YEAR,NCIC_AGENCY,FUNDED_NON_JAIL_SWORN_MALE,FUNDED_NON_JAIL_SWORN_FEMALE,FUNDED_NON_JAIL_SWORN_TOTAL,FUNDED_NON_JAIL_CIVIL_MALE,FUNDED_NON_JAIL_CIVIL_FEMALE,FUNDED_NON_JAIL_CIVIL_TOTAL,FUNDED_JAIL_SWORN_MALE,FUNDED_JAIL_SWORN_FEMALE,FUNDED_JAIL_SWORN_TOTAL,FUNDED_JAIL_CIVIL_MALE,FUNDED_JAIL_CIVIL_FEMALE,FUNDED_JAIL_CIVIL_TOTAL
1991,100,302,42,344,93,139,232,336,63,399,107,170,277
1991,101,89,5,94,4,31,35,0,0,0,4,4,8
1991,102,26,3,29,0,4,4,0,0,0,0,0,0
1991,103,162,20,182,31,69,100,0,0,0,12,10,22
1991,104,28,3,31,4,12,16,0,0,0,0,0,0
1991,105,183,14,197,21,55,76,1,0,1,8,7,15
1991,106,149,15,164,25,71,96,9,6,15,3,2,5
1991,107,58,4,62,6,50,56,0,0,0,0,0,0
1991,108,52,2,54,6,17,23,0,0,0,0,0,0
1991,109,610,55,665,114,187,301,6,0,6,72,30,102
1991,110,18,2,20,1,6,7,0,0,0,0,0,0
1991,111,60,5,65,4,26,30,0,0,0,0,0,0
1991,112,82,4,86,11,29,40,0,0,0,4,1,5
1991,113,59,4,63,8,29,37,0,0,0,0,0,0
1991,114,51,3,54,4,14,18,0,0,0,0,0,0
1991,115,12,0,12,0,4,4,0,0,0,0,0,0
1991,121,139,15,154,15,16,31,0,0,0,0,0,0
1991,122,13,0,13,187,50,237,0,0,0,0,0,0
1991,127,8,1,9,5,0,5,0,0,0,0,0,0
1991,197,50,13,63,12,16,28,0,0,0,0,0,0
1991,200,10,0,10,0,3,3,0,0,0,0,0,0
1991,300,37,0,37,0,4,4,0,0,0,0,0,0
1991,302,4,0,4,0,1,1,0,0,0,0,0,0
1991,303,8,1,9,0,2,2,0,0,0,0,0,0
1991,305,5,0,5,0,1,1,0,0,0,0,0,0
1991,400,79,1,80,4,24,28,2,1,3,41,19,60
1991,401,2,0,2,0,0,0,0,0,0,0,0,0
1991,402,57,5,62,5,35,40,0,0,0,0,0,0
1991,403,10,0,10,0,6,6,0,0,0,0,0,0
1991,404,24,1,25,4,8,12,0,0,0,0,0,0
1991,405,23,0,23,3,12,15,0,0,0,0,0,0
1991,497,9,1,10,2,2,4,0,0,0,0,0,0
1991,500,37,3,40,0,13,13,0,1,1,11,7,18
1991,501,7,1,8,1,0,1,0,0,0,0,0,0
1991,600,26,1,27,0,5,5,3,0,3,0,0,0
1991,601,8,1,9,0,1,1,0,0,0,0,0,0
1991,602,6,0,6,0,1,1,0,0,0,0,0,0
1991,700,313,44,357,52,139,191,225,42,267,47,86,133
1991,701,77,5,82,3,32,35,0,0,0,0,0,0
1991,702,14,0,14,3,0,3,0,0,0,0,0,0
1991,703,8,0,8,0,2,2,0,0,0,0,0,0
1991,704,136,11,147,10,49,59,0,0,0,0,0,0
1991,705,35,2,37,0,6,6,0,0,0,0,0,0
1991,706,14,3,17,1,3,4,0,0,0,0,0,0
1991,707,22,1,23,5,15,20,0,0,0,0,0,0
1991,708,69,1,70,3,14,17,0,0,0,0,0,0
1991,709,40,2,42,2,20,22,0,0,0,0,0,0
1991,710,171,10,181,18,61,79,0,0,0,3,2,5
1991,711,40,0,40,2,11,13,0,0,0,0,0,0
1991,712,70,6,76,4,25,29,0,0,0,0,0,0
1991,713,9,2,11,0,0,0,0,0,0,0,0,0
1991,714,41,2,43,2,11,13,0,0,0,0,0,0
1991,716,11,1,12,0,1,1,0,0,0,0,0,0
1991,721,18,3,21,2,3,5,0,0,0,0,0,0
1991,800,21,2,23,0,4,4,0,0,0,0,0,0
1991,801,12,1,13,0,1,1,0,0,0,0,0,0
1991,900,122,4,126,3,28,31,14,3,17,45,42,87
1991,901,21,0,21,1,4,5,0,0,0,0,0,0
1991,902,51,3,54,3,18,21,0,0,0,0,0,0
1991,1000,302,19,321,59,88,147,0,0,0,0,0,0
1991,1001,62,5,67,5,26,31,0,0,0,0,0,0
1991,1002,15,0,15,1,5,6,0,0,0,0,0,0
1991,1003,7,1,8,0,5,5,0,0,0,0,0,0
1991,1004,5,0,5,0,0,0,0,0,0,0,0,0
1991,1005,389,31,420,53,171,224,0,0,0,0,0,0
1991,1006,3,0,3,1,4,5,0,0,0,0,0,0
1991,1007,10,1,11,1,2,3,0,0,0,0,0,0
1991,1008,11,0,11,0,4,4,0,0,0,0,0,0
1991,1012,20,3,23,4,5,9,0,0,0,0,0,0
1991,1013,22,2,24,0,6,6,0,0,0,0,0,0
1991,1015,19,3,22,1,10,11,0,0,0,0,0,0
1991,1017,10,1,11,0,2,2,0,0,0,0,0,0
1991,1097,13,4,17,3,7,10,0,0,0,0,0,0
1991,1100,24,0,24,1,9,10,0,0,0,0,0,0
1991,1101,9,0,9,0,1,1,0,0,0,0,0,0
1991,1102,9,0,9,0,1,1,0,0,0,0,0,0
1991,1200,83,4,87,2,25,27,0,0,0,0,0,0
1991,1201,20,0,20,1,6,7,0,0,0,0,0,0
1991,1202,2,0,2,0,0,0,0,0,0,0,0,0
1991,1203,37,4,41,2,14,16,0,0,0,0,0,0
1991,1204,2,1,3,0,0,0,0,0,0,0,0,0
1991,1205,14,1,15,1,5,6,0,0,0,0,0,0
1991,1206,3,1,4,0,0,0,0,0,0,0,0,0
1991,1207,4,0,4,0,0,0,0,0,0,0,0,0
1991,1208,10,0,10,5,0,5,0,0,0,0,0,0
1991,1300,65,5,70,2,34,36,53,6,59,25,32,57
1991,1301,26,1,27,0,9,9,0,0,0,0,0,0
1991,1302,23,3,26,8,10,18,0,0,0,0,0,0
1991,1303,4,0,4,0,1,1,0,0,0,0,0,0
1991,1304,44,2,46,9,15,24,0,0,0,0,0,0
1991,1305,9,0,9,3,1,4,0,0,0,0,0,0
1991,1306,9,1,10,1,1,2,0,0,0,0,0,0
1991,1307,5,0,5,0,0,0,0,0,0,0,0,0
1991,1400,25,1,26,0,9,9,11,2,13,3,0,3
1991,1401,14,0,14,0,8,8,0,0,0,0,0,0
1991,1500,281,20,301,25,120,145,189,36,225,87,137,224
1991,1501,11,0,11,0,6,6,0,0,0,0,0,0
1991,1502,239,8,247,10,75,85,0,0,0,0,0,0
1991,1503,31,4,35,0,11,11,0,0,0,4,1,5
1991,1505,5,0,5,1,5,6,0,0,0,0,0,0
1991,1506,34,2,36,2,14,16,0,0,0,0,0,0
1991,1507,11,1,12,0,5,5,0,0,0,0,0,0
1991,1508,14,0,14,0,5,5,0,0,0,0,0,0
1991,1511,11,1,12,1,4,5,0,0,0,0,0,0
1991,1513,39,7,46,2,6,8,0,0,0,0,0,0
1991,1514,3,0,3,0,0,0,0,0,0,0,0,0
1991,1515,5,0,5,1,11,12,0,0,0,0,0,0
1991,1597,10,0,10,1,3,4,0,0,0,0,0,0
1991,1600,69,2,71,3,39,42,0,0,0,0,0,0
1991,1601,14,1,15,1,4,5,0,0,0,0,0,0
1991,1602,34,2,36,1,12,13,0,0,0,0,0,0
1991,1603,19,1,20,1,5,6,0,0,0,0,0,0
1991,1700,54,3,57,5,22,27,0,0,0,0,0,0
1991,1701,12,0,12,0,2,2,0,0,0,0,0,0
1991,1702,18,0,18,1,6,7,0,0,0,0,0,0
1991,1800,20,1,21,0,9,9,2,0,2,30,22,52
1991,1801,13,1,14,0,1,1,0,0,0,0,0,0
1991,1900,4696,620,5316,611,1666,2277,0,0,0,0,0,0
1991,1901,90,6,96,12,49,61,0,0,0,3,3,6
1991,1902,71,6,77,4,13,17,0,0,0,1,3,4
1991,1905,51,2,53,2,16,18,0,0,0,4,0,4
1991,1906,58,2,60,2,18,20,0,0,0,0,0,0
1991,1907,39,1,40,2,14,16,0,0,0,0,0,0
1991,1909,47,5,52,1,19,20,0,0,0,0,0,0
1991,1910,123,5,128,19,37,56,0,0,0,6,4,10
1991,1912,134,7,141,21,56,77,1,0,1,7,3,10
1991,1913,37,2,39,2,12,14,0,0,0,4,1,5
1991,1915,117,8,125,15,46,61,0,0,0,5,0,5
1991,1916,50,1,51,4,25,29,0,0,0,3,0,3
1991,1918,107,9,116,8,27,35,0,0,0,2,0,2
1991,1920,120,4,124,4,29,33,0,0,0,0,0,0
1991,1922,100,10,110,12,18,30,0,0,0,5,0,5
1991,1923,58,7,65,2,13,15,0,0,0,3,3,6
1991,1924,85,8,93,5,16,21,0,0,0,4,3,7
1991,1925,191,24,215,18,71,89,0,0,0,7,5,12
1991,1926,48,5,53,3,17,20,0,0,0,3,2,5
1991,1928,84,6,90,5,35,40,0,0,0,6,0,6
1991,1929,37,3,40,2,12,14,0,0,0,2,4,6
1991,1931,65,2,67,5,24,29,0,0,0,3,2,5
1991,1933,186,13,199,19,64,83,0,0,0,5,6,11
1991,1934,21,0,21,0,5,5,0,0,0,0,0,0
1991,1938,37,2,39,3,11,14,0,0,0,1,0,1
1991,1941,599,57,656,81,204,285,7,1,8,41,19,60
1991,1942,7054,1101,8155,570,1547,2117,42,1,43,426,123,549
1991,1944,52,6,58,2,10,12,0,0,0,3,1,4
1991,1945,23,0,23,4,6,10,0,0,0,0,0,0
1991,1946,54,3,57,0,20,20,0,0,0,1,1,2
1991,1947,85,5,90,4,29,33,0,0,0,0,0,0
1991,1948,68,7,75,3,33,36,0,0,0,6,0,6
1991,1951,21,2,23,0,1,1,0,0,0,2,5,7
1991,1953,196,22,218,34,80,114,2,0,2,9,6,15
1991,1955,155,7,162,11,76,87,0,0,0,12,7,19
1991,1956,99,5,104,10,47,57,0,0,0,1,8,9
1991,1961,33,1,34,4,12,16,0,0,0,0,0,0
1991,1962,47,3,50,3,8,11,0,0,0,0,0,0
1991,1963,21,3,24,0,6,6,0,0,0,0,0,0
1991,1965,150,25,175,41,79,120,0,0,0,7,6,13
1991,1966,13,2,15,4,1,5,0,0,0,0,0,0
1991,1967,29,3,32,1,5,6,0,0,0,4,2,6
1991,1969,89,2,91,5,25,30,0,0,0,4,1,5
1991,1970,27,2,29,4,11,15,0,0,0,4,0,4
1991,1972,231,7,238,10,54,64,0,0,0,8,6,14
1991,1973,50,2,52,2,15,17,0,0,0,0,0,0
1991,1975,107,7,114,5,33,38,0,0,0,4,2,6
1991,1976,88,2,90,2,27,29,0,0,0,6,0,6
1991,1978,9,3,12,4,11,15,0,0,0,0,0,0
1991,1981,9,1,10,4,5,9,0,0,0,0,0,0
1991,1982,14,4,18,3,3,6,0,0,0,0,0,0
1991,1983,17,2,19,5,11,16,0,0,0,0,0,0
1991,1984,16,2,18,7,10,17,0,0,0,0,0,0
1991,1997,55,9,64,8,9,17,0,0,0,0,0,0
1991,2000,56,2,58,2,16,18,0,0,0,0,0,0
1991,2001,13,0,13,1,5,6,0,0,0,0,0,0
1991,2002,39,2,41,2,10,12,0,0,0,0,0,0
1991,2100,96,14,110,13,48,61,50,16,66,7,11,18
1991,2101,7,0,7,0,0,0,0,0,0,0,0,0
1991,2103,9,3,12,1,4,5,0,0,0,0,0,0
1991,2104,30,2,32,1,8,9,0,0,0,0,0,0
1991,2105,22,0,22,1,6,7,0,0,0,0,0,0
1991,2106,46,3,49,2,17,19,0,0,0,0,0,0
1991,2107,7,0,7,0,0,0,0,0,0,0,0,0
1991,2108,15,1,16,0,6,6,0,0,0,0,0,0
1991,2109,67,6,73,3,26,29,0,0,0,0,0,0
1991,2110,22,1,23,2,9,11,0,0,0,0,0,0
1991,2111,13,2,15,2,4,6,0,0,0,0,0,0
1991,2113,9,0,9,0,0,0,0,0,0,0,0,0
1991,2200,27,2,29,1,1,2,6,6,12,0,2,2
1991,2300,60,2,62,2,16,18,0,0,0,0,0,0
1991,2301,17,1,18,0,8,8,0,0,0,3,2,5
1991,2303,22,0,22,1,6,7,0,0,0,0,0,0
1991,2304,10,0,10,0,6,6,0,0,0,0,0,0
1991,2400,70,2,72,4,16,20,0,0,0,0,0,0
1991,2401,22,1,23,1,5,6,0,0,0,0,0,0
1991,2402,7,0,7,0,0,0,0,0,0,0,0,0
1991,2403,7,1,8,0,2,2,0,0,0,0,0,0
1991,2404,13,0,13,1,4,5,0,0,0,0,0,0
1991,2405,22,2,24,1,12,13,0,0,0,0,0,0
1991,2406,72,3,75,5,29,34,0,0,0,0,0,0
1991,2409,2,0,2,1,0,1,0,0,0,0,0,0
1991,2500,8,1,9,0,0,0,0,0,0,0,0,0
1991,2501,8,0,8,0,1,1,0,0,0,0,0,0
1991,2600,22,1,23,0,2,2,0,0,0,0,0,0
1991,2601,14,1,15,0,3,3,0,0,0,0,0,0
1991,2700,144,8,152,8,56,64,106,27,133,7,20,27
1991,2701,18,1,19,3,8,11,0,0,0,0,0,0
1991,2702,5,0,5,0,0,0,0,0,0,0,0,0
1991,2703,9,0,9,0,1,1,0,0,0,0,0,0
1991,2704,11,0,11,0,1,1,0,0,0,0,0,0
1991,2705,14,0,14,1,4,5,0,0,0,0,0,0
1991,2706,50,2,52,2,5,7,0,0,0,6,5,11
1991,2707,27,2,29,4,7,11,0,0,0,0,0,0
1991,2708,131,4,135,12,35,47,0,0,0,0,0,0
1991,2709,4,0,4,0,0,0,0,0,0,0,0,0
1991,2710,31,2,33,3,7,10,0,0,0,0,0,0
1991,2711,10,0,10,0,2,2,0,0,0,0,0,0
1991,2712,24,2,26,1,4,5,0,0,0,0,0,0
1991,2714,10,0,10,0,0,0,0,0,0,0,0,0
1991,2800,65,3,68,1,17,18,0,0,0,0,0,0
1991,2801,8,1,9,2,2,4,0,0,0,0,0,0
1991,2802,67,4,71,8,30,38,0,0,0,0,0,0
1991,2803,11,1,12,1,3,4,0,0,0,0,0,0
1991,2900,62,4,66,1,31,32,0,0,0,0,0,0
1991,2901,19,0,19,2,6,8,0,0,0,0,0,0
1991,2902,8,0,8,0,2,2,0,0,0,0,0,0
1991,3000,556,57,613,201,322,523,513,95,608,209,175,384
1991,3001,326,21,347,31,115,146,1,0,1,16,14,30
1991,3002,97,6,103,1,23,24,0,0,0,0,0,0
1991,3003,88,1,89,10,38,48,0,0,0,3,0,3
1991,3004,129,9,138,11,37,48,0,0,0,6,0,6
1991,3005,49,4,53,2,22,24,0,0,0,3,0,3
1991,3006,23,1,24,0,6,6,0,0,0,0,0,0
1991,3007,55,6,61,6,17,23,0,0,0,0,0,0
1991,3008,140,10,150,5,61,66,0,0,0,5,0,5
1991,3009,158,7,165,6,59,65,0,0,0,0,0,0
1991,3010,217,7,224,31,90,121,1,0,1,10,6,16
1991,3011,41,6,47,2,31,33,0,0,0,0,0,0
1991,3012,58,3,61,3,24,27,0,0,0,0,0,0
1991,3013,24,1,25,3,3,6,0,0,0,0,0,0
1991,3014,144,7,151,14,47,61,0,0,0,5,2,7
1991,3015,142,8,150,13,60,73,0,0,0,0,0,0
1991,3016,49,2,51,3,13,16,0,0,0,0,0,0
1991,3017,43,6,49,2,18,20,0,0,0,0,0,0
1991,3019,384,15,399,33,165,198,0,0,0,0,0,0
1991,3020,34,3,37,0,15,15,0,0,0,0,0,0
1991,3022,80,4,84,4,30,34,0,0,0,0,0,0
1991,3024,98,3,101,5,45,50,0,0,0,0,0,0
1991,3026,120,10,130,9,49,58,0,0,0,4,0,4
1991,3027,12,1,13,1,6,7,0,0,0,0,0,0
1991,3091,234,37,271,29,86,115,0,0,0,0,0,0
1991,3097,22,3,25,20,14,34,0,0,0,0,0,0
1991,3100,116,10,126,3,59,62,71,7,78,22,19,41
1991,3101,19,1,20,0,7,7,0,0,0,0,0,0
1991,3102,6,0,6,0,1,1,0,0,0,0,0,0
1991,3103,11,2,13,0,7,7,0,0,0,0,0,0
1991,3104,27,2,29,4,9,13,0,0,0,0,0,0
1991,3105,56,2,58,5,31,36,0,0,0,5,3,8
1991,3200,36,0,36,2,11,13,0,0,0,9,5,14
1991,3300,712,86,798,70,328,398,216,47,263,283,137,420
1991,3301,28,3,31,4,14,18,0,0,0,0,0,0
1991,3302,19,1,20,4,7,11,0,0,0,0,0,0
1991,3303,17,0,17,1,8,9,0,0,0,0,0,0
1991,3305,19,0,19,1,7,8,0,0,0,0,0,0
1991,3308,45,4,49,5,14,19,0,0,0,0,0,0
1991,3309,45,0,45,5,21,26,0,0,0,0,0,0
1991,3311,79,5,84,12,24,36,0,0,0,4,2,6
1991,3312,31,4,35,1,17,18,0,0,0,0,0,0
1991,3313,274,22,296,26,105,131,0,0,0,0,0,0
1991,3314,23,0,23,3,8,11,0,0,0,0,0,0
1991,3315,103,11,114,9,56,65,0,0,0,0,0,0
1991,3325,37,2,39,5,16,21,0,0,0,0,0,0
1991,3397,15,1,16,2,4,6,0,0,0,0,0,0
1991,3400,633,91,724,76,198,274,325,100,425,77,88,165
1991,3401,33,1,34,0,9,9,0,0,0,0,0,0
1991,3402,15,1,16,1,7,8,0,0,0,0,0,0
1991,3403,7,1,8,0,0,0,0,0,0,0,0,0
1991,3404,556,60,616,77,226,303,0,0,0,0,0,0
1991,3408,12,1,13,1,5,6,0,0,0,0,0,0
1991,3420,2,0,2,0,1,1,0,0,0,0,0,0
1991,3498,299,35,334,25,48,73,0,0,0,0,0,0
1991,3499,5533,508,6041,981,1465,2446,0,0,0,0,0,0
1991,3500,19,1,20,1,4,5,1,0,1,8,7,15
1991,3501,20,2,22,1,3,4,0,0,0,0,0,0
1991,3502,4,0,4,0,0,0,0,0,0,0,0,0
1991,3600,787,133,920,93,302,395,321,86,407,121,195,316
1991,3601,34,1,35,1,13,14,0,0,0,0,0,0
1991,3602,78,2,80,7,36,43,0,0,0,0,0,0
1991,3603,60,2,62,4,23,27,0,0,0,0,0,0
1991,3604,100,4,104,10,56,66,0,0,0,0,0,0
1991,3605,49,3,52,1,20,21,0,0,0,0,0,0
1991,3607,164,8,172,16,47,63,0,0,0,0,0,0
1991,3608,68,2,70,7,17,24,0,0,0,0,0,0
1991,3609,86,7,93,5,39,44,0,0,0,0,0,0
1991,3610,219,16,235,28,87,115,0,0,0,0,0,0
1991,3611,76,3,79,5,26,31,0,0,0,0,0,0
1991,3613,14,1,15,2,6,8,0,0,0,0,0,0
1991,3614,10,0,10,1,4,5,0,0,0,0,0,0
1991,3700,630,113,743,69,331,400,608,125,733,234,263,497
1991,3701,77,4,81,9,19,28,0,0,0,0,0,0
1991,3702,135,14,149,24,56,80,0,0,0,0,0,0
1991,3703,37,4,41,5,11,16,0,0,0,0,0,0
1991,3705,123,9,132,16,62,78,0,0,0,0,0,0
1991,3706,128,8,136,14,51,65,0,0,0,0,0,0
1991,3708,54,5,59,3,19,22,0,0,0,0,0,0
1991,3709,74,3,77,5,28,33,0,0,0,0,0,0
1991,3710,164,16,180,16,70,86,0,0,0,0,0,0
1991,3711,1650,236,1886,227,495,722,0,0,0,0,0,0
1991,3714,21,2,23,3,9,12,0,0,0,0,0,0
1991,3797,25,4,29,15,6,21,0,0,0,0,0,0
1991,3800,92,30,122,25,17,42,241,89,330,31,10,41
1991,3801,1623,217,1840,168,308,476,0,0,0,0,0,0
1991,3803,14,2,16,7,5,12,0,0,0,0,0,0
1991,3897,20,5,25,27,20,47,0,0,0,0,0,0
1991,3900,202,15,217,17,70,87,193,60,253,18,58,76
1991,3901,8,0,8,1,4,5,0,0,0,0,0,0
1991,3902,66,3,69,1,17,18,0,0,0,2,14,16
1991,3903,43,3,46,8,15,23,0,0,0,0,0,0
1991,3904,11,2,13,2,4,6,0,0,0,0,0,0
1991,3905,266,22,288,46,114,160,0,0,0,0,0,0
1991,3906,40,2,42,4,10,14,0,0,0,0,0,0
1991,4000,121,4,125,4,47,51,2,0,2,71,33,104
1991,4001,20,2,22,1,8,9,0,0,0,0,0,0
1991,4002,16,1,17,1,8,9,0,0,0,0,0,0
1991,4003,16,1,17,0,8,8,0,0,0,0,0,0
1991,4004,29,2,31,1,6,7,0,0,0,0,0,0
1991,4005,19,1,20,0,11,11,0,0,0,0,0,0
1991,4006,51,3,54,7,20,27,0,0,0,0,0,0
1991,4007,12,2,14,1,14,15,0,0,0,0,0,0
1991,4008,24,4,28,2,7,9,0,0,0,0,0,0
1991,4100,196,15,211,25,44,69,108,9,117,37,38,75
1991,4101,18,1,19,2,3,5,0,0,0,0,0,0
1991,4102,26,3,29,6,10,16,0,0,0,0,0,0
1991,4103,11,4,15,3,2,5,0,0,0,0,0,0
1991,4104,44,2,46,4,15,19,0,0,0,0,0,0
1991,4105,11,1,12,0,4,4,0,0,0,0,0,0
1991,4106,97,7,104,6,32,38,0,0,0,0,0,0
1991,4107,12,1,13,0,2,2,0,0,0,0,0,0
1991,4108,24,3,27,1,6,7,0,0,0,0,0,0
1991,4109,37,5,42,3,19,22,0,0,0,0,0,0
1991,4110,23,1,24,0,8,8,0,0,0,0,0,0
1991,4111,42,1,43,2,11,13,0,0,0,0,0,0
1991,4113,70,5,75,10,27,37,0,0,0,0,0,0
1991,4114,45,2,47,1,10,11,0,0,0,0,0,0
1991,4115,33,2,35,2,9,11,0,0,0,0,0,0
1991,4116,93,9,102,3,39,42,0,0,0,0,0,0
1991,4117,68,7,75,6,33,39,0,0,0,0,0,0
1991,4119,8,0,8,1,0,1,0,0,0,0,0,0
1991,4120,37,5,42,5,11,16,0,0,0,0,0,0
1991,4127,32,3,35,0,3,3,0,0,0,0,0,0
1991,4200,200,11,211,29,67,96,0,0,0,0,0,0
1991,4201,6,2,8,0,1,1,0,0,0,0,0,0
1991,4202,38,2,40,3,6,9,0,0,0,5,6,11
1991,4203,130,8,138,19,62,81,0,0,0,0,0,0
1991,4204,70,5,75,0,23,23,0,0,0,0,0,0
1991,4205,19,0,19,1,5,6,0,0,0,0,0,0
1991,4297,21,4,25,5,6,11,0,0,0,0,0,0
1991,4300,355,63,418,22,99,121,0,0,0,0,0,0
1991,4302,38,3,41,0,14,14,0,0,0,0,0,0
1991,4304,40,3,43,5,17,22,0,0,0,2,2,4
1991,4305,27,2,29,4,11,15,0,0,0,0,0,0
1991,4307,41,2,43,10,15,25,0,0,0,0,0,0
1991,4308,65,9,74,8,20,28,0,0,0,0,0,0
1991,4310,30,2,32,0,13,13,0,0,0,0,0,0
1991,4311,77,5,82,4,31,35,0,0,0,0,0,0
1991,4312,74,17,91,28,46,74,0,0,0,0,0,0
1991,4313,1093,77,1170,116,349,465,0,0,0,0,0,0
1991,4314,141,5,146,3,33,36,0,0,0,0,0,0
1991,4316,116,2,118,23,39,62,0,0,0,0,0,0
1991,4317,25,1,26,16,13,29,0,0,0,0,0,0
1991,4320,8,0,8,4,6,10,0,0,0,0,0,0
1991,4321,7,1,8,0,1,1,0,0,0,0,0,0
1991,4327,6,0,6,0,1,1,0,0,0,0,0,0
1991,4400,99,4,103,2,31,33,0,0,0,0,0,0
1991,4401,23,0,23,2,9,11,0,0,0,0,0,0
1991,4402,71,6,77,3,32,35,0,0,0,0,0,0
1991,4403,51,1,52,2,17,19,0,0,0,0,0,0
1991,4404,16,1,17,1,7,8,0,0,0,0,0,0
1991,4405,3,2,5,1,2,3,0,0,0,0,0,0
1991,4497,11,4,15,5,5,10,0,0,0,0,0,0
1991,4500,68,8,76,5,41,46,58,22,80,12,19,31
1991,4501,15,0,15,2,7,9,0,0,0,0,0,0
1991,4502,93,1,94,9,56,65,0,0,0,0,0,0
1991,4600,9,1,10,0,0,0,0,0,0,1,3,4
1991,4700,43,1,44,1,12,13,0,0,0,0,0,0
1991,4701,2,0,2,1,2,3,0,0,0,0,0,0
1991,4702,4,1,5,0,1,1,0,0,0,0,0,0
1991,4703,1,0,1,0,0,0,0,0,0,0,0,0
1991,4706,9,0,9,2,3,5,0,0,0,0,0,0
1991,4707,3,0,3,0,0,0,0,0,0,0,0,0
1991,4708,9,0,9,1,3,4,0,0,0,0,0,0
1991,4709,14,0,14,5,2,7,0,0,0,0,0,0
1991,4710,3,0,3,0,1,1,0,0,0,0,0,0
1991,4800,90,3,93,22,45,67,3,0,3,154,71,225
1991,4801,32,1,33,3,12,15,0,0,0,0,0,0
1991,4802,14,1,15,0,3,3,0,0,0,0,0,0
1991,4803,79,7,86,11,41,52,0,0,0,0,0,0
1991,4804,6,0,6,0,1,1,0,0,0,0,0,0
1991,4805,23,1,24,3,9,12,0,0,0,0,0,0
1991,4806,65,5,70,3,38,41,0,0,0,0,0,0
1991,4807,128,9,137,10,54,64,0,0,0,0,0,0
1991,4900,199,6,205,13,78,91,0,0,0,0,0,0
1991,4901,9,1,10,0,5,5,0,0,0,0,0,0
1991,4902,11,2,13,2,5,7,0,0,0,0,0,0
1991,4903,17,0,17,1,9,10,0,0,0,0,0,0
1991,4904,46,2,48,8,19,27,0,0,0,0,0,0
1991,4905,131,9,140,13,52,65,0,0,0,0,0,0
1991,4906,14,0,14,1,4,5,0,0,0,0,0,0
1991,4907,13,1,14,1,7,8,0,0,0,0,0,0
1991,4908,51,3,54,1,24,25,0,0,0,0,0,0
1991,4909,8,1,9,0,8,8,0,0,0,0,0,0
1991,4914,6,1,7,0,1,1,0,0,0,0,0,0
1991,5000,130,5,135,5,46,51,5,0,5,117,61,178
1991,5001,33,1,34,5,15,20,0,0,0,0,0,0
1991,5002,197,5,202,19,66,85,0,0,0,0,0,0
1991,5003,8,0,8,0,1,1,0,0,0,0,0,0
1991,5004,21,0,21,3,5,8,0,0,0,0,0,0
1991,5005,16,0,16,1,3,4,0,0,0,0,0,0
1991,5006,15,1,16,2,3,5,0,0,0,0,0,0
1991,5007,53,2,55,5,23,28,0,0,0,0,0,0
1991,5008,8,0,8,1,1,2,0,0,0,0,0,0
1991,5009,6,0,6,2,1,3,0,0,0,0,0,0
1991,5010,8,1,9,2,5,7,0,0,0,0,0,0
1991,5100,54,4,58,5,20,25,18,8,26,2,1,3
1991,5102,36,2,38,5,12,17,0,0,0,0,0,0
1991,5200,42,2,44,2,18,20,14,2,16,1,2,3
1991,5201,14,0,14,0,6,6,0,0,0,0,0,0
1991,5202,20,1,21,1,10,11,0,0,0,0,0,0
1991,5300,24,0,24,0,6,6,0,0,0,0,0,0
1991,5400,155,12,167,3,50,53,147,22,169,25,9,34
1991,5401,18,0,18,1,6,7,0,0,0,0,0,0
1991,5402,12,0,12,0,1,1,0,0,0,0,0,0
1991,5403,10,0,10,0,1,1,0,0,0,0,0,0
1991,5404,12,2,14,5,3,8,0,0,0,0,0,0
1991,5405,36,4,40,5,19,24,0,0,0,0,0,0
1991,5406,38,3,41,3,24,27,0,0,0,0,0,0
1991,5407,74,9,83,6,35,41,0,0,0,0,0,0
1991,5408,8,0,8,0,1,1,0,0,0,0,0,0
1991,5411,3,0,3,0,1,1,0,0,0,0,0,0
1991,5500,50,0,50,3,18,21,0,0,0,0,0,0
1991,5501,12,0,12,0,4,4,0,0,0,0,0,0
1991,5600,400,44,444,33,107,140,134,23,157,114,90,204
1991,5604,135,6,141,17,52,69,0,0,0,5,3,8
1991,5605,19,1,20,0,8,8,0,0,0,0,0,0
1991,5606,27,2,29,0,6,6,0,0,0,0,0,0
1991,5608,111,10,121,7,60,67,0,0,0,0,0,0
1991,5609,107,3,110,8,39,47,0,0,0,0,0,0
1991,5700,42,6,48,10,22,32,27,2,29,48,45,93
1991,5701,45,7,52,3,17,20,0,0,0,0,0,0
1991,5702,8,1,9,0,1,1,0,0,0,0,0,0
1991,5703,46,7,53,4,14,18,0,0,0,0,0,0
1991,5704,53,5,58,2,26,28,0,0,0,0,0,0
1991,5797,42,5,47,11,22,33,0,0,0,0,0,0
1991,5800,43,4,47,1,16,17,0,0,0,0,0,0
1991,5801,23,0,23,2,9,11,0,0,0,0,0,0
1991,5802,6,0,6,0,1,1,0,0,0,0,0,0
1991,190P,8,1,9,3,1,4,0,0,0,0,0,0
1991,190R,9,0,9,1,9,10,0,0,0,0,0,0
1992,100,304,40,344,88,140,228,336,69,405,104,157,261
1992,101,89,5,94,5,30,35,0,0,0,4,5,9
1992,102,26,3,29,0,4,4,0,0,0,0,0,0
1992,103,159,23,182,46,76,122,0,0,0,0,0,0
1992,104,26,3,29,1,12,13,0,0,0,0,0,0
1992,105,169,12,181,8,57,65,1,0,1,6,7,13
1992,106,149,15,164,7,59,66,0,0,0,9,4,13
1992,107,62,3,65,26,29,55,0,0,0,0,0,0
1992,108,49,3,52,4,17,21,0,0,0,0,0,0
1992,109,650,63,713,102,212,314,7,0,7,71,28,99
1992,110,18,2,20,1,6,7,0,0,0,0,0,0
1992,111,61,5,66,4,25,29,0,0,0,0,0,0
1992,112,79,4,83,10,31,41,0,0,0,4,1,5
1992,113,60,3,63,5,18,23,3,1,4,0,0,0
1992,114,46,3,49,3,20,23,0,0,0,0,0,0
1992,115,11,1,12,9,4,13,0,0,0,0,0,0
1992,121,137,16,153,15,16,31,0,0,0,0,0,0
1992,122,3,0,3,174,48,222,0,0,0,0,0,0
1992,197,59,15,74,24,23,47,0,0,0,0,0,0
1992,200,9,0,9,0,3,3,0,0,0,0,0,0
1992,300,34,0,34,1,11,12,0,0,0,0,0,0
1992,302,4,0,4,0,1,1,0,0,0,0,0,0
1992,303,8,1,9,0,2,2,0,0,0,0,0,0
1992,305,5,1,6,0,0,0,0,0,0,0,0,0
1992,400,84,2,86,4,27,31,0,0,0,0,0,0
1992,402,57,7,64,6,33,39,0,0,0,0,0,0
1992,403,8,0,8,1,5,6,0,0,0,0,0,0
1992,404,22,1,23,2,8,10,0,0,0,0,0,0
1992,405,23,0,23,14,0,14,0,0,0,0,0,0
1992,497,9,1,10,2,2,4,0,0,0,0,0,0
1992,500,32,3,35,0,15,15,0,0,0,0,0,0
1992,501,5,2,7,1,0,1,0,0,0,0,0,0
1992,600,23,1,24,0,6,6,0,0,0,0,0,0
1992,601,7,1,8,0,1,1,0,0,0,0,0,0
1992,602,5,1,6,0,0,0,0,0,0,0,0,0
1992,700,312,34,346,30,99,129,201,42,243,38,72,110
1992,701,76,5,81,3,31,34,0,0,0,0,0,0
1992,702,15,0,15,0,3,3,0,0,0,0,0,0
1992,703,9,0,9,0,2,2,0,0,0,0,0,0
1992,704,130,10,140,3,41,44,0,0,0,4,0,4
1992,705,32,1,33,0,4,4,0,0,0,0,0,0
1992,706,14,3,17,1,3,4,0,0,0,0,0,0
1992,707,21,1,22,5,15,20,0,0,0,0,0,0
1992,708,68,1,69,3,15,18,0,0,0,0,0,0
1992,709,39,3,42,2,19,21,0,0,0,0,0,0
1992,710,166,11,177,16,57,73,0,0,0,3,2,5
1992,711,40,0,40,0,11,11,0,0,0,0,0,0
1992,712,69,7,76,5,24,29,0,0,0,0,0,0
1992,713,8,2,10,0,0,0,0,0,0,0,0,0
1992,714,41,2,43,2,9,11,0,0,0,0,0,0
1992,716,11,1,12,0,1,1,0,0,0,0,0,0
1992,721,13,4,17,3,2,5,0,0,0,0,0,0
1992,800,23,3,26,0,2,2,0,0,0,0,0,0
1992,801,10,1,11,0,1,1,0,0,0,0,0,0
1992,900,118,4,122,4,28,32,20,3,23,57,48,105
1992,901,19,0,19,1,4,5,0,0,0,0,0,0
1992,902,48,2,50,4,16,20,0,0,0,0,0,0
1992,1000,296,24,320,56,96,152,0,0,0,0,0,0
1992,1001,63,7,70,5,25,30,0,0,0,0,0,0
1992,1002,15,0,15,2,5,7,0,0,0,0,0,0
1992,1003,6,1,7,0,4,4,0,0,0,0,0,0
1992,1004,5,0,5,0,0,0,0,0,0,0,0,0
1992,1005,383,27,410,59,176,235,0,0,0,0,0,0
1992,1006,5,0,5,1,5,6,0,0,0,0,0,0
1992,1007,12,1,13,0,2,2,0,0,0,0,0,0
1992,1008,11,0,11,0,4,4,0,0,0,0,0,0
1992,1011,10,0,10,0,1,1,0,0,0,0,0,0
1992,1012,21,2,23,3,6,9,0,0,0,0,0,0
1992,1013,21,2,23,0,6,6,0,0,0,0,0,0
1992,1015,19,3,22,1,11,12,0,0,0,0,0,0
1992,1017,10,1,11,0,0,0,0,0,0,0,0,0
1992,1031,4,0,4,0,0,0,0,0,0,0,0,0
1992,1097,12,4,16,3,7,10,0,0,0,0,0,0
1992,1100,21,0,21,1,10,11,0,0,0,0,0,0
1992,1101,9,0,9,0,1,1,0,0,0,0,0,0
1992,1102,8,0,8,1,1,2,0,0,0,0,0,0
1992,1200,78,4,82,3,23,26,0,0,0,0,0,0
1992,1201,20,0,20,2,6,8,0,0,0,0,0,0
1992,1202,2,0,2,0,0,0,0,0,0,0,0,0
1992,1203,42,4,46,4,15,19,0,0,0,0,0,0
1992,1204,3,0,3,0,0,0,0,0,0,0,0,0
1992,1205,13,1,14,0,6,6,0,0,0,0,0,0
1992,1206,2,1,3,0,0,0,0,0,0,0,0,0
1992,1207,4,0,4,0,0,0,0,0,0,0,0,0
1992,1208,10,0,10,2,5,7,0,0,0,0,0,0
1992,1300,65,5,70,2,34,36,53,6,59,25,32,57
1992,1301,26,1,27,0,9,9,0,0,0,0,0,0
1992,1302,25,3,28,5,11,16,0,0,0,0,0,0
1992,1303,4,0,4,0,1,1,0,0,0,0,0,0
1992,1304,44,2,46,7,17,24,0,0,0,0,0,0
1992,1305,9,0,9,3,1,4,0,0,0,0,0,0
1992,1306,9,1,10,0,0,0,0,0,0,0,0,0
1992,1307,4,0,4,0,0,0,0,0,0,0,0,0
1992,1400,22,2,24,3,3,6,11,1,12,2,8,10
1992,1401,14,0,14,0,8,8,0,0,0,0,0,0
1992,1500,272,19,291,25,126,151,0,0,0,0,0,0
1992,1501,11,0,11,0,6,6,0,0,0,0,0,0
1992,1502,237,7,244,10,79,89,0,0,0,0,0,0
1992,1503,30,3,33,0,9,9,0,0,0,4,0,4
1992,1506,31,2,33,0,9,9,0,0,0,0,0,0
1992,1507,20,3,23,0,5,5,0,0,0,0,0,0
1992,1508,16,0,16,7,0,7,0,0,0,0,0,0
1992,1511,12,1,13,1,6,7,0,0,0,0,0,0
1992,1513,35,6,41,4,6,10,0,0,0,0,0,0
1992,1514,3,0,3,0,0,0,0,0,0,0,0,0
1992,1515,6,0,6,0,4,4,0,0,0,0,0,0
1992,1597,9,0,9,1,3,4,0,0,0,0,0,0
1992,1600,65,2,67,6,31,37,31,16,47,4,5,9
1992,1601,14,1,15,0,5,5,0,0,0,0,0,0
1992,1602,33,1,34,0,12,12,0,0,0,0,0,0
1992,1603,19,1,20,2,4,6,0,0,0,0,0,0
1992,1700,54,2,56,5,24,29,0,0,0,0,0,0
1992,1701,12,0,12,0,2,2,0,0,0,0,0,0
1992,1702,17,0,17,1,7,8,0,0,0,0,0,0
1992,1800,22,1,23,0,6,6,29,13,42,6,7,13
1992,1801,13,1,14,0,1,1,0,0,0,0,0,0
1992,1900,4562,599,5161,840,1849,2689,0,0,0,0,0,0
1992,1901,81,7,88,13,35,48,0,0,0,3,3,6
1992,1902,71,6,77,4,12,16,0,0,0,1,3,4
1992,1905,54,2,56,1,21,22,0,0,0,5,0,5
1992,1906,65,3,68,2,18,20,0,0,0,0,0,0
1992,1907,39,1,40,4,14,18,0,0,0,2,2,4
1992,1909,50,6,56,4,17,21,0,0,0,0,0,0
1992,1910,123,5,128,21,36,57,0,0,0,7,3,10
1992,1912,137,8,145,21,59,80,0,0,0,6,3,9
1992,1913,37,2,39,2,11,13,0,0,0,4,1,5
1992,1915,117,7,124,6,71,77,0,0,0,5,0,5
1992,1916,51,1,52,1,24,25,0,0,0,4,0,4
1992,1918,107,9,116,13,28,41,0,0,0,2,0,2
1992,1920,119,4,123,2,29,31,0,0,0,0,0,0
1992,1922,105,9,114,8,18,26,0,0,0,5,0,5
1992,1923,55,8,63,3,12,15,0,0,0,3,2,5
1992,1924,84,7,91,1,13,14,0,0,0,3,3,6
1992,1925,185,21,206,22,62,84,1,0,1,6,6,12
1992,1926,47,5,52,2,13,15,0,0,0,3,4,7
1992,1928,85,6,91,15,35,50,0,0,0,6,0,6
1992,1929,36,3,39,2,12,14,0,0,0,2,4,6
1992,1931,61,2,63,6,28,34,0,0,0,3,2,5
1992,1933,194,14,208,14,54,68,1,0,1,3,8,11
1992,1934,20,0,20,0,6,6,0,0,0,0,0,0
1992,1938,36,2,38,3,10,13,0,0,0,1,0,1
1992,1941,666,59,725,54,250,304,9,0,9,43,19,62
1992,1942,6680,1080,7760,700,1546,2246,40,0,40,261,85,346
1992,1944,50,8,58,0,0,0,1,6,7,4,1,5
1992,1945,21,0,21,5,6,11,0,0,0,0,0,0
1992,1946,52,3,55,0,18,18,0,0,0,1,0,1
1992,1947,88,4,92,13,30,43,0,0,0,0,0,0
1992,1948,68,7,75,3,30,33,6,0,6,0,0,0
1992,1951,21,2,23,0,2,2,0,0,0,3,7,10
1992,1953,186,20,206,34,78,112,2,0,2,10,7,17
1992,1955,162,5,167,13,80,93,1,0,1,12,7,19
1992,1956,95,5,100,14,47,61,0,0,0,3,6,9
1992,1961,33,1,34,1,8,9,0,0,0,3,2,5
1992,1962,46,4,50,3,8,11,0,0,0,0,0,0
1992,1963,22,3,25,0,5,5,0,0,0,0,0,0
1992,1965,152,25,177,50,83,133,0,0,0,5,6,11
1992,1966,15,0,15,3,3,6,0,0,0,0,0,0
1992,1967,28,3,31,1,6,7,0,0,0,3,2,5
1992,1969,87,3,90,5,24,29,0,0,0,4,1,5
1992,1970,28,2,30,1,13,14,0,0,0,4,0,4
1992,1972,231,7,238,13,56,69,0,0,0,6,7,13
1992,1973,52,2,54,3,16,19,0,0,0,0,0,0
1992,1975,107,7,114,7,31,38,0,0,0,4,4,8
1992,1976,89,3,92,5,30,35,0,0,0,6,0,6
1992,1978,10,2,12,4,10,14,0,0,0,0,0,0
1992,1981,11,1,12,4,5,9,0,0,0,0,0,0
1992,1982,14,4,18,3,2,5,0,0,0,0,0,0
1992,1983,13,2,15,0,4,4,0,0,0,0,0,0
1992,1984,17,2,19,12,6,18,0,0,0,0,0,0
1992,1997,52,11,63,12,10,22,0,0,0,0,0,0
1992,2000,52,3,55,2,17,19,0,0,0,0,0,0
1992,2001,12,0,12,1,5,6,0,0,0,0,0,0
1992,2002,40,2,42,2,10,12,0,0,0,0,0,0
1992,2100,101,15,116,15,46,61,41,19,60,8,11,19
1992,2101,7,0,7,0,1,1,0,0,0,0,0,0
1992,2103,9,3,12,1,3,4,0,0,0,0,0,0
1992,2104,30,2,32,1,8,9,0,0,0,0,0,0
1992,2105,26,0,26,0,8,8,0,0,0,0,0,0
1992,2106,50,3,53,3,18,21,0,0,0,0,0,0
1992,2107,7,0,7,0,0,0,0,0,0,0,0,0
1992,2108,16,0,16,0,6,6,0,0,0,0,0,0
1992,2109,72,5,77,2,29,31,0,0,0,0,0,0
1992,2110,20,1,21,0,10,10,0,0,0,0,0,0
1992,2111,12,2,14,1,2,3,0,0,0,0,0,0
1992,2113,8,0,8,0,1,1,0,0,0,0,0,0
1992,2200,27,2,29,1,0,1,0,0,0,0,0,0
1992,2300,63,1,64,2,17,19,0,0,0,0,0,0
1992,2301,17,1,18,0,3,3,0,0,0,2,3,5
1992,2303,24,0,24,1,8,9,0,0,0,0,0,0
1992,2304,10,0,10,0,6,6,0,0,0,0,0,0
1992,2400,72,2,74,6,15,21,0,0,0,0,0,0
1992,2401,21,1,22,1,6,7,0,0,0,0,0,0
1992,2402,7,0,7,0,0,0,0,0,0,0,0,0
1992,2403,7,1,8,0,1,1,0,0,0,0,0,0
1992,2404,13,1,14,1,5,6,0,0,0,0,0,0
1992,2405,23,2,25,1,11,12,0,0,0,0,0,0
1992,2406,71,3,74,4,30,34,0,0,0,0,0,0
1992,2500,9,1,10,0,0,0,0,0,0,0,0,0
1992,2501,8,0,8,0,1,1,0,0,0,0,0,0
1992,2600,23,1,24,3,2,5,1,0,1,0,0,0
1992,2601,14,1,15,0,3,3,0,0,0,0,0,0
1992,2700,146,7,153,7,54,61,110,24,134,6,22,28
1992,2701,17,1,18,4,6,10,0,0,0,0,0,0
1992,2702,4,0,4,0,0,0,0,0,0,0,0,0
1992,2703,8,0,8,0,1,1,0,0,0,0,0,0
1992,2704,9,0,9,0,1,1,0,0,0,0,0,0
1992,2705,14,0,14,1,0,1,0,0,0,0,0,0
1992,2706,51,2,53,3,5,8,0,0,0,6,5,11
1992,2707,25,2,27,4,7,11,0,0,0,0,0,0
1992,2708,134,4,138,9,34,43,0,0,0,0,0,0
1992,2709,5,0,5,0,1,1,0,0,0,0,0,0
1992,2710,38,3,41,3,7,10,0,0,0,0,0,0
1992,2711,10,0,10,0,2,2,0,0,0,0,0,0
1992,2712,24,1,25,1,4,5,0,0,0,0,0,0
1992,2714,10,0,10,0,0,0,0,0,0,0,0,0
1992,2800,65,4,69,1,17,18,0,0,0,0,0,0
1992,2801,8,1,9,2,2,4,0,0,0,0,0,0
1992,2802,66,4,70,5,34,39,0,0,0,0,0,0
1992,2803,11,1,12,1,3,4,0,0,0,0,0,0
1992,2900,70,3,73,2,32,34,0,0,0,0,0,0
1992,2901,18,0,18,1,7,8,0,0,0,0,0,0
1992,2902,8,0,8,0,2,2,0,0,0,0,0,0
1992,3000,611,34,645,179,292,471,505,80,585,217,149,366
1992,3001,331,19,350,37,116,153,1,0,1,14,11,25
1992,3002,99,7,106,1,25,26,0,0,0,0,0,0
1992,3003,85,2,87,6,38,44,0,0,0,5,0,5
1992,3004,130,8,138,50,0,50,0,0,0,8,0,8
1992,3005,48,5,53,1,23,24,0,0,0,3,0,3
1992,3006,23,1,24,0,6,6,0,0,0,0,0,0
1992,3007,56,6,62,6,15,21,0,0,0,0,0,0
1992,3008,138,10,148,3,59,62,0,0,0,5,0,5
1992,3009,161,8,169,9,56,65,0,0,0,0,0,0
1992,3010,221,7,228,30,98,128,1,0,1,11,8,19
1992,3011,41,6,47,2,31,33,0,0,0,0,0,0
1992,3012,58,4,62,4,23,27,0,0,0,0,0,0
1992,3013,24,0,24,2,4,6,0,0,0,0,0,0
1992,3014,144,7,151,12,57,69,0,0,0,5,3,8
1992,3015,137,5,142,12,56,68,0,0,0,0,0,0
1992,3016,50,1,51,3,13,16,0,0,0,0,0,0
1992,3017,41,6,47,3,16,19,0,0,0,2,0,2
1992,3019,375,15,390,29,163,192,0,0,0,3,2,5
1992,3020,32,3,35,3,14,17,0,0,0,0,0,0
1992,3022,81,4,85,3,30,33,0,0,0,0,0,0
1992,3024,97,3,100,5,37,42,0,0,0,0,0,0
1992,3026,115,10,125,7,56,63,0,0,0,3,1,4
1992,3027,12,2,14,5,11,16,0,0,0,0,0,0
1992,3091,238,33,271,19,56,75,53,13,66,0,0,0
1992,3097,20,4,24,3,6,9,0,0,0,0,0,0
1992,3100,123,14,137,5,59,64,47,11,58,17,29,46
1992,3101,19,1,20,1,6,7,0,0,0,0,0,0
1992,3102,5,0,5,0,0,0,0,0,0,0,0,0
1992,3103,10,2,12,0,4,4,0,0,0,0,0,0
1992,3104,24,2,26,4,10,14,0,0,0,0,0,0
1992,3105,55,2,57,8,35,43,0,0,0,3,4,7
1992,3200,34,0,34,0,10,10,0,0,0,0,0,0
1992,3300,739,85,824,60,364,424,202,39,241,272,149,421
1992,3301,27,3,30,1,14,15,0,0,0,0,0,0
1992,3302,16,0,16,3,5,8,0,0,0,0,0,0
1992,3303,17,1,18,1,8,9,0,0,0,0,0,0
1992,3305,22,0,22,2,8,10,0,0,0,0,0,0
1992,3308,44,3,47,3,12,15,0,0,0,0,0,0
1992,3309,41,0,41,6,19,25,0,0,0,0,0,0
1992,3311,79,4,83,12,29,41,0,0,0,4,3,7
1992,3312,30,4,34,0,15,15,0,0,0,0,0,0
1992,3313,282,23,305,41,128,169,0,0,0,0,0,0
1992,3314,25,1,26,5,9,14,0,0,0,0,0,0
1992,3315,102,12,114,13,57,70,0,0,0,0,0,0
1992,3325,40,2,42,6,14,20,0,0,0,0,0,0
1992,3397,13,2,15,3,4,7,0,0,0,0,0,0
1992,3400,627,93,720,80,198,278,322,84,406,77,87,164
1992,3401,34,0,34,1,9,10,0,0,0,0,0,0
1992,3402,16,1,17,1,9,10,0,0,0,0,0,0
1992,3403,2,0,2,0,0,0,0,0,0,0,0,0
1992,3404,538,61,599,70,231,301,0,0,0,0,0,0
1992,3408,12,1,13,1,5,6,0,0,0,0,0,0
1992,3420,2,0,2,1,0,1,0,0,0,0,0,0
1992,3498,282,32,314,24,50,74,0,0,0,0,0,0
1992,3499,5468,501,5969,1016,1516,2532,0,0,0,0,0,0
1992,3500,16,1,17,0,3,3,1,0,1,9,8,17
1992,3501,19,2,21,1,3,4,0,0,0,0,0,0
1992,3600,794,141,935,129,354,483,283,77,360,125,184,309
1992,3601,35,1,36,1,13,14,0,0,0,0,0,0
1992,3602,75,3,78,12,46,58,0,0,0,0,0,0
1992,3603,60,2,62,5,21,26,0,0,0,0,0,0
1992,3604,102,4,106,9,48,57,0,0,0,0,0,0
1992,3605,48,4,52,1,21,22,0,0,0,0,0,0
1992,3607,169,10,179,18,71,89,0,0,0,0,0,0
1992,3608,67,3,70,9,16,25,0,0,0,0,0,0
1992,3609,93,7,100,7,41,48,0,0,0,0,0,0
1992,3610,237,16,253,32,112,144,0,0,0,0,0,0
1992,3611,75,3,78,7,26,33,0,0,0,0,0,0
1992,3613,18,1,19,2,6,8,0,0,0,0,0,0
1992,3614,10,0,10,1,3,4,0,0,0,0,0,0
1992,3700,654,93,747,85,336,421,670,130,800,172,296,468
1992,3701,75,2,77,4,24,28,0,0,0,0,0,0
1992,3702,137,17,154,15,66,81,0,0,0,0,0,0
1992,3703,39,3,42,3,12,15,0,0,0,0,0,0
1992,3705,117,7,124,17,62,79,0,0,0,0,0,0
1992,3706,125,12,137,10,55,65,0,0,0,0,0,0
1992,3708,52,5,57,3,16,19,0,0,0,0,0,0
1992,3709,68,5,73,5,25,30,0,0,0,0,0,0
1992,3710,149,17,166,23,63,86,0,0,0,0,0,0
1992,3711,1657,246,1903,293,545,838,0,0,0,0,0,0
1992,3714,19,2,21,2,10,12,0,0,0,0,0,0
1992,3797,24,4,28,16,5,21,0,0,0,0,0,0
1992,3800,0,0,0,0,0,0,0,0,0,0,0,0
1992,3801,1620,227,1847,135,279,414,0,0,0,0,0,0
1992,3803,15,4,19,1,4,5,0,0,0,0,0,0
1992,3897,19,6,25,27,17,44,0,0,0,0,0,0
1992,3900,205,20,225,22,107,129,0,0,0,0,0,0
1992,3901,8,0,8,1,4,5,0,0,0,0,0,0
1992,3902,66,3,69,1,17,18,0,0,0,4,11,15
1992,3903,43,3,46,6,16,22,0,0,0,0,0,0
1992,3904,9,2,11,2,4,6,0,0,0,0,0,0
1992,3905,281,26,307,45,116,161,0,0,0,0,0,0
1992,3906,40,2,42,4,12,16,0,0,0,0,0,0
1992,4000,124,4,128,5,45,50,2,0,2,69,35,104
1992,4001,18,2,20,1,7,8,0,0,0,0,0,0
1992,4002,14,1,15,0,7,7,0,0,0,0,0,0
1992,4003,16,1,17,0,7,7,0,0,0,0,0,0
1992,4004,29,2,31,0,7,7,0,0,0,0,0,0
1992,4005,23,1,24,0,11,11,0,0,0,0,0,0
1992,4006,53,3,56,7,20,27,0,0,0,0,0,0
1992,4007,9,2,11,1,9,10,0,0,0,0,0,0
1992,4008,24,4,28,2,6,8,0,0,0,0,0,0
1992,4100,189,15,204,25,44,69,102,8,110,36,37,73
1992,4101,19,1,20,2,3,5,0,0,0,0,0,0
1992,4102,30,2,32,4,8,12,0,0,0,0,0,0
1992,4103,11,4,15,3,0,3,0,0,0,0,0,0
1992,4104,43,2,45,4,15,19,0,0,0,0,0,0
1992,4105,11,1,12,0,4,4,0,0,0,0,0,0
1992,4106,100,9,109,6,28,34,0,0,0,0,0,0
1992,4107,12,1,13,0,2,2,0,0,0,0,0,0
1992,4108,25,3,28,1,6,7,0,0,0,0,0,0
1992,4109,37,5,42,5,16,21,0,0,0,0,0,0
1992,4110,22,1,23,1,8,9,0,0,0,0,0,0
1992,4111,40,1,41,1,12,13,0,0,0,0,0,0
1992,4113,69,5,74,8,28,36,0,0,0,0,0,0
1992,4114,46,2,48,0,10,10,0,0,0,0,0,0
1992,4115,33,2,35,2,10,12,0,0,0,0,0,0
1992,4116,93,10,103,2,40,42,0,0,0,0,0,0
1992,4117,67,5,72,6,31,37,0,0,0,0,0,0
1992,4119,8,0,8,0,0,0,0,0,0,0,0,0
1992,4120,37,5,42,5,10,15,0,0,0,0,0,0
1992,4127,30,4,34,1,7,8,0,0,0,0,0,0
1992,4200,196,11,207,19,74,93,0,0,0,0,0,0
1992,4201,6,2,8,0,1,1,0,0,0,0,0,0
1992,4202,39,2,41,1,6,7,0,0,0,4,4,8
1992,4203,128,12,140,15,57,72,0,0,0,0,0,0
1992,4204,70,5,75,1,25,26,0,0,0,0,0,0
1992,4297,21,4,25,5,7,12,0,0,0,0,0,0
1992,4300,354,63,417,23,90,113,0,0,0,0,0,0
1992,4302,36,4,40,0,15,15,0,0,0,0,0,0
1992,4304,43,3,46,7,19,26,0,0,0,1,2,3
1992,4305,25,3,28,4,10,14,0,0,0,0,0,0
1992,4307,38,2,40,15,10,25,0,0,0,0,0,0
1992,4308,65,10,75,8,21,29,0,0,0,0,0,0
1992,4310,25,2,27,0,13,13,0,0,0,0,0,0
1992,4311,77,5,82,4,31,35,0,0,0,0,0,0
1992,4312,75,19,94,28,47,75,0,0,0,0,0,0
1992,4313,1095,79,1174,85,322,407,0,0,0,0,0,0
1992,4314,140,5,145,4,32,36,0,0,0,0,0,0
1992,4316,119,3,122,18,39,57,0,0,0,0,0,0
1992,4317,18,2,20,3,15,18,0,0,0,0,0,0
1992,4320,8,0,8,3,7,10,0,0,0,0,0,0
1992,4321,8,1,9,0,2,2,0,0,0,0,0,0
1992,4327,10,0,10,0,1,1,0,0,0,0,0,0
1992,4400,96,3,99,2,28,30,0,0,0,0,0,0
1992,4401,22,0,22,16,0,16,0,0,0,0,0,0
1992,4402,69,6,75,12,26,38,0,0,0,0,0,0
1992,4403,52,1,53,1,17,18,0,0,0,0,0,0
1992,4404,16,1,17,1,7,8,0,0,0,0,0,0
1992,4405,4,2,6,1,3,4,0,0,0,0,0,0
1992,4497,11,4,15,6,7,13,0,0,0,0,0,0
1992,4500,59,8,67,10,42,52,55,21,76,19,24,43
1992,4501,14,0,14,2,6,8,0,0,0,0,0,0
1992,4502,91,1,92,6,66,72,0,0,0,0,0,0
1992,4600,9,1,10,0,0,0,0,0,0,1,3,4
1992,4700,47,1,48,2,11,13,0,0,0,0,0,0
1992,4701,2,0,2,1,2,3,0,0,0,0,0,0
1992,4703,1,0,1,0,0,0,0,0,0,0,0,0
1992,4706,9,0,9,0,0,0,0,0,0,0,0,0
1992,4707,3,0,3,0,0,0,0,0,0,0,0,0
1992,4708,9,0,9,1,3,4,0,0,0,0,0,0
1992,4709,14,0,14,5,2,7,0,0,0,0,0,0
1992,4710,3,0,3,0,0,0,0,0,0,0,0,0
1992,4800,85,3,88,5,53,58,3,0,3,168,65,233
1992,4801,32,0,32,2,13,15,0,0,0,0,0,0
1992,4802,15,1,16,0,3,3,0,0,0,0,0,0
1992,4803,76,6,82,15,38,53,0,0,0,0,0,0
1992,4804,8,1,9,0,1,1,0,0,0,0,0,0
1992,4805,22,1,23,2,8,10,0,0,0,0,0,0
1992,4806,64,7,71,6,43,49,0,0,0,0,0,0
1992,4807,124,8,132,9,59,68,0,0,0,0,0,0
1992,4900,196,6,202,14,74,88,0,0,0,0,0,0
1992,4901,9,1,10,0,5,5,0,0,0,0,0,0
1992,4902,12,1,13,2,5,7,0,0,0,0,0,0
1992,4903,16,0,16,1,8,9,0,0,0,0,0,0
1992,4904,44,2,46,11,18,29,0,0,0,0,0,0
1992,4905,129,7,136,13,52,65,0,0,0,0,0,0
1992,4906,14,0,14,1,5,6,0,0,0,0,0,0
1992,4907,13,1,14,2,4,6,0,0,0,0,0,0
1992,4908,51,3,54,1,23,24,0,0,0,0,0,0
1992,4909,8,1,9,2,11,13,0,0,0,0,0,0
1992,4914,6,1,7,1,1,2,0,0,0,0,0,0
1992,5000,138,8,146,5,56,61,5,0,5,120,70,190
1992,5001,32,1,33,8,11,19,0,0,0,0,0,0
1992,5002,194,5,199,17,68,85,0,0,0,0,0,0
1992,5003,7,2,9,0,0,0,0,0,0,0,0,0
1992,5004,24,0,24,3,5,8,0,0,0,0,0,0
1992,5005,14,0,14,0,2,2,0,0,0,0,0,0
1992,5006,15,0,15,2,3,5,0,0,0,0,0,0
1992,5007,50,2,52,2,22,24,0,0,0,0,0,0
1992,5008,8,0,8,1,1,2,0,0,0,0,0,0
1992,5009,6,0,6,0,1,1,0,0,0,0,0,0
1992,5010,8,1,9,2,2,4,0,0,0,0,0,0
1992,5100,50,3,53,7,19,26,17,7,24,2,1,3
1992,5102,38,2,40,6,11,17,0,0,0,0,0,0
1992,5200,43,2,45,2,18,20,13,3,16,1,3,4
1992,5201,14,1,15,1,5,6,0,0,0,0,0,0
1992,5202,22,1,23,1,10,11,0,0,0,0,0,0
1992,5300,24,0,24,0,6,6,0,0,0,0,0,0
1992,5400,153,12,165,3,49,52,108,11,119,11,9,20
1992,5401,18,0,18,1,5,6,0,0,0,0,0,0
1992,5402,13,0,13,0,1,1,0,0,0,0,0,0
1992,5403,10,0,10,0,1,1,0,0,0,0,0,0
1992,5404,12,2,14,2,3,5,0,0,0,0,0,0
1992,5405,34,4,38,4,16,20,0,0,0,0,0,0
1992,5406,37,3,40,7,21,28,0,0,0,0,0,0
1992,5407,75,10,85,8,37,45,0,0,0,0,0,0
1992,5408,10,0,10,0,1,1,0,0,0,0,0,0
1992,5411,2,0,2,0,1,1,0,0,0,0,0,0
1992,5500,46,0,46,3,18,21,0,0,0,0,0,0
1992,5501,9,0,9,0,3,3,0,0,0,0,0,0
1992,5600,401,46,447,70,108,178,139,9,148,97,62,159
1992,5604,138,7,145,15,63,78,0,0,0,0,0,0
1992,5605,20,1,21,0,8,8,0,0,0,0,0,0
1992,5606,25,2,27,0,6,6,0,0,0,0,0,0
1992,5608,109,13,122,4,59,63,0,0,0,0,0,0
1992,5609,108,6,114,8,46,54,0,0,0,0,0,0
1992,5700,52,8,60,9,22,31,18,1,19,50,49,99
1992,5701,46,6,52,2,14,16,0,0,0,0,0,0
1992,5702,6,1,7,0,1,1,0,0,0,0,0,0
1992,5703,43,6,49,4,14,18,0,0,0,0,0,0
1992,5704,49,6,55,2,21,23,0,0,0,0,0,0
1992,5797,42,5,47,11,20,31,0,0,0,0,0,0
1992,5800,45,3,48,3,17,20,0,0,0,0,0,0
1992,5801,20,0,20,5,3,8,0,0,0,0,0,0
1992,5802,6,0,6,0,1,1,0,0,0,0,0,0
1992,190P,9,1,10,2,1,3,0,0,0,0,0,0
1992,190R,8,1,9,1,9,10,0,0,0,0,0,0
1993,100,298,41,339,73,134,207,318,64,382,115,160,275
1993,101,87,5,92,5,28,33,0,0,0,4,5,9
1993,102,26,2,28,0,5,5,0,0,0,0,0,0
1993,103,167,20,187,50,79,129,0,0,0,0,0,0
1993,104,26,3,29,1,12,13,0,0,0,0,0,0
1993,105,166,13,179,11,62,73,1,0,1,8,8,16
1993,106,145,16,161,24,60,84,0,0,0,9,9,18
1993,107,56,4,60,4,31,35,0,0,0,0,0,0
1993,108,47,2,49,4,15,19,0,0,0,0,0,0
1993,109,652,61,713,76,198,274,5,1,6,69,27,96
1993,110,18,2,20,1,6,7,0,0,0,0,0,0
1993,111,61,5,66,4,25,29,0,0,0,0,0,0
1993,112,79,4,83,10,27,37,0,0,0,4,1,5
1993,113,58,4,62,7,20,27,0,0,0,0,0,0
1993,114,41,2,43,4,15,19,0,0,0,0,0,0
1993,115,10,1,11,10,5,15,0,0,0,0,0,0
1993,121,136,15,151,21,17,38,0,0,0,0,0,0
1993,122,2,0,2,166,52,218,0,0,0,0,0,0
1993,197,62,14,76,19,23,42,0,0,0,0,0,0
1993,200,9,0,9,0,3,3,0,0,0,0,0,0
1993,300,32,0,32,0,0,0,4,0,4,6,7,13
1993,302,4,0,4,0,0,0,0,0,0,0,0,0
1993,303,9,1,10,0,3,3,0,0,0,0,0,0
1993,305,4,1,5,0,1,1,0,0,0,0,0,0
1993,400,88,2,90,4,28,32,0,0,0,0,0,0
1993,402,54,8,62,6,31,37,0,0,0,0,0,0
1993,403,11,0,11,0,6,6,0,0,0,0,0,0
1993,404,20,1,21,1,9,10,0,0,0,0,0,0
1993,405,23,0,23,2,12,14,0,0,0,0,0,0
1993,497,9,1,10,2,2,4,0,0,0,0,0,0
1993,500,34,3,37,0,14,14,1,0,1,9,8,17
1993,501,4,0,4,1,0,1,0,0,0,0,0,0
1993,600,25,1,26,1,9,10,13,1,14,1,1,2
1993,601,7,1,8,0,1,1,0,0,0,0,0,0
1993,602,5,1,6,0,0,0,0,0,0,0,0,0
1993,700,308,32,340,19,109,128,198,34,232,37,73,110
1993,701,77,4,81,5,30,35,0,0,0,0,0,0
1993,702,15,0,15,0,4,4,0,0,0,0,0,0
1993,703,9,0,9,0,1,1,0,0,0,0,0,0
1993,704,129,8,137,4,42,46,0,0,0,5,0,5
1993,705,32,1,33,0,5,5,0,0,0,0,0,0
1993,706,13,4,17,1,2,3,0,0,0,0,0,0
1993,707,21,1,22,5,14,19,0,0,0,0,0,0
1993,708,64,2,66,3,12,15,0,0,0,0,0,0
1993,709,38,3,41,2,18,20,0,0,0,0,0,0
1993,710,170,9,179,11,62,73,0,0,0,3,2,5
1993,711,37,0,37,0,7,7,0,0,0,0,0,0
1993,712,72,6,78,4,26,30,0,0,0,0,0,0
1993,713,6,2,8,0,1,1,0,0,0,0,0,0
1993,714,41,1,42,1,10,11,0,0,0,0,0,0
1993,716,10,1,11,0,1,1,0,0,0,0,0,0
1993,721,14,4,18,2,3,5,0,0,0,0,0,0
1993,725,5,1,6,0,0,0,0,0,0,0,0,0
1993,800,24,2,26,0,8,8,2,0,2,0,0,0
1993,801,12,0,12,0,1,1,0,0,0,0,0,0
1993,900,107,2,109,3,26,29,17,0,17,55,47,102
1993,901,18,0,18,1,3,4,0,0,0,0,0,0
1993,902,48,3,51,3,16,19,0,0,0,0,0,0
1993,923,3,1,4,2,2,4,0,0,0,0,0,0
1993,1000,290,24,314,42,104,146,0,0,0,0,0,0
1993,1001,63,6,69,4,27,31,0,0,0,0,0,0
1993,1002,16,0,16,1,6,7,0,0,0,0,0,0
1993,1003,7,1,8,0,4,4,0,0,0,0,0,0
1993,1004,6,0,6,0,0,0,0,0,0,0,0,0
1993,1005,397,35,432,61,175,236,0,0,0,0,0,0
1993,1006,7,0,7,0,5,5,0,0,0,0,0,0
1993,1007,13,0,13,0,2,2,0,0,0,0,0,0
1993,1008,10,0,10,1,4,5,0,0,0,0,0,0
1993,1011,8,0,8,0,1,1,0,0,0,0,0,0
1993,1012,22,0,22,3,6,9,0,0,0,0,0,0
1993,1013,20,2,22,1,7,8,0,0,0,0,0,0
1993,1015,19,2,21,1,11,12,0,0,0,0,0,0
1993,1017,9,2,11,0,1,1,0,0,0,0,0,0
1993,1031,4,0,4,0,1,1,0,0,0,0,0,0
1993,1097,12,3,15,7,7,14,0,0,0,0,0,0
1993,1100,20,0,20,1,9,10,1,0,1,12,8,20
1993,1101,9,0,9,0,1,1,0,0,0,0,0,0
1993,1102,8,0,8,1,1,2,0,0,0,0,0,0
1993,1200,66,4,70,3,22,25,0,0,0,0,0,0
1993,1201,20,0,20,2,6,8,0,0,0,0,0,0
1993,1202,3,0,3,0,0,0,0,0,0,0,0,0
1993,1203,41,4,45,4,15,19,0,0,0,0,0,0
1993,1204,2,0,2,0,0,0,0,0,0,0,0,0
1993,1205,12,2,14,0,5,5,0,0,0,0,0,0
1993,1206,3,0,3,0,0,0,0,0,0,0,0,0
1993,1207,6,0,6,0,0,0,0,0,0,0,0,0
1993,1208,10,0,10,2,5,7,0,0,0,0,0,0
1993,1211,23,1,24,0,0,0,0,0,0,0,0,0
1993,1300,65,5,70,2,34,36,53,6,59,25,32,57
1993,1301,26,1,27,0,10,10,0,0,0,0,0,0
1993,1302,26,3,29,8,11,19,0,0,0,0,0,0
1993,1303,5,0,5,0,1,1,0,0,0,0,0,0
1993,1304,46,3,49,9,21,30,0,0,0,0,0,0
1993,1305,7,0,7,3,1,4,0,0,0,0,0,0
1993,1306,11,2,13,0,0,0,0,0,0,0,0,0
1993,1307,4,0,4,0,0,0,0,0,0,0,0,0
1993,1400,25,1,26,0,4,4,12,1,13,5,11,16
1993,1401,14,0,14,0,8,8,0,0,0,0,0,0
1993,1500,284,21,305,29,146,175,0,0,0,0,0,0
1993,1501,11,0,11,0,6,6,0,0,0,0,0,0
1993,1502,228,6,234,10,74,84,0,0,0,0,0,0
1993,1503,33,4,37,0,9,9,4,0,4,0,0,0
1993,1506,29,2,31,0,9,9,0,0,0,0,0,0
1993,1507,12,2,14,0,6,6,0,0,0,0,0,0
1993,1508,14,0,14,0,6,6,0,0,0,0,0,0
1993,1511,12,1,13,1,6,7,0,0,0,0,0,0
1993,1513,32,6,38,14,11,25,0,0,0,0,0,0
1993,1514,4,0,4,0,0,0,0,0,0,0,0,0
1993,1515,6,0,6,0,4,4,0,0,0,0,0,0
1993,1597,9,0,9,6,0,6,0,0,0,0,0,0
1993,1600,62,2,64,6,30,36,1,0,1,38,19,57
1993,1601,12,1,13,0,7,7,0,0,0,0,0,0
1993,1602,36,0,36,0,13,13,0,0,0,0,0,0
1993,1603,19,1,20,1,5,6,0,0,0,0,0,0
1993,1700,53,2,55,2,21,23,34,17,51,1,10,11
1993,1701,12,0,12,0,2,2,0,0,0,0,0,0
1993,1702,16,0,16,1,6,7,0,0,0,0,0,0
1993,1703,4,0,4,0,0,0,0,0,0,0,0,0
1993,1800,19,0,19,0,5,5,2,1,3,33,17,50
1993,1801,13,1,14,0,1,1,0,0,0,0,0,0
1993,1900,4533,594,5127,719,1449,2168,0,0,0,0,0,0
1993,1901,79,7,86,12,40,52,0,0,0,3,3,6
1993,1902,72,5,77,4,14,18,0,0,0,2,2,4
1993,1905,54,2,56,1,21,22,0,0,0,4,0,4
1993,1906,69,2,71,3,18,21,0,0,0,0,0,0
1993,1907,39,1,40,2,11,13,0,0,0,1,2,3
1993,1909,50,6,56,5,19,24,0,0,0,0,0,0
1993,1910,123,5,128,33,40,73,0,0,0,5,4,9
1993,1912,141,9,150,17,58,75,0,0,0,8,2,10
1993,1913,36,2,38,1,13,14,0,0,0,4,1,5
1993,1915,119,6,125,50,69,119,0,0,0,5,0,5
1993,1916,51,1,52,2,21,23,0,0,0,4,0,4
1993,1918,110,7,117,15,28,43,0,0,0,2,0,2
1993,1919,18,1,19,0,0,0,0,0,0,0,0,0
1993,1920,115,4,119,2,31,33,0,0,0,0,0,0
1993,1922,116,9,125,12,14,26,0,0,0,5,0,5
1993,1923,55,8,63,1,12,13,0,0,0,4,3,7
1993,1924,80,9,89,3,13,16,0,0,0,3,3,6
1993,1925,194,21,215,18,68,86,1,0,1,6,7,13
1993,1926,47,5,52,3,13,16,0,0,0,3,3,6
1993,1928,85,9,94,8,37,45,0,0,0,6,0,6
1993,1929,33,3,36,2,17,19,0,0,0,0,0,0
1993,1931,63,2,65,6,29,35,0,0,0,3,2,5
1993,1933,192,14,206,14,54,68,1,0,1,3,8,11
1993,1934,20,0,20,0,6,6,0,0,0,0,0,0
1993,1938,37,2,39,3,13,16,1,0,1,0,0,0
1993,1941,712,72,784,22,333,355,7,0,7,37,20,57
1993,1942,6471,1140,7611,664,1480,2144,26,0,26,245,73,318
1993,1944,52,8,60,16,16,32,0,0,0,4,1,5
1993,1945,26,0,26,5,5,10,0,0,0,0,0,0
1993,1946,52,2,54,0,18,18,0,0,0,2,0,2
1993,1947,83,4,87,8,24,32,0,0,0,0,0,0
1993,1948,71,9,80,3,34,37,0,0,0,5,0,5
1993,1951,21,2,23,3,9,12,0,0,0,0,0,0
1993,1953,196,24,220,34,73,107,3,0,3,10,7,17
1993,1955,167,6,173,14,81,95,1,0,1,12,6,18
1993,1956,92,4,96,13,50,63,0,0,0,3,6,9
1993,1961,32,1,33,3,11,14,0,0,0,0,0,0
1993,1962,49,4,53,2,9,11,0,0,0,0,0,0
1993,1963,21,4,25,0,6,6,0,0,0,0,0,0
1993,1965,163,25,188,95,131,226,0,0,0,7,6,13
1993,1966,13,0,13,2,3,5,0,0,0,0,0,0
1993,1967,27,3,30,1,5,6,0,0,0,3,2,5
1993,1969,87,3,90,6,20,26,0,0,0,3,1,4
1993,1970,29,2,31,5,12,17,0,0,0,4,0,4
1993,1972,228,10,238,11,56,67,0,0,0,6,7,13
1993,1973,52,3,55,4,14,18,0,0,0,0,0,0
1993,1975,106,8,114,8,30,38,0,0,0,5,3,8
1993,1976,90,3,93,5,20,25,0,0,0,6,10,16
1993,1978,10,2,12,4,10,14,0,0,0,0,0,0
1993,1981,10,1,11,4,4,8,0,0,0,0,0,0
1993,1982,14,4,18,3,2,5,0,0,0,0,0,0
1993,1983,14,2,16,4,11,15,0,0,0,0,0,0
1993,1984,14,1,15,3,2,5,0,0,0,0,0,0
1993,1997,43,11,54,6,9,15,0,0,0,0,0,0
1993,2000,53,3,56,1,18,19,0,0,0,0,0,0
1993,2001,12,0,12,4,8,12,0,0,0,0,0,0
1993,2002,41,2,43,13,2,15,0,0,0,0,0,0
1993,2100,101,14,115,13,46,59,40,17,57,7,10,17
1993,2101,7,0,7,0,2,2,0,0,0,0,0,0
1993,2103,9,1,10,1,3,4,0,0,0,0,0,0
1993,2104,29,2,31,1,8,9,0,0,0,0,0,0
1993,2105,20,1,21,3,11,14,0,0,0,0,0,0
1993,2106,50,2,52,3,20,23,0,0,0,0,0,0
1993,2107,8,0,8,1,0,1,0,0,0,0,0,0
1993,2108,16,1,17,1,5,6,0,0,0,0,0,0
1993,2109,63,4,67,2,24,26,0,0,0,0,0,0
1993,2110,19,0,19,0,5,5,0,0,0,0,0,0
1993,2111,12,2,14,1,2,3,0,0,0,0,0,0
1993,2113,8,0,8,0,1,1,0,0,0,0,0,0
1993,2116,9,0,9,0,1,1,0,0,0,0,0,0
1993,2200,24,3,27,0,0,0,0,0,0,6,6,12
1993,2300,62,1,63,1,17,18,0,0,0,0,0,0
1993,2301,17,1,18,0,3,3,0,0,0,2,3,5
1993,2303,23,1,24,1,8,9,0,0,0,0,0,0
1993,2304,12,0,12,1,5,6,0,0,0,0,0,0
1993,2400,63,1,64,6,15,21,0,0,0,0,0,0
1993,2401,21,1,22,2,5,7,0,0,0,0,0,0
1993,2402,5,0,5,0,0,0,0,0,0,0,0,0
1993,2403,7,1,8,0,1,1,0,0,0,0,0,0
1993,2404,14,1,15,0,5,5,0,0,0,0,0,0
1993,2405,21,2,23,1,12,13,0,0,0,0,0,0
1993,2406,70,3,73,6,26,32,0,0,0,0,0,0
1993,2410,13,6,19,0,0,0,0,0,0,0,0,0
1993,2500,9,1,10,0,0,0,0,0,0,0,0,0
1993,2501,8,0,8,0,1,1,0,0,0,0,0,0
1993,2600,24,1,25,0,2,2,0,0,0,8,7,15
1993,2601,14,1,15,0,3,3,0,0,0,0,0,0
1993,2700,141,7,148,5,46,51,103,26,129,6,19,25
1993,2701,14,1,15,4,6,10,0,0,0,0,0,0
1993,2702,3,0,3,0,0,0,0,0,0,0,0,0
1993,2703,9,0,9,0,1,1,0,0,0,0,0,0
1993,2704,9,0,9,0,1,1,0,0,0,0,0,0
1993,2705,14,0,14,1,5,6,0,0,0,0,0,0
1993,2706,53,3,56,2,5,7,0,0,0,4,5,9
1993,2707,24,2,26,4,7,11,0,0,0,0,0,0
1993,2708,133,5,138,8,35,43,0,0,0,0,0,0
1993,2709,5,0,5,0,0,0,0,0,0,0,0,0
1993,2710,35,4,39,3,8,11,0,0,0,0,0,0
1993,2711,11,0,11,1,2,3,0,0,0,0,0,0
1993,2712,23,1,24,1,4,5,0,0,0,0,0,0
1993,2714,8,0,8,0,0,0,0,0,0,0,0,0
1993,2800,62,4,66,1,16,17,0,0,0,0,0,0
1993,2801,8,1,9,2,1,3,0,0,0,0,0,0
1993,2802,61,5,66,8,32,40,0,0,0,0,0,0
1993,2803,11,1,12,0,4,4,0,0,0,0,0,0
1993,2808,6,2,8,0,0,0,0,0,0,0,0,0
1993,2900,48,3,51,2,52,54,0,0,0,1,1,2
1993,2901,18,0,18,1,7,8,0,0,0,0,0,0
1993,2902,8,0,8,0,2,2,0,0,0,0,0,0
1993,3000,616,66,682,223,372,595,428,80,508,233,70,303
1993,3001,323,23,346,26,111,137,1,0,1,16,11,27
1993,3002,99,7,106,1,25,26,0,0,0,0,0,0
1993,3003,83,3,86,6,34,40,0,0,0,6,0,6
1993,3004,129,9,138,15,36,51,1,0,1,10,1,11
1993,3005,47,6,53,2,23,25,0,0,0,2,0,2
1993,3006,23,1,24,0,6,6,0,0,0,0,0,0
1993,3007,55,6,61,4,19,23,0,0,0,0,0,0
1993,3008,136,10,146,11,54,65,0,0,0,5,0,5
1993,3009,154,6,160,14,52,66,0,0,0,0,0,0
1993,3010,222,8,230,29,99,128,1,0,1,11,8,19
1993,3011,40,6,46,31,2,33,0,0,0,0,0,0
1993,3012,59,4,63,3,24,27,0,0,0,0,0,0
1993,3013,24,0,24,2,4,6,0,0,0,0,0,0
1993,3014,137,6,143,12,49,61,0,0,0,6,2,8
1993,3015,132,8,140,5,30,35,0,0,0,0,0,0
1993,3016,50,1,51,3,13,16,0,0,0,0,0,0
1993,3017,0,0,0,0,0,0,0,0,0,0,0,0
1993,3019,372,15,387,41,164,205,0,0,0,17,7,24
1993,3020,30,3,33,3,12,15,0,0,0,0,0,0
1993,3022,79,5,84,4,31,35,0,0,0,0,0,0
1993,3024,98,4,102,5,41,46,0,0,0,0,0,0
1993,3026,121,8,129,5,49,54,0,0,0,3,1,4
1993,3027,12,2,14,7,12,19,0,0,0,0,0,0
1993,3032,44,6,50,31,16,47,0,0,0,0,0,0
1993,3091,252,35,287,50,78,128,0,0,0,0,0,0
1993,3097,18,4,22,2,6,8,0,0,0,0,0,0
1993,3100,123,14,137,5,59,64,47,11,58,17,29,46
1993,3101,19,1,20,1,6,7,0,0,0,0,0,0
1993,3102,5,0,5,0,0,0,0,0,0,0,0,0
1993,3103,11,2,13,0,4,4,0,0,0,0,0,0
1993,3104,25,2,27,5,9,14,0,0,0,0,0,0
1993,3105,63,4,67,8,32,40,0,0,0,3,3,6
1993,3200,34,0,34,1,10,11,0,0,0,9,8,17
1993,3300,731,88,819,67,346,413,193,32,225,271,141,412
1993,3301,25,3,28,1,13,14,0,0,0,0,0,0
1993,3302,16,0,16,2,5,7,0,0,0,0,0,0
1993,3303,14,2,16,1,8,9,0,0,0,0,0,0
1993,3305,22,0,22,2,8,10,0,0,0,0,0,0
1993,3308,45,3,48,4,11,15,0,0,0,0,0,0
1993,3309,40,1,41,3,18,21,0,0,0,0,0,0
1993,3311,73,4,77,12,24,36,0,0,0,3,4,7
1993,3312,38,4,42,0,23,23,0,0,0,0,0,0
1993,3313,277,25,302,26,116,142,0,0,0,0,0,0
1993,3314,25,1,26,2,10,12,0,0,0,0,0,0
1993,3315,102,12,114,5,47,52,0,0,0,0,0,0
1993,3324,24,6,30,0,5,5,0,0,0,0,0,0
1993,3325,38,3,41,7,16,23,0,0,0,0,0,0
1993,3326,4,0,4,0,0,0,0,0,0,0,0,0
1993,3327,4,2,6,0,0,0,0,0,0,0,0,0
1993,3342,23,0,23,0,7,7,0,0,0,0,0,0
1993,3397,17,2,19,0,0,0,0,0,0,0,0,0
1993,3400,596,92,688,71,187,258,296,78,374,80,93,173
1993,3401,33,0,33,1,8,9,0,0,0,0,0,0
1993,3402,16,1,17,3,6,9,0,0,0,0,0,0
1993,3403,2,0,2,0,0,0,0,0,0,0,0,0
1993,3404,515,63,578,75,236,311,0,0,0,0,0,0
1993,3408,12,1,13,1,5,6,0,0,0,0,0,0
1993,3412,23,3,26,1,13,14,0,0,0,0,0,0
1993,3420,3,0,3,0,1,1,0,0,0,0,0,0
1993,3433,2,2,4,0,0,0,0,0,0,0,0,0
1993,3498,231,21,252,18,42,60,0,0,0,0,0,0
1993,3499,5246,480,5726,1012,1513,2525,0,0,0,0,0,0
1993,3500,15,1,16,0,2,2,0,0,0,0,0,0
1993,3501,20,3,23,2,3,5,0,0,0,0,0,0
1993,3504,4,2,6,0,0,0,0,0,0,0,0,0
1993,3600,729,109,838,83,83,166,303,45,348,130,130,260
1993,3601,37,1,38,1,12,13,0,0,0,0,0,0
1993,3602,75,3,78,8,26,34,0,0,0,0,0,0
1993,3603,57,3,60,18,5,23,0,0,0,0,0,0
1993,3604,105,7,112,7,46,53,0,0,0,0,0,0
1993,3605,47,4,51,1,21,22,0,0,0,0,0,0
1993,3607,176,12,188,28,82,110,0,0,0,0,0,0
1993,3608,65,3,68,10,16,26,0,0,0,0,0,0
1993,3609,87,6,93,5,36,41,0,0,0,0,0,0
1993,3610,237,14,251,33,109,142,0,0,0,0,0,0
1993,3611,76,3,79,5,26,31,0,0,0,0,0,0
1993,3613,19,0,19,8,3,11,0,0,0,0,0,0
1993,3614,9,0,9,2,4,6,0,0,0,0,0,0
1993,3616,68,6,74,7,28,35,0,0,0,0,0,0
1993,3621,8,2,10,0,5,5,0,0,0,0,0,0
1993,3625,7,1,8,0,0,0,0,0,0,0,0,0
1993,3700,665,94,759,95,375,470,650,124,774,191,326,517
1993,3701,75,2,77,4,24,28,0,0,0,0,0,0
1993,3702,142,20,162,26,60,86,0,0,0,0,0,0
1993,3703,36,4,40,5,12,17,0,0,0,0,0,0
1993,3705,115,8,123,16,56,72,0,0,0,0,0,0
1993,3706,136,11,147,12,56,68,0,0,0,0,0,0
1993,3708,56,5,61,3,20,23,0,0,0,0,0,0
1993,3709,64,3,67,3,24,27,0,0,0,0,0,0
1993,3710,149,11,160,18,58,76,0,0,0,0,0,0
1993,3711,1606,255,1861,487,265,752,0,0,0,0,0,0
1993,3714,19,1,20,4,9,13,0,0,0,0,0,0
1993,3715,101,12,113,1,15,16,0,0,0,0,0,0
1993,3722,10,2,12,0,0,0,0,0,0,0,0,0
1993,3723,27,10,37,1,3,4,0,0,0,0,0,0
1993,3724,5,0,5,0,0,0,0,0,0,0,0,0
1993,3727,0,0,0,0,0,0,5,3,8,0,0,0
1993,3797,22,4,26,14,9,23,0,0,0,0,0,0
1993,3800,0,0,0,0,0,0,0,0,0,0,0,0
1993,3801,1579,225,1804,117,272,389,0,0,0,0,0,0
1993,3803,16,4,20,5,7,12,0,0,0,0,0,0
1993,3816,0,0,0,11,2,13,0,0,0,0,0,0
1993,3897,18,6,24,21,16,37,0,0,0,0,0,0
1993,3900,152,13,165,50,103,153,0,0,0,0,0,0
1993,3901,8,0,8,1,4,5,0,0,0,0,0,0
1993,3902,66,3,69,1,16,17,0,0,0,4,11,15
1993,3903,39,3,42,4,15,19,0,0,0,0,0,0
1993,3904,9,2,11,1,6,7,0,0,0,0,0,0
1993,3905,294,30,324,44,121,165,0,0,0,0,0,0
1993,3906,40,2,42,6,12,18,0,0,0,0,0,0
1993,3914,7,0,7,1,5,6,0,0,0,0,0,0
1993,3915,10,3,13,3,5,8,0,0,0,0,0,0
1993,4000,116,4,120,6,39,45,77,23,100,7,25,32
1993,4001,18,2,20,1,7,8,0,0,0,0,0,0
1993,4002,16,1,17,0,7,7,0,0,0,0,0,0
1993,4003,17,1,18,1,5,6,0,0,0,0,0,0
1993,4004,27,2,29,0,6,6,0,0,0,0,0,0
1993,4005,24,0,24,0,11,11,0,0,0,0,0,0
1993,4006,50,3,53,6,18,24,0,0,0,0,0,0
1993,4007,9,2,11,1,9,10,0,0,0,0,0,0
1993,4008,23,4,27,2,6,8,0,0,0,0,0,0
1993,4012,13,6,19,1,2,3,0,0,0,0,0,0
1993,4016,0,0,0,70,28,98,0,0,0,0,0,0
1993,4100,172,18,190,19,64,83,95,7,102,42,31,73
1993,4101,18,2,20,3,2,5,0,0,0,0,0,0
1993,4102,30,1,31,4,8,12,0,0,0,0,0,0
1993,4103,11,4,15,2,3,5,0,0,0,0,0,0
1993,4104,43,2,45,4,15,19,0,0,0,0,0,0
1993,4105,12,1,13,0,3,3,0,0,0,0,0,0
1993,4106,99,8,107,6,27,33,0,0,0,0,0,0
1993,4107,12,1,13,0,1,1,0,0,0,0,0,0
1993,4108,22,3,25,1,6,7,0,0,0,0,0,0
1993,4109,40,6,46,5,15,20,0,0,0,0,0,0
1993,4110,21,0,21,1,6,7,0,0,0,0,0,0
1993,4111,40,1,41,3,9,12,0,0,0,0,0,0
1993,4113,67,5,72,7,27,34,0,0,0,0,0,0
1993,4114,45,2,47,0,11,11,0,0,0,0,0,0
1993,4115,33,1,34,2,10,12,0,0,0,0,0,0
1993,4116,92,9,101,4,38,42,0,0,0,0,0,0
1993,4117,70,5,75,8,32,40,0,0,0,0,0,0
1993,4119,10,0,10,1,0,1,0,0,0,0,0,0
1993,4120,36,5,41,5,8,13,0,0,0,0,0,0
1993,4127,33,3,36,1,7,8,0,0,0,0,0,0
1993,4200,228,13,241,17,82,99,0,0,0,0,0,0
1993,4201,5,1,6,0,1,1,0,0,0,0,0,0
1993,4202,39,2,41,1,6,7,0,0,0,4,4,8
1993,4203,125,9,134,17,63,80,0,0,0,0,0,0
1993,4204,70,5,75,1,23,24,0,0,0,0,0,0
1993,4209,3,0,3,2,1,3,0,0,0,0,0,0
1993,4211,2,0,2,4,2,6,0,0,0,0,0,0
1993,4297,20,4,24,0,0,0,0,0,0,0,0,0
1993,4300,345,62,407,20,77,97,0,0,0,0,0,0
1993,4302,34,4,38,1,17,18,0,0,0,0,0,0
1993,4304,42,3,45,21,6,27,0,0,0,2,3,5
1993,4305,25,3,28,6,11,17,0,0,0,0,0,0
1993,4307,38,2,40,6,15,21,0,0,0,0,0,0
1993,4308,66,8,74,7,23,30,0,0,0,0,0,0
1993,4310,18,2,20,1,12,13,0,0,0,0,0,0
1993,4311,76,3,79,8,22,30,0,0,0,0,0,0
1993,4312,75,17,92,26,49,75,0,0,0,0,0,0
1993,4313,1115,88,1203,87,334,421,0,0,0,0,0,0
1993,4314,137,6,143,4,31,35,0,0,0,0,0,0
1993,4316,115,3,118,17,37,54,0,0,0,0,0,0
1993,4317,20,2,22,13,9,22,0,0,0,0,0,0
1993,4320,7,1,8,2,6,8,0,0,0,0,0,0
1993,4321,8,1,9,1,2,3,0,0,0,0,0,0
1993,4327,10,0,10,0,1,1,0,0,0,0,0,0
1993,4400,91,5,96,1,28,29,0,0,0,0,0,0
1993,4401,22,1,23,5,6,11,0,0,0,0,0,0
1993,4402,69,8,77,5,33,38,0,0,0,0,0,0
1993,4403,52,1,53,0,18,18,0,0,0,0,0,0
1993,4404,19,1,20,0,8,8,0,0,0,0,0,0
1993,4405,5,2,7,0,2,2,0,0,0,0,0,0
1993,4497,12,5,17,5,4,9,0,0,0,0,0,0
1993,4500,61,8,69,7,40,47,51,18,69,19,24,43
1993,4501,13,0,13,1,9,10,0,0,0,0,0,0
1993,4502,88,1,89,3,81,84,0,0,0,0,0,0
1993,4505,5,0,5,0,0,0,0,0,0,0,0,0
1993,4600,10,1,11,0,0,0,0,0,0,1,4,5
1993,4700,47,1,48,3,11,14,15,9,24,1,2,3
1993,4701,2,0,2,0,1,1,0,0,0,0,0,0
1993,4703,1,0,1,0,0,0,0,0,0,0,0,0
1993,4706,9,0,9,1,4,5,0,0,0,0,0,0
1993,4707,3,0,3,0,0,0,0,0,0,0,0,0
1993,4708,8,0,8,1,3,4,0,0,0,0,0,0
1993,4709,14,0,14,5,2,7,0,0,0,0,0,0
1993,4710,3,0,3,0,0,0,0,0,0,0,0,0
1993,4800,71,2,73,13,61,74,2,0,2,139,40,179
1993,4801,33,0,33,3,12,15,0,0,0,0,0,0
1993,4802,15,1,16,0,3,3,0,0,0,0,0,0
1993,4803,75,5,80,13,45,58,0,0,0,0,0,0
1993,4804,7,1,8,0,1,1,0,0,0,0,0,0
1993,4805,20,1,21,2,8,10,0,0,0,0,0,0
1993,4806,50,5,55,8,39,47,0,0,0,0,0,0
1993,4807,118,7,125,8,54,62,0,0,0,0,0,0
1993,4900,188,8,196,12,73,85,0,0,0,0,0,0
1993,4901,9,1,10,1,3,4,0,0,0,0,0,0
1993,4902,11,1,12,2,3,5,0,0,0,0,0,0
1993,4903,16,0,16,1,8,9,0,0,0,0,0,0
1993,4904,47,3,50,9,18,27,0,0,0,0,0,0
1993,4905,132,8,140,12,61,73,0,0,0,0,0,0
1993,4906,14,0,14,1,5,6,0,0,0,0,0,0
1993,4907,12,1,13,3,5,8,0,0,0,0,0,0
1993,4908,50,2,52,1,25,26,0,0,0,0,0,0
1993,4909,11,1,12,0,8,8,0,0,0,0,0,0
1993,4911,19,2,21,0,0,0,0,0,0,0,0,0
1993,4914,6,1,7,1,1,2,0,0,0,0,0,0
1993,5000,138,5,143,12,45,57,4,0,4,117,64,181
1993,5001,31,1,32,16,11,27,0,0,0,0,0,0
1993,5002,193,3,196,14,71,85,0,0,0,0,0,0
1993,5003,8,0,8,0,1,1,0,0,0,0,0,0
1993,5004,21,0,21,6,2,8,0,0,0,0,0,0
1993,5005,14,0,14,0,2,2,0,0,0,0,0,0
1993,5006,16,0,16,2,3,5,0,0,0,0,0,0
1993,5007,49,2,51,2,21,23,0,0,0,0,0,0
1993,5008,10,0,10,1,1,2,0,0,0,0,0,0
1993,5009,7,0,7,0,1,1,0,0,0,0,0,0
1993,5010,8,1,9,2,2,4,0,0,0,0,0,0
1993,5100,53,2,55,3,17,20,0,0,0,0,0,0
1993,5102,37,2,39,6,11,17,0,0,0,0,0,0
1993,5200,32,1,33,2,18,20,22,2,24,1,2,3
1993,5201,11,1,12,1,4,5,0,0,0,0,0,0
1993,5202,22,1,23,2,11,13,0,0,0,0,0,0
1993,5300,20,0,20,0,6,6,0,0,0,0,0,0
1993,5400,153,12,165,1,51,52,86,12,98,30,12,42
1993,5401,18,0,18,1,5,6,0,0,0,0,0,0
1993,5402,13,0,13,0,1,1,0,0,0,0,0,0
1993,5403,10,0,10,0,1,1,0,0,0,0,0,0
1993,5404,13,2,15,3,3,6,0,0,0,0,0,0
1993,5405,35,5,40,1,21,22,0,0,0,0,0,0
1993,5406,42,3,45,4,16,20,0,0,0,0,0,0
1993,5407,74,10,84,9,37,46,0,0,0,0,0,0
1993,5408,9,0,9,0,1,1,0,0,0,0,0,0
1993,5411,1,0,1,0,0,0,0,0,0,0,0,0
1993,5500,46,0,46,2,18,20,0,0,0,0,0,0
1993,5501,10,0,10,0,4,4,0,0,0,0,0,0
1993,5502,7,1,8,0,0,0,0,0,0,0,0,0
1993,5600,389,39,428,60,96,156,102,35,137,67,79,146
1993,5604,139,7,146,28,56,84,0,0,0,6,3,9
1993,5605,18,1,19,0,7,7,0,0,0,0,0,0
1993,5606,28,1,29,2,6,8,0,0,0,0,0,0
1993,5608,108,11,119,6,54,60,0,0,0,0,0,0
1993,5609,104,4,108,7,45,52,0,0,0,0,0,0
1993,5615,20,6,26,1,3,4,0,0,0,0,0,0
1993,5700,47,7,54,10,19,29,17,1,18,43,59,102
1993,5701,43,7,50,18,2,20,0,0,0,0,0,0
1993,5702,7,1,8,0,1,1,0,0,0,0,0,0
1993,5703,43,6,49,6,13,19,0,0,0,0,0,0
1993,5704,45,5,50,1,20,21,0,0,0,0,0,0
1993,5797,42,5,47,11,21,32,0,0,0,0,0,0
1993,5800,41,3,44,3,15,18,0,0,0,0,0,0
1993,5801,20,1,21,4,8,12,0,0,0,0,0,0
1993,5802,6,0,6,0,1,1,0,0,0,0,0,0
1993,190P,11,1,12,0,1,1,0,0,0,0,0,0
1993,190R,8,1,9,1,9,10,0,0,0,0,0,0
1993,191C,6,1,7,1,1,2,0,0,0,0,0,0
1993,191E,6,1,7,0,0,0,0,0,0,0,0,0
1994,100,301,38,339,73,134,207,322,60,382,112,156,268
1994,101,88,7,95,5,27,32,0,0,0,4,5,9
1994,102,27,1,28,0,4,4,0,0,0,0,0,0
1994,103,161,21,182,43,67,110,1,0,1,7,8,15
1994,104,28,3,31,2,13,15,0,0,0,0,0,0
1994,105,169,14,183,11,63,74,0,0,0,8,8,16
1994,106,140,16,156,16,60,76,0,0,0,12,7,19
1994,107,60,4,64,7,33,40,0,0,0,0,0,0
1994,108,48,3,51,4,14,18,0,0,0,0,0,0
1994,109,604,61,665,58,195,253,5,1,6,60,22,82
1994,110,18,2,20,5,2,7,0,0,0,0,0,0
1994,111,63,5,68,4,28,32,0,0,0,0,0,0
1994,112,82,4,86,9,27,36,0,0,0,3,2,5
1994,113,55,8,63,10,21,31,0,0,0,2,1,3
1994,114,46,2,48,7,22,29,0,0,0,0,0,0
1994,115,11,1,12,4,1,5,0,0,0,0,0,0
1994,121,132,16,148,24,20,44,0,0,0,0,0,0
1994,122,2,0,2,164,38,202,0,0,0,0,0,0
1994,197,60,11,71,21,23,44,0,0,0,0,0,0
1994,200,8,0,8,0,3,3,0,0,0,0,0,0
1994,300,34,0,34,0,12,12,0,0,0,0,0,0
1994,302,5,0,5,0,0,0,0,0,0,0,0,0
1994,303,9,0,9,0,3,3,0,0,0,0,0,0
1994,305,4,1,5,0,1,1,0,0,0,0,0,0
1994,400,81,2,83,4,26,30,1,0,1,0,0,0
1994,402,56,9,65,6,42,48,0,0,0,0,0,0
1994,403,11,0,11,0,7,7,0,0,0,0,0,0
1994,404,21,2,23,10,1,11,0,0,0,0,0,0
1994,405,23,0,23,0,11,11,0,0,0,0,0,0
1994,497,9,1,10,2,2,4,0,0,0,0,0,0
1994,500,34,3,37,0,14,14,1,0,1,9,8,17
1994,501,6,0,6,1,0,1,0,0,0,0,0,0
1994,503,8,1,9,0,0,0,0,0,0,0,0,0
1994,600,26,1,27,1,3,4,2,0,2,0,7,7
1994,601,7,1,8,0,1,1,0,0,0,0,0,0
1994,602,6,0,6,0,1,1,0,0,0,0,0,0
1994,700,307,37,344,13,114,127,231,0,231,111,0,111
1994,701,78,4,82,5,24,29,0,0,0,0,0,0
1994,702,16,0,16,0,0,0,0,0,0,0,0,0
1994,703,9,0,9,0,2,2,0,0,0,0,0,0
1994,704,135,12,147,7,42,49,0,0,0,5,0,5
1994,705,30,0,30,0,5,5,0,0,0,0,0,0
1994,706,16,4,20,1,2,3,0,0,0,0,0,0
1994,707,20,1,21,1,9,10,0,0,0,0,0,0
1994,708,63,3,66,1,11,12,0,0,0,0,0,0
1994,709,38,3,41,3,16,19,0,0,0,0,0,0
1994,710,170,13,183,17,64,81,0,0,0,6,3,9
1994,711,40,0,40,1,7,8,0,0,0,0,0,0
1994,712,72,6,78,5,23,28,0,0,0,0,0,0
1994,713,7,1,8,0,0,0,0,0,0,0,0,0
1994,714,41,1,42,4,9,13,0,0,0,0,0,0
1994,716,10,2,12,0,1,1,0,0,0,0,0,0
1994,721,15,3,18,2,3,5,0,0,0,0,0,0
1994,800,22,2,24,2,6,8,0,0,0,0,0,0
1994,801,12,0,12,0,1,1,0,0,0,0,0,0
1994,900,134,4,138,4,32,36,1,0,1,46,50,96
1994,901,17,0,17,2,3,5,0,0,0,0,0,0
1994,902,49,3,52,2,18,20,0,0,0,0,0,0
1994,1000,298,24,322,39,121,160,0,0,0,0,0,0
1994,1001,65,7,72,5,27,32,0,0,0,0,0,0
1994,1002,17,0,17,9,0,9,0,0,0,0,0,0
1994,1003,8,1,9,0,4,4,0,0,0,0,0,0
1994,1004,5,0,5,0,1,1,0,0,0,0,0,0
1994,1005,442,41,483,58,169,227,0,0,0,0,0,0
1994,1006,8,1,9,2,2,4,0,0,0,0,0,0
1994,1007,12,1,13,0,2,2,0,0,0,0,0,0
1994,1008,11,0,11,2,3,5,0,0,0,0,0,0
1994,1011,11,0,11,0,1,1,0,0,0,0,0,0
1994,1012,21,0,21,2,5,7,0,0,0,0,0,0
1994,1013,22,1,23,1,7,8,0,0,0,0,0,0
1994,1015,19,2,21,0,11,11,0,0,0,0,0,0
1994,1017,6,1,7,0,1,1,0,0,0,0,0,0
1994,1031,4,0,4,0,1,1,0,0,0,0,0,0
1994,1097,12,3,15,9,9,18,0,0,0,0,0,0
1994,1100,22,0,22,9,4,13,0,0,0,11,7,18
1994,1101,9,0,9,0,1,1,0,0,0,0,0,0
1994,1102,8,0,8,1,1,2,0,0,0,0,0,0
1994,1200,66,3,69,2,24,26,0,0,0,0,0,0
1994,1201,20,0,20,2,6,8,0,0,0,0,0,0
1994,1202,3,0,3,0,0,0,0,0,0,0,0,0
1994,1203,43,5,48,7,20,27,0,0,0,0,0,0
1994,1204,3,0,3,0,0,0,0,0,0,0,0,0
1994,1205,12,2,14,0,4,4,0,0,0,0,0,0
1994,1206,3,0,3,0,0,0,0,0,0,0,0,0
1994,1207,5,1,6,0,0,0,0,0,0,0,0,0
1994,1208,10,0,10,1,4,5,0,0,0,0,0,0
1994,1300,58,5,63,12,25,37,0,0,0,0,0,0
1994,1301,26,1,27,0,10,10,0,0,0,0,0,0
1994,1302,26,1,27,7,10,17,0,0,0,0,0,0
1994,1303,5,0,5,0,1,1,0,0,0,0,0,0
1994,1304,44,3,47,11,24,35,0,0,0,0,0,0
1994,1305,8,0,8,2,1,3,0,0,0,0,0,0
1994,1306,13,1,14,0,1,1,0,0,0,0,0,0
1994,1307,4,0,4,0,0,0,0,0,0,0,0,0
1994,1400,26,2,28,0,4,4,11,0,11,6,9,15
1994,1401,14,0,14,0,7,7,0,0,0,0,0,0
1994,1500,284,21,305,10,140,150,9,0,9,0,0,0
1994,1501,10,0,10,0,7,7,0,0,0,0,0,0
1994,1502,244,6,250,13,80,93,0,0,0,0,0,0
1994,1503,34,3,37,0,8,8,4,0,4,0,0,0
1994,1506,26,2,28,1,8,9,0,0,0,0,0,0
1994,1507,17,2,19,0,6,6,0,0,0,0,0,0
1994,1508,14,0,14,0,5,5,0,0,0,0,0,0
1994,1511,12,1,13,0,6,6,0,0,0,0,0,0
1994,1513,33,7,40,7,13,20,0,0,0,0,0,0
1994,1514,3,0,3,0,0,0,0,0,0,0,0,0
1994,1515,6,0,6,1,4,5,0,0,0,0,0,0
1994,1597,9,0,9,2,3,5,0,0,0,0,0,0
1994,1600,64,1,65,4,32,36,1,0,1,37,17,54
1994,1601,15,1,16,0,6,6,0,0,0,0,0,0
1994,1602,38,1,39,0,16,16,0,0,0,0,0,0
1994,1603,19,2,21,1,5,6,0,0,0,0,0,0
1994,1700,59,2,61,2,20,22,34,12,46,1,9,10
1994,1701,11,0,11,0,2,2,0,0,0,0,0,0
1994,1702,16,0,16,0,6,6,0,0,0,0,0,0
1994,1800,23,0,23,1,5,6,3,0,3,0,0,0
1994,1801,14,2,16,0,1,1,0,0,0,0,0,0
1994,1900,3826,448,4274,664,1345,2009,0,0,0,0,0,0
1994,1901,80,7,87,18,41,59,0,0,0,2,3,5
1994,1902,70,6,76,5,11,16,0,0,0,1,2,3
1994,1905,54,1,55,3,24,27,0,0,0,5,0,5
1994,1906,65,3,68,2,12,14,0,0,0,0,0,0
1994,1907,39,0,39,1,10,11,0,3,3,0,0,0
1994,1909,50,5,55,5,17,22,0,0,0,0,0,0
1994,1910,120,8,128,19,30,49,0,0,0,3,5,8
1994,1912,146,10,156,29,53,82,0,0,0,7,1,8
1994,1913,37,2,39,1,12,13,0,0,0,4,1,5
1994,1915,121,7,128,12,64,76,0,0,0,5,0,5
1994,1916,53,1,54,2,25,27,0,0,0,4,0,4
1994,1918,109,10,119,8,27,35,0,0,0,2,0,2
1994,1920,114,4,118,4,32,36,0,0,0,0,0,0
1994,1922,115,9,124,16,14,30,0,0,0,5,0,5
1994,1923,54,8,62,3,13,16,0,0,0,3,2,5
1994,1924,80,9,89,1,13,14,0,0,0,4,4,8
1994,1925,196,20,216,3,43,46,0,0,0,6,6,12
1994,1926,48,5,53,3,14,17,0,0,0,2,2,4
1994,1928,91,10,101,10,34,44,0,0,0,6,0,6
1994,1929,32,3,35,2,12,14,0,0,0,1,4,5
1994,1931,59,4,63,5,23,28,0,0,0,2,3,5
1994,1933,186,17,203,9,61,70,0,0,0,5,6,11
1994,1934,20,0,20,0,6,6,0,0,0,0,0,0
1994,1938,36,4,40,3,11,14,0,0,0,0,0,0
1994,1941,717,74,791,70,214,284,4,0,4,28,10,38
1994,1942,6601,1243,7844,972,1715,2687,25,0,25,151,37,188
1994,1944,52,8,60,8,19,27,0,1,1,4,1,5
1994,1945,26,0,26,5,5,10,0,0,0,0,0,0
1994,1946,53,2,55,11,31,42,0,0,0,2,0,2
1994,1947,90,4,94,9,31,40,0,0,0,0,0,0
1994,1948,69,11,80,7,33,40,0,0,0,4,1,5
1994,1951,21,2,23,0,0,0,0,0,0,4,6,10
1994,1953,204,26,230,20,63,83,1,1,2,10,6,16
1994,1955,166,7,173,25,79,104,1,0,1,12,7,19
1994,1956,89,4,93,6,44,50,0,0,0,3,6,9
1994,1961,34,1,35,3,11,14,0,0,0,0,0,0
1994,1962,47,5,52,1,9,10,0,0,0,0,0,0
1994,1963,22,4,26,0,5,5,0,0,0,0,0,0
1994,1965,171,25,196,72,79,151,0,0,0,5,6,11
1994,1966,14,0,14,1,5,6,0,0,0,0,0,0
1994,1967,26,4,30,1,6,7,0,0,0,3,2,5
1994,1969,85,4,89,7,24,31,0,0,0,4,1,5
1994,1970,29,2,31,2,13,15,0,0,0,4,0,4
1994,1972,230,9,239,43,56,99,1,0,1,17,12,29
1994,1973,54,3,57,5,16,21,0,0,0,0,0,0
1994,1975,102,8,110,7,26,33,0,0,0,5,2,7
1994,1976,88,3,91,6,15,21,0,0,0,6,10,16
1994,1978,10,2,12,6,10,16,0,0,0,0,0,0
1994,1981,9,1,10,4,5,9,0,0,0,0,0,0
1994,1982,16,4,20,2,3,5,0,0,0,0,0,0
1994,1983,14,2,16,3,12,15,0,0,0,0,0,0
1994,1984,16,2,18,11,14,25,0,0,0,0,0,0
1994,1997,42,11,53,8,8,16,0,0,0,0,0,0
1994,2000,49,4,53,3,14,17,0,0,0,0,0,0
1994,2001,13,0,13,1,5,6,0,0,0,0,0,0
1994,2002,41,3,44,4,12,16,0,0,0,0,0,0
1994,2100,100,15,115,10,52,62,56,17,73,9,13,22
1994,2101,7,0,7,0,1,1,0,0,0,0,0,0
1994,2103,11,0,11,0,5,5,0,0,0,0,0,0
1994,2104,30,2,32,1,8,9,0,0,0,0,0,0
1994,2105,19,3,22,2,11,13,0,0,0,0,0,0
1994,2106,48,3,51,4,20,24,0,0,0,0,0,0
1994,2107,9,0,9,0,0,0,0,0,0,0,0,0
1994,2108,16,1,17,0,6,6,0,0,0,0,0,0
1994,2109,63,4,67,2,28,30,0,0,0,0,0,0
1994,2110,20,0,20,1,4,5,0,0,0,0,0,0
1994,2111,13,2,15,2,1,3,0,0,0,0,0,0
1994,2113,7,0,7,0,1,1,0,0,0,0,0,0
1994,2116,7,1,8,0,1,1,0,0,0,0,0,0
1994,2200,24,3,27,7,6,13,0,0,0,0,0,0
1994,2300,61,1,62,2,15,17,0,0,0,0,0,0
1994,2301,17,1,18,0,3,3,0,0,0,0,1,1
1994,2303,24,1,25,2,10,12,0,0,0,0,0,0
1994,2304,12,0,12,1,4,5,0,0,0,0,0,0
1994,2400,63,1,64,5,15,20,0,0,0,0,0,0
1994,2401,21,1,22,1,5,6,0,0,0,0,0,0
1994,2402,7,0,7,0,0,0,0,0,0,0,0,0
1994,2403,7,1,8,0,1,1,0,0,0,0,0,0
1994,2404,14,1,15,0,6,6,0,0,0,0,0,0
1994,2405,24,2,26,1,11,12,0,0,0,0,0,0
1994,2406,78,3,81,3,32,35,0,0,0,0,0,0
1994,2500,9,1,10,0,0,0,5,4,9,0,0,0
1994,2501,7,0,7,0,1,1,0,0,0,0,0,0
1994,2600,23,1,24,2,2,4,0,0,0,9,7,16
1994,2601,14,1,15,0,3,3,0,0,0,0,0,0
1994,2700,136,7,143,10,51,61,104,22,126,7,19,26
1994,2701,14,1,15,3,6,9,0,0,0,0,0,0
1994,2702,4,0,4,0,0,0,0,0,0,0,0,0
1994,2703,10,0,10,0,1,1,0,0,0,0,0,0
1994,2704,12,0,12,0,1,1,0,0,0,0,0,0
1994,2705,14,0,14,0,2,2,0,0,0,0,0,0
1994,2706,54,4,58,1,4,5,0,0,0,5,5,10
1994,2707,27,2,29,4,6,10,0,0,0,0,0,0
1994,2708,128,6,134,9,32,41,0,0,0,0,0,0
1994,2709,5,0,5,0,0,0,0,0,0,0,0,0
1994,2710,39,4,43,3,7,10,0,0,0,0,0,0
1994,2711,16,0,16,0,2,2,0,0,0,0,0,0
1994,2712,20,2,22,1,4,5,0,0,0,0,0,0
1994,2714,6,0,6,0,0,0,0,0,0,0,0,0
1994,2800,63,4,67,1,16,17,0,0,0,0,0,0
1994,2801,8,1,9,2,1,3,0,0,0,0,0,0
1994,2802,61,4,65,6,33,39,0,0,0,0,0,0
1994,2803,12,0,12,0,4,4,0,0,0,0,0,0
1994,2808,8,1,9,0,0,0,0,0,0,0,0,0
1994,2900,66,3,69,3,29,32,0,0,0,0,0,0
1994,2901,18,0,18,8,0,8,0,0,0,0,0,0
1994,2902,8,0,8,0,2,2,0,0,0,0,0,0
1994,3000,700,84,784,254,398,652,637,115,752,74,99,173
1994,3001,347,28,375,101,41,142,0,0,0,17,8,25
1994,3002,69,7,76,1,22,23,0,0,0,0,0,0
1994,3003,85,2,87,7,38,45,0,0,0,5,0,5
1994,3004,135,7,142,10,48,58,1,0,1,8,1,9
1994,3005,49,4,53,1,22,23,0,0,0,3,0,3
1994,3006,23,1,24,1,5,6,0,0,0,0,0,0
1994,3007,59,6,65,9,21,30,0,0,0,0,0,0
1994,3008,137,10,147,7,57,64,0,0,0,5,0,5
1994,3009,152,8,160,12,53,65,0,0,0,0,0,0
1994,3010,218,6,224,35,96,131,1,0,1,10,6,16
1994,3011,40,6,46,2,30,32,0,0,0,0,0,0
1994,3012,61,5,66,6,24,30,0,0,0,0,0,0
1994,3013,23,0,23,2,4,6,0,0,0,0,0,0
1994,3014,136,3,139,12,46,58,0,0,0,8,3,11
1994,3015,130,11,141,13,47,60,0,0,0,0,0,0
1994,3016,50,1,51,3,14,17,0,0,0,0,0,0
1994,3019,375,15,390,40,145,185,0,0,0,12,18,30
1994,3020,31,2,33,3,9,12,0,0,0,0,0,0
1994,3022,79,5,84,4,34,38,0,0,0,0,0,0
1994,3024,96,4,100,6,39,45,0,0,0,2,0,2
1994,3026,115,11,126,6,41,47,0,0,0,0,0,0
1994,3027,11,2,13,5,11,16,0,0,0,0,0,0
1994,3091,250,41,291,59,80,139,0,0,0,0,0,0
1994,3097,23,4,27,2,4,6,0,0,0,0,0,0
1994,3100,125,18,143,8,59,67,55,8,63,16,31,47
1994,3101,15,2,17,0,5,5,0,0,0,0,0,0
1994,3102,6,0,6,0,1,1,0,0,0,0,0,0
1994,3103,11,2,13,0,5,5,0,0,0,0,0,0
1994,3104,26,2,28,5,9,14,0,0,0,0,0,0
1994,3105,63,5,68,7,33,40,0,0,0,4,3,7
1994,3200,34,0,34,0,10,10,0,0,0,10,8,18
1994,3300,726,90,816,87,338,425,241,33,274,266,147,413
1994,3301,28,2,30,0,14,14,0,0,0,0,0,0
1994,3302,16,0,16,1,5,6,0,0,0,0,0,0
1994,3303,17,2,19,1,8,9,0,0,0,0,0,0
1994,3305,19,0,19,2,6,8,0,0,0,0,0,0
1994,3308,48,4,52,2,12,14,0,0,0,0,0,0
1994,3309,40,1,41,5,16,21,0,0,0,0,0,0
1994,3311,70,5,75,12,23,35,0,0,0,4,3,7
1994,3312,44,4,48,1,23,24,0,0,0,0,0,0
1994,3313,293,25,318,43,127,170,0,0,0,0,0,0
1994,3314,25,1,26,1,9,10,0,0,0,0,0,0
1994,3315,104,10,114,8,51,59,0,0,0,0,0,0
1994,3325,42,2,44,6,15,21,0,0,0,0,0,0
1994,3342,23,0,23,0,9,9,0,0,0,0,0,0
1994,3397,17,0,17,5,3,8,0,0,0,0,0,0
1994,3400,630,101,731,79,191,270,308,74,382,81,95,176
1994,3401,34,2,36,1,9,10,0,0,0,0,0,0
1994,3402,16,1,17,4,6,10,0,0,0,0,0,0
1994,3403,3,0,3,0,0,0,0,0,0,0,0,0
1994,3404,506,63,569,91,252,343,0,0,0,0,0,0
1994,3408,11,1,12,1,6,7,0,0,0,0,0,0
1994,3420,7,0,7,0,1,1,0,0,0,0,0,0
1994,3422,466,93,559,27,54,81,0,0,0,0,0,0
1994,3423,15,0,15,0,0,0,0,0,0,0,0,0
1994,3498,241,22,263,18,47,65,0,0,0,0,0,0
1994,3499,5205,481,5686,1290,1624,2914,0,0,0,0,0,0
1994,3500,19,1,20,1,4,5,0,0,0,0,0,0
1994,3501,23,3,26,3,4,7,0,0,0,0,0,0
1994,3600,565,74,639,139,360,499,217,56,273,107,158,265
1994,3601,37,1,38,1,15,16,0,0,0,0,0,0
1994,3602,76,3,79,6,36,42,0,0,0,0,0,0
1994,3603,60,4,64,3,17,20,0,0,0,0,0,0
1994,3604,102,6,108,7,45,52,0,0,0,0,0,0
1994,3605,47,4,51,1,21,22,0,0,0,0,0,0
1994,3607,184,15,199,21,84,105,0,0,0,0,0,0
1994,3608,67,4,71,10,22,32,0,0,0,0,0,0
1994,3609,88,7,95,7,40,47,0,0,0,0,0,0
1994,3610,248,17,265,34,110,144,0,0,0,0,0,0
1994,3611,78,3,81,8,25,33,0,0,0,0,0,0
1994,3613,20,0,20,3,8,11,0,0,0,0,0,0
1994,3614,9,1,10,3,2,5,0,0,0,0,0,0
1994,3700,679,96,775,101,392,493,683,129,812,178,347,525
1994,3701,75,5,80,4,23,27,0,0,0,0,0,0
1994,3702,148,22,170,26,59,85,0,0,0,0,0,0
1994,3703,36,4,40,5,10,15,0,0,0,0,0,0
1994,3705,114,7,121,16,50,66,0,0,0,0,0,0
1994,3706,135,11,146,13,54,67,0,0,0,0,0,0
1994,3708,55,5,60,17,4,21,0,0,0,0,0,0
1994,3709,63,3,66,3,24,27,0,0,0,0,0,0
1994,3710,148,15,163,11,71,82,0,0,0,0,0,0
1994,3711,1699,273,1972,195,474,669,0,0,0,0,0,0
1994,3714,21,2,23,5,8,13,0,0,0,0,0,0
1994,3715,85,11,96,7,15,22,0,0,0,0,0,0
1994,3732,5,0,5,0,2,2,0,0,0,0,0,0
1994,3797,21,5,26,14,7,21,0,0,0,0,0,0
1994,3800,0,0,0,0,0,0,0,0,0,0,0,0
1994,3801,1565,258,1823,117,289,406,0,0,0,0,0,0
1994,3803,13,5,18,5,6,11,0,0,0,0,0,0
1994,3816,3,2,5,0,5,5,0,0,0,0,0,0
1994,3897,19,4,23,15,12,27,0,0,0,0,0,0
1994,3900,149,13,162,50,101,151,0,0,0,0,0,0
1994,3901,8,0,8,2,3,5,0,0,0,0,0,0
1994,3902,66,4,70,1,16,17,0,0,0,3,12,15
1994,3903,40,2,42,6,14,20,0,0,0,0,0,0
1994,3904,11,2,13,0,0,0,0,0,0,0,0,0
1994,3905,307,29,336,45,114,159,0,0,0,0,0,0
1994,3906,41,2,43,8,14,22,0,0,0,0,0,0
1994,3914,7,0,7,0,0,0,0,0,0,0,0,0
1994,3915,10,3,13,2,5,7,0,0,0,0,0,0
1994,4000,120,5,125,8,40,48,80,23,103,7,26,33
1994,4001,18,2,20,1,8,9,0,0,0,0,0,0
1994,4002,15,1,16,0,7,7,0,0,0,0,0,0
1994,4003,16,2,18,1,5,6,0,0,0,0,0,0
1994,4004,27,2,29,0,7,7,0,0,0,0,0,0
1994,4005,23,1,24,0,11,11,0,0,0,0,0,0
1994,4006,52,3,55,5,20,25,0,0,0,0,0,0
1994,4007,10,2,12,1,6,7,0,0,0,0,0,0
1994,4008,23,4,27,2,6,8,0,0,0,0,0,0
1994,4016,54,21,75,2,4,6,0,0,0,0,0,0
1994,4100,283,29,312,26,59,85,61,21,82,11,32,43
1994,4101,18,1,19,2,1,3,0,0,0,0,0,0
1994,4102,29,2,31,3,10,13,0,0,0,0,0,0
1994,4103,11,4,15,2,3,5,0,0,0,0,0,0
1994,4104,43,2,45,4,15,19,0,0,0,0,0,0
1994,4105,15,0,15,0,4,4,0,0,0,0,0,0
1994,4106,93,6,99,6,28,34,0,0,0,0,0,0
1994,4107,12,1,13,0,2,2,0,0,0,0,0,0
1994,4108,24,3,27,0,7,7,0,0,0,0,0,0
1994,4109,43,6,49,0,20,20,0,0,0,0,0,0
1994,4110,23,1,24,1,5,6,0,0,0,0,0,0
1994,4111,40,1,41,1,11,12,0,0,0,0,0,0
1994,4113,72,8,80,4,29,33,0,0,0,0,0,0
1994,4114,45,2,47,1,10,11,0,0,0,0,0,0
1994,4115,33,1,34,2,9,11,0,0,0,0,0,0
1994,4116,84,10,94,1,34,35,0,0,0,0,0,0
1994,4117,68,5,73,3,26,29,0,0,0,0,0,0
1994,4119,10,0,10,0,0,0,0,0,0,0,0,0
1994,4120,36,5,41,5,8,13,0,0,0,0,0,0
1994,4127,30,4,34,2,7,9,0,0,0,0,0,0
1994,4200,236,13,249,17,84,101,0,0,0,0,0,0
1994,4201,6,0,6,0,1,1,0,0,0,0,0,0
1994,4202,40,2,42,1,5,6,0,0,0,4,4,8
1994,4203,129,10,139,18,63,81,0,0,0,0,0,0
1994,4204,71,6,77,2,27,29,0,0,0,0,0,0
1994,4211,2,0,2,0,0,0,0,0,0,0,0,0
1994,4297,22,3,25,5,6,11,0,0,0,0,0,0
1994,4300,352,62,414,16,108,124,0,0,0,0,0,0
1994,4302,37,4,41,1,15,16,0,0,0,0,0,0
1994,4304,50,3,53,9,25,34,0,0,0,0,0,0
1994,4305,26,3,29,6,8,14,0,0,0,0,0,0
1994,4307,40,4,44,6,15,21,0,0,0,0,0,0
1994,4308,67,11,78,6,21,27,0,0,0,0,0,0
1994,4310,20,2,22,1,12,13,0,0,0,0,0,0
1994,4311,74,4,78,7,23,30,0,0,0,0,0,0
1994,4312,71,20,91,27,49,76,0,0,0,0,0,0
1994,4313,1112,97,1209,74,310,384,0,0,0,0,0,0
1994,4314,137,6,143,10,27,37,0,0,0,0,0,0
1994,4316,115,6,121,25,38,63,0,0,0,0,0,0
1994,4317,20,2,22,7,8,15,0,0,0,0,0,0
1994,4320,8,0,8,1,5,6,0,0,0,0,0,0
1994,4321,8,1,9,0,1,1,0,0,0,0,0,0
1994,4327,9,0,9,0,1,1,0,0,0,0,0,0
1994,4400,95,8,103,1,27,28,0,0,0,0,0,0
1994,4401,23,1,24,0,0,0,0,0,0,0,0,0
1994,4402,75,5,80,4,31,35,0,0,0,0,0,0
1994,4403,56,1,57,1,17,18,0,0,0,0,0,0
1994,4404,19,1,20,1,7,8,0,0,0,0,0,0
1994,4405,4,0,4,0,2,2,0,0,0,0,0,0
1994,4497,11,4,15,0,0,0,0,0,0,7,4,11
1994,4500,71,13,84,8,48,56,47,13,60,0,0,0
1994,4501,14,0,14,1,8,9,0,0,0,0,0,0
1994,4502,92,1,93,7,53,60,0,0,0,0,0,0
1994,4600,9,1,10,0,0,0,0,0,0,1,4,5
1994,4700,47,0,47,4,11,15,0,0,0,0,0,0
1994,4701,2,0,2,0,1,1,0,0,0,0,0,0
1994,4703,1,0,1,0,0,0,0,0,0,0,0,0
1994,4706,9,0,9,2,3,5,0,0,0,0,0,0
1994,4707,3,0,3,0,0,0,0,0,0,0,0,0
1994,4708,8,0,8,2,3,5,0,0,0,0,0,0
1994,4709,14,0,14,4,2,6,0,0,0,0,0,0
1994,4710,3,0,3,0,0,0,0,0,0,0,0,0
1994,4800,77,2,79,7,43,50,2,0,2,149,59,208
1994,4801,33,0,33,2,11,13,0,0,0,0,0,0
1994,4802,17,1,18,0,4,4,0,0,0,0,0,0
1994,4803,83,3,86,13,34,47,0,0,0,0,0,0
1994,4804,7,1,8,0,1,1,0,0,0,0,0,0
1994,4805,20,1,21,2,7,9,0,0,0,0,0,0
1994,4806,73,8,81,4,44,48,0,0,0,0,0,0
1994,4807,119,7,126,8,55,63,0,0,0,0,0,0
1994,4900,187,8,195,11,72,83,0,0,0,0,0,0
1994,4901,9,0,9,1,2,3,0,0,0,0,0,0
1994,4902,11,1,12,1,4,5,0,0,0,0,0,0
1994,4903,16,0,16,2,8,10,0,0,0,0,0,0
1994,4904,49,3,52,7,25,32,0,0,0,0,0,0
1994,4905,135,8,143,16,55,71,0,0,0,0,0,0
1994,4906,14,0,14,0,5,5,0,0,0,0,0,0
1994,4907,13,1,14,1,6,7,0,0,0,0,0,0
1994,4908,52,3,55,1,22,23,0,0,0,0,0,0
1994,4909,11,1,12,0,8,8,0,0,0,0,0,0
1994,4914,9,1,10,3,3,6,0,0,0,0,0,0
1994,5000,141,8,149,9,61,70,4,0,4,134,75,209
1994,5001,33,1,34,19,11,30,0,0,0,0,0,0
1994,5002,196,7,203,16,63,79,0,0,0,0,0,0
1994,5003,10,0,10,0,1,1,0,0,0,0,0,0
1994,5004,21,0,21,3,5,8,0,0,0,0,0,0
1994,5005,14,0,14,0,2,2,0,0,0,0,0,0
1994,5006,18,0,18,2,3,5,0,0,0,0,0,0
1994,5007,51,2,53,3,23,26,0,0,0,0,0,0
1994,5008,6,0,6,1,0,1,0,0,0,0,0,0
1994,5009,7,0,7,0,1,1,0,0,0,0,0,0
1994,5010,6,2,8,3,2,5,0,0,0,0,0,0
1994,5100,50,2,52,4,17,21,0,0,0,0,0,0
1994,5102,37,2,39,10,13,23,0,0,0,0,0,0
1994,5200,28,1,29,2,18,20,22,2,24,1,2,3
1994,5201,11,2,13,1,3,4,0,0,0,0,0,0
1994,5202,19,2,21,2,16,18,0,0,0,0,0,0
1994,5300,20,0,20,0,5,5,0,0,0,0,0,0
1994,5400,169,12,181,5,59,64,54,7,61,69,19,88
1994,5401,18,1,19,1,4,5,0,0,0,0,0,0
1994,5402,12,0,12,0,1,1,0,0,0,0,0,0
1994,5403,10,0,10,0,1,1,0,0,0,0,0,0
1994,5404,15,2,17,7,4,11,0,0,0,0,0,0
1994,5405,35,4,39,1,22,23,0,0,0,0,0,0
1994,5406,39,3,42,4,15,19,0,0,0,0,0,0
1994,5407,78,10,88,7,36,43,0,0,0,0,0,0
1994,5408,10,0,10,1,2,3,0,0,0,0,0,0
1994,5411,0,0,0,0,0,0,0,0,0,0,0,0
1994,5500,53,0,53,3,17,20,0,0,0,0,0,0
1994,5501,12,0,12,0,4,4,0,0,0,0,0,0
1994,5600,420,52,472,39,124,163,146,36,182,101,70,171
1994,5604,152,9,161,14,52,66,0,0,0,5,4,9
1994,5605,18,1,19,0,7,7,0,0,0,0,0,0
1994,5606,27,1,28,1,5,6,0,0,0,0,0,0
1994,5608,106,11,117,9,56,65,0,0,0,0,0,0
1994,5609,107,4,111,8,49,57,0,0,0,0,0,0
1994,5616,3,2,5,0,6,6,0,0,0,0,0,0
1994,5700,46,7,53,10,19,29,22,1,23,53,49,102
1994,5701,45,6,51,3,17,20,0,0,0,0,0,0
1994,5702,9,0,9,0,1,1,0,0,0,0,0,0
1994,5703,41,7,48,5,15,20,0,0,0,0,0,0
1994,5704,43,5,48,1,18,19,0,0,0,0,0,0
1994,5797,41,7,48,8,24,32,0,0,0,0,0,0
1994,5800,44,2,46,2,16,18,0,0,0,0,0,0
1994,5801,21,1,22,3,9,12,0,0,0,0,0,0
1994,5802,4,0,4,0,0,0,0,0,0,0,0,0
1994,190P,19,1,20,0,1,1,0,0,0,0,0,0
1994,190R,8,1,9,0,0,0,1,9,10,0,0,0
1994,191E,5,1,6,0,0,0,0,0,0,0,0,0
1994,192Q,0,0,0,0,0,0,5,1,6,0,0,0
1995,100,302,36,338,73,139,212,346,63,409,123,158,281
1995,101,92,7,99,6,27,33,0,0,0,4,5,9
1995,102,27,1,28,0,4,4,0,0,0,0,0,0
1995,103,165,25,190,26,58,84,0,1,1,7,8,15
1995,104,30,3,33,1,15,16,0,0,0,0,0,0
1995,105,167,16,183,16,66,82,0,0,0,7,9,16
1995,106,146,16,162,20,59,79,0,0,0,12,6,18
1995,107,61,4,65,10,37,47,0,0,0,0,0,0
1995,108,49,3,52,8,12,20,0,0,0,0,0,0
1995,109,593,62,655,106,165,271,5,1,6,56,21,77
1995,110,18,2,20,2,5,7,0,0,0,0,0,0
1995,111,65,5,70,4,26,30,0,0,0,0,0,0
1995,112,87,6,93,8,27,35,0,0,0,4,1,5
1995,113,56,6,62,6,20,26,0,0,0,0,0,0
1995,114,45,2,47,4,20,24,0,0,0,0,0,0
1995,115,9,1,10,8,1,9,0,0,0,0,0,0
1995,121,141,15,156,38,35,73,0,0,0,0,0,0
1995,122,2,0,2,154,35,189,0,0,0,0,0,0
1995,197,60,12,72,21,25,46,0,0,0,0,0,0
1995,200,9,0,9,0,3,3,0,0,0,0,0,0
1995,300,33,1,34,0,12,12,0,0,0,0,0,0
1995,302,4,0,4,0,0,0,0,0,0,0,0,0
1995,303,7,2,9,0,2,2,0,0,0,0,0,0
1995,305,5,0,5,0,1,1,0,0,0,0,0,0
1995,400,83,2,85,6,28,34,36,13,49,7,10,17
1995,402,60,10,70,5,38,43,0,0,0,0,0,0
1995,403,11,1,12,0,6,6,0,0,0,0,0,0
1995,404,21,2,23,1,9,10,0,0,0,0,0,0
1995,405,24,0,24,2,11,13,0,0,0,0,0,0
1995,497,9,1,10,2,3,5,0,0,0,0,0,0
1995,500,39,2,41,0,15,15,1,0,1,8,8,16
1995,501,5,0,5,0,1,1,0,0,0,0,0,0
1995,600,26,1,27,1,12,13,0,0,0,0,0,0
1995,601,7,0,7,0,1,1,0,0,0,0,0,0
1995,602,7,0,7,0,1,1,0,0,0,0,0,0
1995,700,364,40,404,31,114,145,180,36,216,50,67,117
1995,701,87,6,93,3,32,35,0,0,0,2,1,3
1995,702,18,0,18,0,5,5,0,0,0,0,0,0
1995,703,8,2,10,0,3,3,0,0,0,0,0,0
1995,704,141,14,155,7,43,50,0,0,0,5,0,5
1995,705,31,1,32,1,4,5,0,0,0,0,0,0
1995,706,16,4,20,1,2,3,0,0,0,0,0,0
1995,707,23,1,24,7,14,21,0,0,0,0,0,0
1995,708,68,3,71,4,12,16,0,0,0,0,0,0
1995,709,39,3,42,2,17,19,0,0,0,0,0,0
1995,710,169,13,182,12,61,73,0,0,0,6,3,9
1995,711,38,0,38,8,0,8,0,0,0,0,0,0
1995,712,69,5,74,5,22,27,0,0,0,0,0,0
1995,713,9,1,10,0,0,0,0,0,0,0,0,0
1995,714,41,0,41,2,9,11,0,0,0,0,0,0
1995,716,12,0,12,0,1,1,0,0,0,0,0,0
1995,721,16,3,19,2,3,5,0,0,0,0,0,0
1995,800,24,3,27,1,3,4,11,2,13,0,0,0
1995,801,12,0,12,0,1,1,0,0,0,0,0,0
1995,900,140,2,142,6,31,37,1,0,1,55,54,109
1995,901,17,0,17,1,4,5,0,0,0,0,0,0
1995,902,49,3,52,3,16,19,0,0,0,0,0,0
1995,1000,310,27,337,40,115,155,0,0,0,0,0,0
1995,1001,69,7,76,3,27,30,0,0,0,0,0,0
1995,1002,16,0,16,1,7,8,0,0,0,0,0,0
1995,1003,8,1,9,0,4,4,0,0,0,0,0,0
1995,1004,7,0,7,0,1,1,0,0,0,0,0,0
1995,1005,451,42,493,64,190,254,0,0,0,0,0,0
1995,1006,11,0,11,1,3,4,0,0,0,0,0,0
1995,1007,13,1,14,0,0,0,0,0,0,0,0,0
1995,1008,13,0,13,0,5,5,0,0,0,0,0,0
1995,1011,11,0,11,0,1,1,0,0,0,0,0,0
1995,1012,21,0,21,2,6,8,0,0,0,0,0,0
1995,1013,20,1,21,1,7,8,0,0,0,0,0,0
1995,1015,22,2,24,0,12,12,0,0,0,0,0,0
1995,1017,5,1,6,0,0,0,0,0,0,0,0,0
1995,1031,10,1,11,0,2,2,0,0,0,0,0,0
1995,1097,12,1,13,5,8,13,0,0,0,0,0,0
1995,1100,19,0,19,4,10,14,0,0,0,8,9,17
1995,1101,8,0,8,0,1,1,0,0,0,0,0,0
1995,1102,9,0,9,0,1,1,0,0,0,0,0,0
1995,1200,66,4,70,1,26,27,69,23,92,2,2,4
1995,1201,22,0,22,2,6,8,0,0,0,0,0,0
1995,1202,4,0,4,0,0,0,0,0,0,0,0,0
1995,1203,46,5,51,2,28,30,0,0,0,0,0,0
1995,1204,3,0,3,0,0,0,0,0,0,0,0,0
1995,1205,14,1,15,0,5,5,0,0,0,0,0,0
1995,1206,4,0,4,0,0,0,0,0,0,0,0,0
1995,1207,5,1,6,0,0,0,0,0,0,0,0,0
1995,1208,10,0,10,1,4,5,0,0,0,0,0,0
1995,1300,69,4,73,6,30,36,0,0,0,0,0,0
1995,1301,27,1,28,0,10,10,0,0,0,0,0,0
1995,1302,27,3,30,7,9,16,0,0,0,0,0,0
1995,1303,5,0,5,0,1,1,0,0,0,0,0,0
1995,1304,47,3,50,10,20,30,0,0,0,0,0,0
1995,1305,8,0,8,1,1,2,0,0,0,0,0,0
1995,1306,14,1,15,1,2,3,0,0,0,0,0,0
1995,1307,4,0,4,0,0,0,0,0,0,0,0,0
1995,1400,24,1,25,2,7,9,0,0,0,0,0,0
1995,1401,14,0,14,0,7,7,0,0,0,0,0,0
1995,1500,272,23,295,30,149,179,0,0,0,6,1,7
1995,1501,11,0,11,0,6,6,0,0,0,0,0,0
1995,1502,253,11,264,11,76,87,0,0,0,0,0,0
1995,1503,29,3,32,0,6,6,4,0,4,0,0,0
1995,1506,26,2,28,2,10,12,0,0,0,0,0,0
1995,1507,12,1,13,0,6,6,0,0,0,0,0,0
1995,1508,11,0,11,0,5,5,0,0,0,0,0,0
1995,1511,11,1,12,0,5,5,0,0,0,0,0,0
1995,1514,3,0,3,0,0,0,0,0,0,0,0,0
1995,1515,6,0,6,1,3,4,0,0,0,0,0,0
1995,1597,8,0,8,1,3,4,0,0,0,0,0,0
1995,1600,70,2,72,2,42,44,1,0,1,32,18,50
1995,1601,16,1,17,0,5,5,0,0,0,0,0,0
1995,1602,40,1,41,0,16,16,0,0,0,0,0,0
1995,1603,19,2,21,1,5,6,0,0,0,0,0,0
1995,1700,55,2,57,5,19,24,0,0,0,34,25,59
1995,1701,12,0,12,0,2,2,0,0,0,0,0,0
1995,1702,17,0,17,3,5,8,0,0,0,0,0,0
1995,1800,25,0,25,1,4,5,2,1,3,29,26,55
1995,1801,14,2,16,1,1,2,0,0,0,0,0,0
1995,1900,3939,515,4454,755,1495,2250,0,0,0,0,0,0
1995,1901,83,7,90,12,35,47,5,5,10,0,0,0
1995,1902,72,6,78,12,8,20,0,0,0,1,3,4
1995,1905,54,2,56,1,21,22,0,0,0,4,0,4
1995,1906,70,3,73,3,20,23,0,0,0,0,0,0
1995,1907,37,0,37,1,9,10,0,0,0,1,3,4
1995,1909,50,4,54,3,13,16,0,0,0,0,0,0
1995,1910,120,7,127,18,33,51,0,0,0,4,5,9
1995,1912,149,9,158,31,49,80,0,0,0,8,1,9
1995,1913,33,3,36,1,12,13,0,0,0,4,0,4
1995,1915,122,8,130,12,36,48,0,0,0,4,0,4
1995,1916,51,1,52,3,18,21,0,0,0,3,1,4
1995,1918,110,8,118,8,26,34,0,0,0,2,0,2
1995,1919,0,0,0,0,0,0,0,0,0,0,0,0
1995,1920,109,6,115,5,38,43,0,0,0,0,0,0
1995,1922,121,8,129,10,16,26,0,0,0,5,0,5
1995,1923,56,7,63,3,13,16,0,0,0,4,1,5
1995,1924,82,7,89,1,13,14,0,0,0,4,4,8
1995,1925,195,25,220,16,73,89,0,0,0,10,6,16
1995,1926,47,5,52,3,11,14,0,0,0,5,5,10
1995,1928,82,8,90,4,31,35,0,0,0,0,0,0
1995,1929,32,3,35,2,8,10,0,0,0,1,4,5
1995,1931,63,4,67,6,28,34,2,3,5,0,0,0
1995,1933,181,19,200,7,70,77,0,0,0,6,5,11
1995,1934,21,0,21,0,6,6,0,0,0,0,0,0
1995,1938,38,4,42,3,11,14,0,0,0,0,0,0
1995,1941,732,80,812,132,245,377,8,2,10,39,20,59
1995,1942,6919,1418,8337,759,1785,2544,26,0,26,237,87,324
1995,1944,56,6,62,0,0,0,0,1,1,4,1,5
1995,1945,27,0,27,3,6,9,0,0,0,1,1,2
1995,1946,55,3,58,2,20,22,0,0,0,2,0,2
1995,1947,90,4,94,6,33,39,0,0,0,0,0,0
1995,1948,68,10,78,3,34,37,0,0,0,3,1,4
1995,1951,21,2,23,0,7,7,0,0,0,4,1,5
1995,1953,195,26,221,23,68,91,3,0,3,10,7,17
1995,1955,161,5,166,14,81,95,0,1,1,11,7,18
1995,1956,98,6,104,5,38,43,0,0,0,3,6,9
1995,1961,33,2,35,4,9,13,0,0,0,0,0,0
1995,1962,46,4,50,4,10,14,0,0,0,0,0,0
1995,1963,20,3,23,1,5,6,0,0,0,0,0,0
1995,1965,170,26,196,90,131,221,0,0,0,7,5,12
1995,1966,15,0,15,3,6,9,0,0,0,0,0,0
1995,1967,25,5,30,1,8,9,0,0,0,4,1,5
1995,1969,90,3,93,5,24,29,0,0,0,4,1,5
1995,1970,34,2,36,0,11,11,0,0,0,4,0,4
1995,1972,237,12,249,13,59,72,1,0,1,7,6,13
1995,1973,53,3,56,7,12,19,0,0,0,0,0,0
1995,1975,102,8,110,10,26,36,0,0,0,4,2,6
1995,1976,124,4,128,6,36,42,0,0,0,6,0,6
1995,1978,10,2,12,6,11,17,0,0,0,0,0,0
1995,1981,12,1,13,5,6,11,0,0,0,0,0,0
1995,1982,16,5,21,2,3,5,0,0,0,0,0,0
1995,1983,14,2,16,0,4,4,0,0,0,0,0,0
1995,1984,15,1,16,1,4,5,0,0,0,0,0,0
1995,1997,44,10,54,16,11,27,0,0,0,0,0,0
1995,2000,59,3,62,4,16,20,0,0,0,0,0,0
1995,2001,13,0,13,1,5,6,0,0,0,0,0,0
1995,2002,48,2,50,3,14,17,0,0,0,0,0,0
1995,2100,91,14,105,10,48,58,58,21,79,9,14,23
1995,2101,6,0,6,1,0,1,0,0,0,0,0,0
1995,2103,11,0,11,0,4,4,0,0,0,0,0,0
1995,2104,29,2,31,0,11,11,0,0,0,0,0,0
1995,2105,19,3,22,2,9,11,0,0,0,0,0,0
1995,2106,51,4,55,3,18,21,0,0,0,0,0,0
1995,2107,8,1,9,1,0,1,0,0,0,0,0,0
1995,2108,16,1,17,0,6,6,0,0,0,0,0,0
1995,2109,64,3,67,4,29,33,0,0,0,0,0,0
1995,2110,21,0,21,0,0,0,0,0,0,0,0,0
1995,2111,12,2,14,0,3,3,0,0,0,0,0,0
1995,2113,8,1,9,0,0,0,0,0,0,0,0,0
1995,2116,7,0,7,0,1,1,0,0,0,0,0,0
1995,2200,30,3,33,3,6,9,7,7,14,0,0,0
1995,2300,63,1,64,3,15,18,38,7,45,2,3,5
1995,2301,15,2,17,5,2,7,0,0,0,0,0,0
1995,2303,24,1,25,1,9,10,0,0,0,0,0,0
1995,2304,12,0,12,2,5,7,0,0,0,0,0,0
1995,2400,66,3,69,8,14,22,0,0,0,0,0,0
1995,2401,23,1,24,2,6,8,0,0,0,0,0,0
1995,2402,7,0,7,0,0,0,0,0,0,0,0,0
1995,2403,7,1,8,0,1,1,0,0,0,0,0,0
1995,2404,18,1,19,0,6,6,0,0,0,0,0,0
1995,2405,25,1,26,2,10,12,0,0,0,0,0,0
1995,2406,77,3,80,3,28,31,0,0,0,0,0,0
1995,2500,10,1,11,0,0,0,0,0,0,0,0,0
1995,2501,7,0,7,0,1,1,1,0,1,0,0,0
1995,2600,23,1,24,0,2,2,1,0,1,16,0,16
1995,2601,14,1,15,0,3,3,0,0,0,0,0,0
1995,2700,138,8,146,9,54,63,115,24,139,9,16,25
1995,2701,14,1,15,3,6,9,0,0,0,0,0,0
1995,2702,4,0,4,0,0,0,0,0,0,0,0,0
1995,2703,10,0,10,0,1,1,0,0,0,0,0,0
1995,2704,11,0,11,0,1,1,0,0,0,0,0,0
1995,2705,16,0,16,0,2,2,0,0,0,0,0,0
1995,2706,55,3,58,1,5,6,0,0,0,5,5,10
1995,2707,26,2,28,4,5,9,0,0,0,0,0,0
1995,2708,147,4,151,26,35,61,0,0,0,0,0,0
1995,2709,6,0,6,0,0,0,0,0,0,0,0,0
1995,2710,35,5,40,3,10,13,0,0,0,0,0,0
1995,2711,11,1,12,1,2,3,0,0,0,0,0,0
1995,2712,24,1,25,2,4,6,0,0,0,0,0,0
1995,2714,6,0,6,0,0,0,0,0,0,0,0,0
1995,2800,60,4,64,1,17,18,0,0,0,0,0,0
1995,2801,10,0,10,1,2,3,0,0,0,0,0,0
1995,2802,60,6,66,8,34,42,0,0,0,0,0,0
1995,2803,12,0,12,0,5,5,0,0,0,0,0,0
1995,2808,6,1,7,0,1,1,0,0,0,0,0,0
1995,2900,69,3,72,3,31,34,0,0,0,2,2,4
1995,2901,19,0,19,1,7,8,0,0,0,0,0,0
1995,2902,9,0,9,0,1,1,0,0,0,0,0,0
1995,3000,617,60,677,262,384,646,472,77,549,256,157,413
1995,3001,354,28,382,31,115,146,0,0,0,10,11,21
1995,3002,92,8,100,1,23,24,0,0,0,0,0,0
1995,3003,86,3,89,5,39,44,0,0,0,5,0,5
1995,3004,129,8,137,12,45,57,0,0,0,8,0,8
1995,3005,51,4,55,1,22,23,0,0,0,3,0,3
1995,3006,22,1,23,0,6,6,0,0,0,0,0,0
1995,3007,57,7,64,4,20,24,0,0,0,0,0,0
1995,3008,136,11,147,8,55,63,0,0,0,5,0,5
1995,3009,155,10,165,15,50,65,0,0,0,0,0,0
1995,3010,214,8,222,28,88,116,1,0,1,9,7,16
1995,3011,40,7,47,1,32,33,0,0,0,0,0,0
1995,3012,67,5,72,0,0,0,0,0,0,5,0,5
1995,3013,22,1,23,2,4,6,0,0,0,0,0,0
1995,3014,130,2,132,10,49,59,0,0,0,7,2,9
1995,3015,134,12,146,11,55,66,0,0,0,0,0,0
1995,3016,48,1,49,4,11,15,0,0,0,0,0,0
1995,3019,360,15,375,42,154,196,0,0,0,12,8,20
1995,3020,30,3,33,5,11,16,0,0,0,0,0,0
1995,3022,78,5,83,5,31,36,0,0,0,0,0,0
1995,3024,93,4,97,4,39,43,0,0,0,0,0,0
1995,3026,123,11,134,6,44,50,0,0,0,0,0,0
1995,3027,12,1,13,6,11,17,0,0,0,0,0,0
1995,3091,241,37,278,56,81,137,0,0,0,0,0,0
1995,3097,23,3,26,2,5,7,0,0,0,0,0,0
1995,3100,129,19,148,9,59,68,59,9,68,16,32,48
1995,3101,15,2,17,1,5,6,0,0,0,0,0,0
1995,3102,5,0,5,0,0,0,0,0,0,0,0,0
1995,3103,9,0,9,0,0,0,0,0,0,1,4,5
1995,3104,28,2,30,4,10,14,0,0,0,0,0,0
1995,3105,64,3,67,10,33,43,0,0,0,3,3,6
1995,3200,35,0,35,3,9,12,0,0,0,9,8,17
1995,3300,726,106,832,112,304,416,206,43,249,299,197,496
1995,3301,30,1,31,1,15,16,0,0,0,0,0,0
1995,3302,17,0,17,0,6,6,0,0,0,0,0,0
1995,3303,17,2,19,1,12,13,0,0,0,0,0,0
1995,3305,22,2,24,1,8,9,0,0,0,0,0,0
1995,3308,52,4,56,3,14,17,0,0,0,0,0,0
1995,3309,43,2,45,4,15,19,0,0,0,0,0,0
1995,3311,76,4,80,17,19,36,0,0,0,3,4,7
1995,3312,47,4,51,0,22,22,0,0,0,0,0,0
1995,3313,303,28,331,57,120,177,0,0,0,0,0,0
1995,3314,24,1,25,1,9,10,0,0,0,0,0,0
1995,3315,109,12,121,6,46,52,0,0,0,0,0,0
1995,3325,40,3,43,9,15,24,0,0,0,0,0,0
1995,3342,24,2,26,0,8,8,0,0,0,0,0,0
1995,3397,19,0,19,3,4,7,0,0,0,0,0,0
1995,3400,659,110,769,82,199,281,319,71,390,84,97,181
1995,3401,35,2,37,2,8,10,0,0,0,0,0,0
1995,3402,16,1,17,4,6,10,0,0,0,0,0,0
1995,3403,4,0,4,0,0,0,0,0,0,0,0,0
1995,3404,533,81,614,101,267,368,0,0,0,0,0,0
1995,3408,14,0,14,2,4,6,0,0,0,0,0,0
1995,3420,3,0,3,0,1,1,0,0,0,0,0,0
1995,3422,590,141,731,12,44,56,0,0,0,0,0,0
1995,3423,14,1,15,0,0,0,0,0,0,0,0,0
1995,3499,5640,533,6173,1262,1727,2989,0,0,0,0,0,0
1995,3500,22,0,22,7,10,17,0,0,0,0,0,0
1995,3501,25,0,25,1,4,5,0,0,0,0,0,0
1995,3600,734,79,813,120,362,482,247,68,315,130,180,310
1995,3601,44,0,44,1,14,15,0,0,0,0,0,0
1995,3602,77,2,79,6,30,36,0,0,0,0,0,0
1995,3603,58,3,61,2,13,15,0,0,0,0,0,0
1995,3604,106,6,112,7,46,53,0,0,0,0,0,0
1995,3605,48,5,53,1,21,22,0,0,0,0,0,0
1995,3607,182,11,193,36,81,117,0,0,0,0,0,0
1995,3608,69,6,75,10,24,34,0,0,0,0,0,0
1995,3609,96,8,104,3,47,50,0,0,0,0,0,0
1995,3610,248,15,263,37,110,147,0,0,0,0,0,0
1995,3611,82,5,87,6,28,34,0,0,0,0,0,0
1995,3613,22,1,23,3,7,10,0,0,0,0,0,0
1995,3614,11,1,12,0,0,0,0,0,0,0,0,0
1995,3700,707,101,808,107,411,518,721,135,856,186,363,549
1995,3701,75,6,81,3,27,30,0,0,0,0,0,0
1995,3702,154,20,174,21,68,89,0,0,0,0,0,0
1995,3703,36,3,39,4,11,15,0,0,0,0,0,0
1995,3705,118,12,130,14,51,65,0,0,0,0,0,0
1995,3706,133,13,146,14,54,68,0,0,0,0,0,0
1995,3708,58,5,63,3,19,22,0,0,0,0,0,0
1995,3709,64,4,68,4,22,26,0,0,0,0,0,0
1995,3710,150,14,164,12,59,71,0,0,0,0,0,0
1995,3711,1718,280,1998,210,418,628,0,0,0,0,0,0
1995,3714,21,1,22,5,9,14,0,0,0,0,0,0
1995,3715,90,12,102,7,14,21,0,0,0,0,0,0
1995,3732,8,8,16,0,0,0,0,0,0,0,0,0
1995,3797,21,6,27,16,7,23,0,0,0,0,0,0
1995,3800,92,39,131,31,19,50,372,109,481,17,4,21
1995,3801,1749,306,2055,283,109,392,0,0,0,0,0,0
1995,3803,15,5,20,1,4,5,0,0,0,0,0,0
1995,3816,5,1,6,7,0,7,0,0,0,0,0,0
1995,3897,21,4,25,16,10,26,0,0,0,0,0,0
1995,3900,136,16,152,52,103,155,0,0,0,0,0,0
1995,3901,8,0,8,0,2,2,0,0,0,0,0,0
1995,3902,65,5,70,1,16,17,0,0,0,3,11,14
1995,3903,42,2,44,5,16,21,0,0,0,0,0,0
1995,3904,11,2,13,0,7,7,0,0,0,0,0,0
1995,3905,331,36,367,45,114,159,0,0,0,0,0,0
1995,3906,42,3,45,7,15,22,0,0,0,0,0,0
1995,3914,7,0,7,0,0,0,0,0,0,0,0,0
1995,3915,10,3,13,1,4,5,0,0,0,0,0,0
1995,4000,123,3,126,6,42,48,81,20,101,7,25,32
1995,4001,21,2,23,1,8,9,0,0,0,0,0,0
1995,4002,18,1,19,0,7,7,0,0,0,0,0,0
1995,4003,17,2,19,1,5,6,0,0,0,0,0,0
1995,4004,28,2,30,0,6,6,0,0,0,0,0,0
1995,4005,19,1,20,0,8,8,0,0,0,0,0,0
1995,4006,53,2,55,5,20,25,0,0,0,0,0,0
1995,4007,10,2,12,2,2,4,0,0,0,0,0,0
1995,4008,24,4,28,2,7,9,0,0,0,0,0,0
1995,4016,63,24,87,2,6,8,0,0,0,0,0,0
1995,4100,121,20,141,29,57,86,156,15,171,74,56,130
1995,4101,17,2,19,4,1,5,0,0,0,0,0,0
1995,4102,28,2,30,2,11,13,0,0,0,0,0,0
1995,4103,10,4,14,0,3,3,0,0,0,0,0,0
1995,4104,42,2,44,4,15,19,0,0,0,0,0,0
1995,4105,15,0,15,0,4,4,0,0,0,0,0,0
1995,4106,100,9,109,3,28,31,0,0,0,0,0,0
1995,4107,12,1,13,0,2,2,0,0,0,0,0,0
1995,4108,21,3,24,0,7,7,0,0,0,0,0,0
1995,4109,41,5,46,2,18,20,0,0,0,0,0,0
1995,4110,24,1,25,1,5,6,0,0,0,0,0,0
1995,4111,40,1,41,1,11,12,0,0,0,0,0,0
1995,4113,73,10,83,4,30,34,0,0,0,0,0,0
1995,4114,46,2,48,1,10,11,0,0,0,0,0,0
1995,4115,33,2,35,2,11,13,0,0,0,0,0,0
1995,4116,88,11,99,0,32,32,0,0,0,0,0,0
1995,4117,69,7,76,3,25,28,0,0,0,0,0,0
1995,4119,8,0,8,1,0,1,0,0,0,0,0,0
1995,4120,35,5,40,5,9,14,0,0,0,0,0,0
1995,4127,41,5,46,4,8,12,0,0,0,0,0,0
1995,4200,204,11,215,19,75,94,12,2,14,0,0,0
1995,4201,8,0,8,0,1,1,0,0,0,0,0,0
1995,4202,40,1,41,0,6,6,0,0,0,4,4,8
1995,4203,131,10,141,23,61,84,0,0,0,0,0,0
1995,4204,72,9,81,6,28,34,0,0,0,0,0,0
1995,4211,2,0,2,0,1,1,0,0,0,0,0,0
1995,4297,23,3,26,5,5,10,0,0,0,0,0,0
1995,4300,358,57,415,24,86,110,0,0,0,0,0,0
1995,4302,39,4,43,0,16,16,0,0,0,0,0,0
1995,4304,49,4,53,7,25,32,0,0,0,1,3,4
1995,4305,27,3,30,5,10,15,0,0,0,0,0,0
1995,4307,38,3,41,6,14,20,0,0,0,0,0,0
1995,4308,68,11,79,6,23,29,0,0,0,0,0,0
1995,4310,23,3,26,0,13,13,0,0,0,0,0,0
1995,4311,79,6,85,6,25,31,0,0,0,0,0,0
1995,4312,75,20,95,20,49,69,0,0,0,0,0,0
1995,4313,1151,90,1241,103,320,423,0,0,0,0,0,0
1995,4314,134,6,140,6,25,31,0,0,0,0,0,0
1995,4316,117,5,122,19,30,49,0,0,0,0,0,0
1995,4317,21,2,23,10,11,21,0,0,0,0,0,0
1995,4320,3,1,4,3,3,6,0,0,0,0,0,0
1995,4321,8,1,9,0,2,2,0,0,0,0,0,0
1995,4327,6,0,6,1,0,1,0,0,0,0,0,0
1995,4400,105,6,111,9,43,52,77,32,109,9,7,16
1995,4401,23,0,23,5,4,9,0,0,0,0,0,0
1995,4402,74,4,78,4,33,37,0,0,0,0,0,0
1995,4403,55,3,58,0,8,8,0,0,0,0,0,0
1995,4404,20,1,21,1,7,8,0,0,0,0,0,0
1995,4405,4,0,4,0,2,2,0,0,0,0,0,0
1995,4497,13,4,17,7,5,12,0,0,0,0,0,0
1995,4500,76,12,88,4,38,42,0,0,0,0,0,0
1995,4501,14,0,14,6,0,6,0,0,0,0,0,0
1995,4502,95,3,98,8,43,51,0,0,0,0,0,0
1995,4600,9,1,10,0,0,0,0,0,0,2,3,5
1995,4700,47,0,47,4,11,15,0,0,0,0,0,0
1995,4701,3,0,3,0,1,1,0,0,0,0,0,0
1995,4703,1,0,1,0,0,0,0,0,0,0,0,0
1995,4706,9,0,9,2,3,5,0,0,0,0,0,0
1995,4707,4,0,4,0,0,0,0,0,0,0,0,0
1995,4708,9,0,9,1,3,4,0,0,0,0,0,0
1995,4709,12,0,12,7,0,7,0,0,0,0,0,0
1995,4710,4,0,4,0,0,0,0,0,0,0,0,0
1995,4800,85,2,87,17,70,87,0,0,0,162,49,211
1995,4801,34,0,34,4,12,16,0,0,0,0,0,0
1995,4802,16,2,18,0,4,4,0,0,0,0,0,0
1995,4803,94,5,99,13,36,49,0,0,0,0,0,0
1995,4804,7,1,8,0,1,1,0,0,0,0,0,0
1995,4805,22,1,23,3,6,9,0,0,0,0,0,0
1995,4806,73,7,80,5,48,53,0,0,0,0,0,0
1995,4807,125,8,133,8,59,67,0,0,0,0,0,0
1995,4900,187,8,195,10,71,81,3,0,3,163,115,278
1995,4901,11,0,11,1,3,4,0,0,0,0,0,0
1995,4902,11,1,12,0,5,5,0,0,0,0,0,0
1995,4903,15,0,15,1,8,9,0,0,0,0,0,0
1995,4904,49,3,52,9,18,27,0,0,0,0,0,0
1995,4905,137,8,145,16,60,76,0,0,0,0,0,0
1995,4906,14,0,14,0,4,4,0,0,0,0,0,0
1995,4907,12,2,14,1,2,3,0,0,0,0,0,0
1995,4908,59,3,62,1,25,26,0,0,0,0,0,0
1995,4909,7,1,8,0,9,9,0,0,0,0,0,0
1995,4914,9,1,10,3,2,5,0,0,0,0,0,0
1995,5000,169,9,178,8,62,70,4,0,4,132,87,219
1995,5001,33,2,35,5,11,16,0,0,0,0,0,0
1995,5002,229,8,237,20,72,92,0,0,0,0,0,0
1995,5003,10,0,10,0,1,1,0,0,0,0,0,0
1995,5004,21,1,22,3,5,8,0,0,0,0,0,0
1995,5005,15,0,15,0,2,2,0,0,0,0,0,0
1995,5007,53,2,55,4,23,27,0,0,0,0,0,0
1995,5008,12,0,12,1,0,1,0,0,0,0,0,0
1995,5009,6,0,6,0,1,1,0,0,0,0,0,0
1995,5010,7,2,9,3,2,5,0,0,0,0,0,0
1995,5100,51,2,53,3,17,20,0,0,0,0,0,0
1995,5102,38,2,40,8,16,24,0,0,0,0,0,0
1995,5200,31,1,32,3,17,20,0,0,0,0,0,0
1995,5201,10,2,12,0,4,4,0,0,0,0,0,0
1995,5202,20,2,22,2,12,14,0,0,0,0,0,0
1995,5300,19,0,19,0,5,5,0,0,0,0,0,0
1995,5400,192,12,204,4,55,59,4,1,5,0,0,0
1995,5401,19,1,20,1,5,6,0,0,0,0,0,0
1995,5402,13,0,13,0,1,1,0,0,0,0,0,0
1995,5403,10,0,10,0,1,1,0,0,0,0,0,0
1995,5404,12,2,14,3,3,6,0,0,0,0,0,0
1995,5405,39,4,43,2,19,21,0,0,0,0,0,0
1995,5406,42,2,44,6,14,20,0,0,0,0,0,0
1995,5407,80,7,87,7,33,40,0,0,0,0,0,0
1995,5408,10,0,10,0,1,1,0,0,0,0,0,0
1995,5411,2,0,2,1,1,2,0,0,0,0,0,0
1995,5500,50,0,50,4,18,22,0,0,0,0,0,0
1995,5501,12,1,13,0,4,4,0,0,0,0,0,0
1995,5600,367,44,411,48,110,158,226,39,265,158,111,269
1995,5604,150,10,160,21,59,80,0,0,0,0,0,0
1995,5605,20,1,21,0,7,7,0,0,0,0,0,0
1995,5606,29,1,30,1,7,8,0,0,0,0,0,0
1995,5608,109,10,119,10,57,67,0,0,0,0,0,0
1995,5609,101,5,106,12,43,55,0,0,0,0,0,0
1995,5700,48,9,57,5,14,19,20,0,20,51,48,99
1995,5701,44,7,51,3,18,21,0,0,0,0,0,0
1995,5702,9,1,10,0,1,1,0,0,0,0,0,0
1995,5703,45,7,52,5,13,18,0,0,0,0,0,0
1995,5704,45,5,50,1,21,22,0,0,0,0,0,0
1995,5797,38,6,44,7,23,30,0,0,0,0,0,0
1995,5800,41,3,44,5,19,24,0,0,0,0,0,0
1995,5801,25,1,26,3,11,14,0,0,0,0,0,0
1995,5802,4,0,4,0,0,0,0,0,0,0,0,0
1995,190C,15,1,16,1,4,5,0,0,0,0,0,0
1995,190P,11,1,12,0,1,1,0,0,0,0,0,0
1995,190R,8,1,9,3,5,8,0,0,0,0,0,0
1995,192Q,75,7,82,1,8,9,0,0,0,0,0,0
1995,192R,7,1,8,7,18,25,0,0,0,0,1,1
1996,100,332,39,371,87,154,241,337,60,397,122,161,283
1996,101,97,8,105,11,40,51,0,0,0,3,6,9
1996,102,26,1,27,0,5,5,0,0,0,0,0,0
1996,103,170,25,195,23,72,95,1,0,1,10,11,21
1996,104,30,3,33,1,15,16,0,0,0,0,0,0
1996,105,172,17,189,17,66,83,1,0,1,7,8,15
1996,106,140,17,157,16,52,68,0,0,0,15,16,31
1996,107,65,4,69,4,30,34,0,0,0,0,0,0
1996,108,48,3,51,8,12,20,0,0,0,0,0,0
1996,109,565,55,620,109,213,322,5,1,6,56,20,76
1996,110,18,2,20,2,5,7,0,0,0,0,0,0
1996,111,69,6,75,4,25,29,0,0,0,0,0,0
1996,112,85,7,92,30,9,39,0,0,0,4,1,5
1996,113,59,7,66,4,18,22,0,0,0,0,0,0
1996,114,45,3,48,9,22,31,0,0,0,0,0,0
1996,115,10,1,11,14,7,21,0,0,0,0,0,0
1996,121,147,16,163,38,33,71,0,0,0,0,0,0
1996,122,2,0,2,2,3,5,0,0,0,0,0,0
1996,130,30,2,32,0,5,5,0,0,0,0,0,0
1996,197,59,14,73,23,20,43,0,0,0,0,0,0
1996,200,9,0,9,0,3,3,0,0,0,0,0,0
1996,300,36,0,36,0,14,14,0,0,0,0,0,0
1996,302,4,0,4,0,1,1,0,0,0,0,0,0
1996,303,7,2,9,0,2,2,0,0,0,0,0,0
1996,305,5,0,5,0,1,1,0,0,0,0,0,0
1996,400,96,2,98,3,31,34,1,0,1,46,25,71
1996,402,65,9,74,6,37,43,0,0,0,0,0,0
1996,403,11,1,12,0,6,6,0,0,0,0,0,0
1996,404,22,2,24,1,9,10,0,0,0,0,0,0
1996,405,21,0,21,0,8,8,0,0,0,0,0,0
1996,497,8,2,10,2,3,5,0,0,0,0,0,0
1996,500,40,2,42,0,15,15,10,6,16,0,2,2
1996,501,4,1,5,0,1,1,0,0,0,0,0,0
1996,600,29,0,29,1,12,13,0,0,0,0,0,0
1996,601,9,0,9,0,1,1,0,0,0,0,0,0
1996,602,6,1,7,0,1,1,0,0,0,0,0,0
1996,700,318,39,357,64,91,155,184,30,214,52,65,117
1996,701,83,5,88,5,29,34,0,0,0,1,1,2
1996,702,19,0,19,0,6,6,0,0,0,0,0,0
1996,703,8,2,10,0,3,3,0,0,0,0,0,0
1996,704,140,16,156,10,41,51,0,0,0,3,0,3
1996,705,32,2,34,1,4,5,0,0,0,0,0,0
1996,706,17,3,20,1,3,4,0,0,0,0,0,0
1996,707,25,2,27,6,15,21,0,0,0,0,0,0
1996,708,67,2,69,2,11,13,0,0,0,0,0,0
1996,709,39,3,42,2,18,20,0,0,0,0,0,0
1996,710,171,13,184,10,56,66,0,0,0,3,6,9
1996,711,36,0,36,2,7,9,0,0,0,0,0,0
1996,712,72,3,75,6,22,28,0,0,0,0,0,0
1996,713,8,1,9,0,0,0,0,0,0,0,0,0
1996,714,37,0,37,1,11,12,0,0,0,0,0,0
1996,715,12,1,13,0,1,1,0,0,0,0,0,0
1996,716,11,1,12,0,1,1,0,0,0,0,0,0
1996,721,15,4,19,2,4,6,0,0,0,0,0,0
1996,723,22,5,27,4,1,5,0,0,0,0,0,0
1996,724,32,2,34,3,2,5,0,0,0,0,0,0
1996,726,12,1,13,1,1,2,0,0,0,0,0,0
1996,800,20,5,25,2,9,11,0,0,0,0,0,0
1996,801,12,0,12,0,1,1,0,0,0,0,0,0
1996,900,138,3,141,6,34,40,1,0,1,54,56,110
1996,901,15,0,15,1,5,6,0,0,0,0,0,0
1996,902,49,3,52,3,17,20,0,0,0,0,0,0
1996,1000,331,31,362,39,114,153,0,0,0,0,0,0
1996,1001,70,7,77,3,28,31,0,0,0,0,0,0
1996,1002,17,2,19,1,7,8,0,0,0,0,0,0
1996,1003,9,1,10,0,5,5,0,0,0,0,0,0
1996,1004,9,0,9,0,0,0,0,0,0,0,0,0
1996,1005,468,44,512,70,195,265,0,0,0,0,0,0
1996,1006,9,0,9,3,1,4,0,0,0,0,0,0
1996,1007,13,0,13,0,2,2,0,0,0,0,0,0
1996,1008,13,0,13,0,5,5,0,0,0,0,0,0
1996,1011,13,0,13,0,1,1,0,0,0,0,0,0
1996,1012,21,2,23,2,8,10,0,0,0,0,0,0
1996,1013,19,1,20,1,7,8,0,0,0,0,0,0
1996,1015,20,2,22,0,12,12,0,0,0,0,0,0
1996,1017,9,1,10,0,2,2,0,0,0,0,0,0
1996,1031,12,1,13,0,2,2,0,0,0,0,0,0
1996,1097,14,3,17,2,7,9,0,0,0,0,0,0
1996,1100,21,1,22,4,9,13,0,0,0,13,7,20
1996,1101,8,0,8,0,1,1,0,0,0,0,0,0
1996,1102,9,0,9,0,1,1,0,0,0,0,0,0
1996,1200,67,4,71,1,27,28,0,0,0,0,0,0
1996,1201,21,1,22,2,6,8,0,0,0,0,0,0
1996,1202,3,0,3,0,0,0,0,0,0,0,0,0
1996,1203,45,5,50,4,24,28,0,0,0,0,0,0
1996,1204,3,0,3,0,0,0,0,0,0,0,0,0
1996,1205,14,1,15,0,6,6,0,0,0,0,0,0
1996,1206,2,0,2,0,1,1,0,0,0,0,0,0
1996,1207,6,1,7,0,0,0,0,0,0,0,0,0
1996,1208,11,0,11,1,4,5,0,0,0,0,0,0
1996,1300,60,5,65,18,28,46,0,0,0,0,0,0
1996,1301,23,1,24,0,10,10,0,0,0,0,0,0
1996,1302,27,3,30,7,10,17,0,0,0,0,0,0
1996,1303,5,0,5,0,1,1,0,0,0,0,0,0
1996,1304,45,3,48,7,15,22,0,0,0,0,0,0
1996,1305,7,0,7,1,1,2,0,0,0,0,0,0
1996,1306,10,1,11,2,1,3,0,0,0,0,0,0
1996,1307,4,0,4,0,0,0,0,0,0,0,0,0
1996,1400,26,0,26,1,9,10,12,1,13,9,5,14
1996,1401,13,0,13,0,7,7,0,0,0,0,0,0
1996,1500,273,25,298,24,121,145,112,20,132,202,165,367
1996,1501,11,0,11,0,6,6,0,0,0,0,0,0
1996,1502,247,12,259,11,78,89,0,0,0,0,0,0
1996,1503,29,3,32,0,9,9,4,0,4,0,0,0
1996,1504,3,0,3,0,1,1,0,0,0,0,0,0
1996,1506,26,2,28,2,10,12,0,0,0,0,0,0
1996,1507,13,1,14,1,4,5,0,0,0,0,0,0
1996,1508,10,0,10,0,6,6,0,0,0,0,0,0
1996,1511,9,1,10,0,5,5,0,0,0,0,0,0
1996,1514,3,0,3,0,0,0,0,0,0,0,0,0
1996,1515,6,0,6,1,3,4,0,0,0,0,0,0
1996,1597,9,0,9,2,2,4,0,0,0,0,0,0
1996,1600,71,2,73,13,40,53,0,0,0,39,16,55
1996,1601,17,1,18,1,4,5,0,0,0,0,0,0
1996,1602,40,1,41,0,16,16,0,0,0,0,0,0
1996,1603,20,2,22,1,5,6,0,0,0,0,0,0
1996,1700,50,2,52,2,16,18,0,0,0,0,0,0
1996,1701,12,0,12,0,2,2,0,0,0,0,0,0
1996,1702,21,0,21,3,9,12,0,0,0,0,0,0
1996,1800,26,0,26,1,5,6,28,16,44,6,7,13
1996,1801,16,2,18,0,1,1,0,0,0,0,0,0
1996,1900,3914,505,4419,840,1549,2389,0,0,0,0,0,0
1996,1901,83,7,90,8,35,43,0,0,0,5,5,10
1996,1902,62,9,71,5,14,19,0,0,0,1,3,4
1996,1905,54,3,57,1,21,22,0,0,0,6,0,6
1996,1906,70,3,73,5,21,26,0,0,0,9,0,9
1996,1907,35,0,35,0,8,8,0,0,0,1,3,4
1996,1909,48,3,51,4,14,18,0,0,0,0,0,0
1996,1910,121,8,129,17,32,49,0,0,0,4,5,9
1996,1912,150,9,159,23,52,75,0,0,0,8,1,9
1996,1913,37,3,40,1,14,15,0,0,0,4,0,4
1996,1915,122,8,130,12,36,48,0,0,0,4,0,4
1996,1916,52,2,54,3,21,24,0,0,0,3,1,4
1996,1918,110,8,118,13,26,39,0,0,0,3,2,5
1996,1919,0,0,0,0,0,0,0,0,0,0,0,0
1996,1920,110,7,117,5,40,45,0,0,0,0,0,0
1996,1922,121,11,132,11,17,28,0,0,0,5,0,5
1996,1923,58,6,64,3,13,16,0,0,0,5,1,6
1996,1924,77,9,86,1,11,12,0,0,0,3,5,8
1996,1925,202,24,226,20,72,92,0,0,0,10,6,16
1996,1926,48,6,54,2,17,19,0,0,0,4,1,5
1996,1927,19,0,19,1,4,5,0,0,0,0,0,0
1996,1928,89,8,97,4,30,34,0,0,0,5,1,6
1996,1929,29,3,32,2,8,10,1,0,1,1,4,5
1996,1931,64,4,68,8,22,30,0,0,0,3,2,5
1996,1933,184,19,203,10,65,75,0,0,0,6,7,13
1996,1934,21,0,21,0,6,6,0,0,0,0,0,0
1996,1938,37,4,41,3,11,14,0,0,0,0,0,0
1996,1941,755,78,833,175,226,401,9,2,11,42,20,62
1996,1942,7547,1579,9126,946,1899,2845,21,1,22,138,73,211
1996,1944,52,7,59,10,16,26,0,1,1,3,1,4
1996,1945,24,0,24,2,5,7,0,0,0,1,1,2
1996,1946,56,4,60,1,19,20,0,0,0,2,0,2
1996,1947,88,4,92,9,39,48,0,0,0,0,0,0
1996,1948,66,10,76,8,36,44,0,0,0,3,2,5
1996,1951,21,2,23,0,0,0,0,0,0,7,3,10
1996,1953,192,29,221,26,67,93,3,0,3,8,9,17
1996,1955,160,7,167,18,94,112,0,0,0,13,6,19
1996,1956,98,4,102,4,38,42,0,0,0,2,7,9
1996,1961,33,2,35,6,10,16,3,2,5,0,0,0
1996,1962,49,5,54,2,11,13,0,0,0,0,0,0
1996,1963,22,4,26,1,4,5,0,0,0,0,0,0
1996,1964,0,0,0,4,7,11,0,0,0,0,0,0
1996,1965,174,24,198,66,107,173,0,0,0,5,5,10
1996,1966,14,1,15,3,4,7,0,0,0,0,0,0
1996,1967,26,5,31,2,8,10,0,0,0,3,2,5
1996,1969,86,3,89,5,25,30,0,0,0,5,1,6
1996,1970,31,2,33,3,9,12,0,0,0,3,0,3
1996,1972,227,13,240,15,49,64,1,0,1,6,8,14
1996,1973,53,3,56,2,13,15,0,0,0,5,0,5
1996,1975,106,8,114,7,27,34,0,0,0,4,4,8
1996,1976,117,6,123,13,36,49,5,0,5,0,0,0
1996,1978,12,2,14,6,13,19,0,0,0,0,0,0
1996,1983,15,2,17,0,0,0,0,0,0,0,0,0
1996,1984,16,1,17,1,4,5,0,0,0,0,0,0
1996,1997,45,8,53,11,13,24,0,0,0,0,0,0
1996,2000,65,5,70,3,25,28,0,0,0,0,0,0
1996,2001,12,0,12,6,0,6,0,0,0,0,0,0
1996,2002,49,2,51,3,14,17,0,0,0,0,0,0
1996,2100,99,13,112,15,54,69,52,21,73,8,13,21
1996,2101,9,0,9,0,0,0,0,0,0,0,0,0
1996,2103,11,0,11,0,4,4,0,0,0,0,0,0
1996,2104,29,2,31,0,11,11,0,0,0,0,0,0
1996,2105,18,3,21,2,9,11,0,0,0,0,0,0
1996,2106,55,5,60,3,19,22,0,0,0,0,0,0
1996,2107,8,1,9,0,0,0,0,0,0,0,0,0
1996,2108,16,1,17,0,6,6,0,0,0,0,0,0
1996,2109,70,3,73,4,23,27,0,0,0,0,0,0
1996,2110,21,0,21,1,4,5,0,0,0,0,0,0
1996,2111,13,1,14,0,2,2,0,0,0,0,0,0
1996,2113,8,0,8,2,1,3,0,0,0,0,0,0
1996,2200,29,4,33,5,6,11,8,6,14,0,0,0
1996,2300,55,1,56,5,13,18,45,9,54,2,4,6
1996,2301,13,1,14,0,4,4,0,0,0,0,0,0
1996,2303,24,1,25,0,5,5,0,0,0,0,0,0
1996,2304,14,0,14,2,5,7,0,0,0,0,0,0
1996,2400,70,2,72,6,15,21,0,0,0,0,0,0
1996,2401,22,1,23,4,4,8,0,0,0,0,0,0
1996,2402,7,0,7,0,0,0,0,0,0,0,0,0
1996,2403,8,1,9,0,1,1,0,0,0,0,0,0
1996,2404,16,2,18,0,7,7,0,0,0,0,0,0
1996,2405,26,1,27,11,0,11,0,0,0,0,0,0
1996,2406,79,2,81,2,31,33,0,0,0,0,0,0
1996,2500,10,1,11,0,0,0,5,4,9,0,0,0
1996,2501,8,0,8,0,1,1,0,0,0,0,0,0
1996,2600,23,1,24,0,2,2,1,0,1,7,8,15
1996,2601,14,1,15,0,2,2,0,0,0,0,0,0
1996,2700,145,8,153,9,56,65,136,24,160,13,22,35
1996,2701,14,1,15,3,6,9,0,0,0,0,0,0
1996,2702,5,0,5,0,0,0,0,0,0,0,0,0
1996,2703,11,0,11,1,1,2,0,0,0,0,0,0
1996,2704,11,0,11,0,1,1,0,0,0,0,0,0
1996,2705,14,0,14,0,2,2,0,0,0,0,0,0
1996,2706,56,2,58,2,6,8,0,0,0,5,5,10
1996,2707,27,2,29,4,6,10,0,0,0,0,0,0
1996,2708,138,6,144,8,29,37,0,0,0,0,0,0
1996,2709,6,0,6,0,1,1,0,0,0,0,0,0
1996,2710,32,6,38,2,8,10,0,0,0,0,0,0
1996,2711,13,1,14,0,4,4,0,0,0,0,0,0
1996,2712,26,2,28,3,4,7,0,0,0,0,0,0
1996,2714,5,0,5,0,0,0,0,0,0,0,0,0
1996,2719,12,2,14,5,2,7,0,0,0,0,0,0
1996,2800,69,3,72,1,17,18,0,0,0,0,0,0
1996,2801,10,0,10,1,2,3,0,0,0,0,0,0
1996,2802,70,5,75,5,42,47,0,0,0,0,0,0
1996,2803,11,1,12,0,5,5,0,0,0,0,0,0
1996,2809,69,3,72,1,17,18,0,0,0,0,0,0
1996,2900,65,3,68,4,29,33,4,0,4,34,33,67
1996,2901,19,0,19,1,7,8,0,0,0,0,0,0
1996,2902,9,0,9,0,1,1,0,0,0,0,0,0
1996,3000,608,64,672,281,378,659,485,73,558,218,75,293
1996,3001,367,32,399,25,123,148,0,0,0,14,5,19
1996,3002,93,8,101,1,23,24,0,0,0,0,0,0
1996,3003,85,4,89,4,45,49,0,0,0,5,0,5
1996,3004,139,7,146,10,44,54,1,0,1,9,0,9
1996,3005,50,6,56,4,21,25,0,0,0,2,0,2
1996,3006,22,2,24,0,6,6,0,0,0,0,0,0
1996,3007,58,7,65,5,17,22,0,0,0,0,0,0
1996,3008,136,12,148,8,58,66,0,0,0,5,0,5
1996,3009,155,12,167,13,53,66,0,0,0,0,0,0
1996,3010,214,8,222,34,89,123,1,0,1,8,6,14
1996,3011,39,8,47,1,31,32,0,0,0,0,0,0
1996,3012,68,5,73,9,26,35,0,0,0,0,0,0
1996,3013,22,2,24,2,4,6,0,0,0,0,0,0
1996,3014,127,3,130,17,45,62,0,0,0,7,2,9
1996,3015,137,11,148,14,63,77,0,0,0,0,0,0
1996,3016,51,0,51,4,12,16,0,0,0,0,0,0
1996,3019,365,12,377,34,119,153,0,0,0,46,20,66
1996,3020,30,3,33,5,11,16,0,0,0,0,0,0
1996,3022,85,4,89,6,32,38,0,0,0,0,0,0
1996,3024,96,4,100,3,41,44,0,0,0,1,0,1
1996,3026,118,15,133,10,48,58,0,0,0,0,0,0
1996,3027,12,1,13,3,12,15,0,0,0,0,0,0
1996,3091,298,48,346,10,64,74,0,0,0,0,0,0
1996,3097,22,4,26,2,7,9,0,0,0,0,0,0
1996,3100,136,19,155,10,64,74,47,7,54,27,33,60
1996,3101,18,1,19,1,7,8,0,0,0,0,0,0
1996,3103,9,1,10,1,5,6,0,0,0,0,0,0
1996,3104,27,1,28,4,11,15,0,0,0,0,0,0
1996,3105,67,4,71,8,34,42,0,0,0,4,3,7
1996,3200,38,0,38,2,9,11,0,0,0,11,8,19
1996,3300,871,97,968,75,388,463,174,34,208,358,218,576
1996,3301,28,1,29,1,7,8,0,0,0,0,0,0
1996,3302,17,0,17,0,6,6,0,0,0,0,0,0
1996,3303,20,2,22,2,11,13,0,0,0,0,0,0
1996,3305,27,2,29,1,2,3,0,0,0,0,0,0
1996,3308,49,4,53,2,15,17,0,0,0,0,0,0
1996,3309,47,1,48,8,14,22,0,0,0,0,0,0
1996,3311,74,6,80,14,24,38,0,0,0,2,1,3
1996,3312,0,0,0,0,0,0,0,0,0,0,0,0
1996,3313,297,26,323,27,124,151,0,0,0,0,0,0
1996,3314,24,2,26,1,8,9,0,0,0,0,0,0
1996,3315,115,10,125,9,47,56,0,0,0,0,0,0
1996,3325,43,3,46,8,17,25,0,0,0,0,0,0
1996,3332,119,11,130,13,29,42,0,0,0,0,0,0
1996,3342,24,2,26,2,6,8,0,0,0,0,0,0
1996,3397,20,0,20,3,4,7,0,0,0,0,0,0
1996,3400,683,124,807,80,205,285,298,64,362,83,97,180
1996,3401,37,3,40,1,11,12,0,0,0,0,0,0
1996,3402,17,1,18,3,5,8,0,0,0,0,0,0
1996,3403,4,0,4,0,0,0,0,0,0,0,0,0
1996,3404,551,87,638,111,295,406,0,0,0,0,0,0
1996,3408,15,0,15,2,3,5,0,0,0,0,0,0
1996,3420,3,0,3,0,1,1,0,0,0,0,0,0
1996,3422,511,132,643,12,44,56,0,0,0,0,0,0
1996,3423,0,0,0,0,0,0,0,0,0,0,0,0
1996,3497,36,7,43,7,24,31,0,0,0,0,0,0
1996,3499,6136,572,6708,1193,1825,3018,0,0,0,0,0,0
1996,3500,20,0,20,4,13,17,0,0,0,12,9,21
1996,3600,775,77,852,169,397,566,272,69,341,140,234,374
1996,3601,43,1,44,2,16,18,0,0,0,0,0,0
1996,3602,71,3,74,2,21,23,0,0,0,0,0,0
1996,3603,59,3,62,3,12,15,0,0,0,0,0,0
1996,3604,109,5,114,4,42,46,0,0,0,0,0,0
1996,3605,49,4,53,1,21,22,0,0,0,0,0,0
1996,3607,206,12,218,37,96,133,0,0,0,0,0,0
1996,3608,70,5,75,9,24,33,0,0,0,0,0,0
1996,3609,92,11,103,5,43,48,0,0,0,0,0,0
1996,3610,241,19,260,34,116,150,0,0,0,6,5,11
1996,3611,81,5,86,5,29,34,0,0,0,0,0,0
1996,3613,22,0,22,2,6,8,0,0,0,0,0,0
1996,3614,12,1,13,1,4,5,0,0,0,0,0,0
1996,3700,722,103,825,109,420,529,744,139,883,195,367,562
1996,3701,73,7,80,3,25,28,0,0,0,0,0,0
1996,3702,156,24,180,19,61,80,0,0,0,0,0,0
1996,3703,37,2,39,6,12,18,0,0,0,0,0,0
1996,3705,116,8,124,15,48,63,0,0,0,0,0,0
1996,3706,130,13,143,14,53,67,0,0,0,0,0,0
1996,3708,56,5,61,4,18,22,0,0,0,0,0,0
1996,3709,68,3,71,3,20,23,0,0,0,0,0,0
1996,3710,150,12,162,13,61,74,0,0,0,0,0,0
1996,3711,1721,281,2002,277,505,782,0,0,0,0,0,0
1996,3714,19,0,19,3,7,10,0,0,0,0,0,0
1996,3715,97,14,111,6,15,21,0,0,0,0,0,0
1996,3732,5,1,6,3,6,9,0,0,0,0,0,0
1996,3797,20,6,26,16,5,21,0,0,0,0,0,0
1996,3801,1717,303,2020,107,289,396,0,0,0,0,0,0
1996,3803,18,7,25,7,7,14,0,0,0,0,0,0
1996,3816,0,0,0,12,1,13,0,0,0,0,0,0
1996,3897,21,4,25,10,11,21,0,0,0,0,0,0
1996,3900,140,18,158,54,104,158,0,0,0,0,0,0
1996,3901,8,0,8,0,2,2,0,0,0,0,0,0
1996,3902,72,5,77,1,16,17,0,0,0,3,11,14
1996,3903,48,2,50,4,19,23,0,0,0,0,0,0
1996,3904,11,2,13,0,6,6,0,0,0,0,0,0
1996,3905,332,37,369,44,128,172,0,0,0,0,0,0
1996,3906,39,3,42,8,15,23,0,0,0,0,0,0
1996,3914,5,0,5,0,0,0,0,0,0,0,0,0
1996,3915,12,2,14,1,6,7,0,0,0,0,0,0
1996,4000,130,4,134,7,43,50,90,24,114,8,28,36
1996,4001,21,2,23,1,8,9,0,0,0,0,0,0
1996,4002,18,1,19,0,7,7,0,0,0,0,0,0
1996,4003,17,1,18,1,5,6,0,0,0,0,0,0
1996,4004,29,2,31,1,6,7,0,0,0,0,0,0
1996,4005,18,1,19,0,11,11,0,0,0,0,0,0
1996,4006,52,3,55,5,20,25,0,0,0,0,0,0
1996,4007,10,3,13,0,0,0,0,0,0,0,0,0
1996,4008,21,4,25,2,7,9,0,0,0,0,0,0
1996,4016,61,25,86,3,5,8,0,0,0,0,0,0
1996,4100,184,13,197,39,52,91,81,21,102,76,48,124
1996,4101,22,1,23,3,4,7,0,0,0,0,0,0
1996,4102,27,3,30,3,11,14,0,0,0,0,0,0
1996,4103,11,4,15,0,4,4,0,0,0,0,0,0
1996,4104,42,3,45,4,15,19,0,0,0,0,0,0
1996,4105,14,0,14,1,3,4,0,0,0,0,0,0
1996,4106,102,8,110,4,30,34,0,0,0,0,0,0
1996,4107,10,2,12,0,2,2,0,0,0,0,0,0
1996,4108,24,3,27,0,7,7,0,0,0,0,0,0
1996,4109,40,7,47,6,14,20,0,0,0,0,0,0
1996,4110,25,1,26,1,5,6,0,0,0,0,0,0
1996,4111,38,0,38,2,10,12,0,0,0,0,0,0
1996,4113,77,8,85,3,34,37,0,0,0,0,0,0
1996,4114,43,2,45,1,8,9,0,0,0,0,0,0
1996,4115,32,1,33,2,10,12,0,0,0,0,0,0
1996,4116,89,12,101,0,32,32,0,0,0,0,0,0
1996,4117,68,6,74,7,28,35,0,0,0,0,0,0
1996,4119,9,0,9,1,1,2,0,0,0,0,0,0
1996,4120,36,6,42,4,10,14,0,0,0,0,0,0
1996,4127,38,8,46,2,8,10,0,0,0,0,0,0
1996,4200,235,16,251,19,86,105,113,54,167,23,37,60
1996,4201,8,0,8,0,1,1,0,0,0,0,0,0
1996,4202,44,2,46,2,5,7,0,0,0,4,4,8
1996,4203,126,12,138,17,59,76,0,0,0,0,0,0
1996,4204,73,9,82,4,24,28,0,0,0,0,0,0
1996,4211,2,0,2,0,1,1,0,0,0,0,0,0
1996,4297,23,3,26,5,7,12,0,0,0,0,0,0
1996,4300,352,51,403,24,95,119,0,0,0,0,0,0
1996,4302,40,2,42,1,15,16,0,0,0,0,0,0
1996,4304,49,4,53,6,28,34,0,0,0,0,0,0
1996,4305,23,4,27,4,11,15,0,0,0,0,0,0
1996,4307,39,2,41,8,13,21,0,0,0,0,0,0
1996,4308,73,9,82,7,24,31,0,0,0,0,0,0
1996,4310,26,3,29,0,14,14,0,0,0,0,0,0
1996,4311,78,7,85,7,26,33,0,0,0,0,0,0
1996,4312,85,15,100,22,45,67,0,0,0,0,0,0
1996,4313,1196,104,1300,80,326,406,0,0,0,0,0,0
1996,4314,138,6,144,5,34,39,0,0,0,0,0,0
1996,4316,120,5,125,25,36,61,0,0,0,0,0,0
1996,4317,25,5,30,0,0,0,0,0,0,0,0,0
1996,4320,3,1,4,1,4,5,0,0,0,0,0,0
1996,4321,6,2,8,0,2,2,0,0,0,0,0,0
1996,4327,7,0,7,0,1,1,0,0,0,0,0,0
1996,4400,107,7,114,1,27,28,0,0,0,0,0,0
1996,4401,21,1,22,1,4,5,0,0,0,0,0,0
1996,4402,84,5,89,3,30,33,0,0,0,0,0,0
1996,4403,54,4,58,0,9,9,0,0,0,0,0,0
1996,4404,19,2,21,1,7,8,0,0,0,0,0,0
1996,4405,4,0,4,0,2,2,0,0,0,0,0,0
1996,4497,12,4,16,7,5,12,0,0,0,0,0,0
1996,4500,83,12,95,4,41,45,41,16,57,20,19,39
1996,4501,15,0,15,0,8,8,0,0,0,0,0,0
1996,4502,96,5,101,8,42,50,0,0,0,0,0,0
1996,4600,9,1,10,0,0,0,0,0,0,1,4,5
1996,4700,48,0,48,3,12,15,0,0,0,0,0,0
1996,4703,1,0,1,0,0,0,0,0,0,0,0,0
1996,4706,9,0,9,2,3,5,0,0,0,0,0,0
1996,4707,4,0,4,0,0,0,0,0,0,0,0,0
1996,4708,9,0,9,1,3,4,0,0,0,0,0,0
1996,4709,14,0,14,5,2,7,0,0,0,0,0,0
1996,4710,4,0,4,0,0,0,0,0,0,0,0,0
1996,4800,88,1,89,9,57,66,0,0,0,161,92,253
1996,4801,35,0,35,3,12,15,0,0,0,0,0,0
1996,4802,16,1,17,0,2,2,0,0,0,0,0,0
1996,4803,94,7,101,18,43,61,0,0,0,0,0,0
1996,4804,10,1,11,0,1,1,0,0,0,0,0,0
1996,4805,24,1,25,3,6,9,0,0,0,0,0,0
1996,4806,76,9,85,3,52,55,0,0,0,0,0,0
1996,4807,128,9,137,10,55,65,0,0,0,0,0,0
1996,4900,196,8,204,11,84,95,145,52,197,26,61,87
1996,4901,10,1,11,1,3,4,0,0,0,0,0,0
1996,4903,14,1,15,2,9,11,0,0,0,0,0,0
1996,4904,49,4,53,7,22,29,0,0,0,0,0,0
1996,4905,153,10,163,17,67,84,0,0,0,0,0,0
1996,4906,14,0,14,1,3,4,0,0,0,0,0,0
1996,4907,10,3,13,1,3,4,0,0,0,0,0,0
1996,4908,60,3,63,1,19,20,0,0,0,0,0,0
1996,4909,8,2,10,0,5,5,0,0,0,0,0,0
1996,4914,9,1,10,3,2,5,0,0,0,0,0,0
1996,5000,170,9,179,8,63,71,0,0,0,152,91,243
1996,5001,33,2,35,2,12,14,0,0,0,0,0,0
1996,5002,219,6,225,20,69,89,0,0,0,0,0,0
1996,5003,11,0,11,0,1,1,0,0,0,0,0,0
1996,5005,14,0,14,0,2,2,0,0,0,0,0,0
1996,5007,51,2,53,5,26,31,0,0,0,0,0,0
1996,5008,11,0,11,0,1,1,0,0,0,0,0,0
1996,5009,5,0,5,2,1,3,0,0,0,0,0,0
1996,5010,8,2,10,3,3,6,0,0,0,0,0,0
1996,5100,51,2,53,3,14,17,0,0,0,0,0,0
1996,5102,42,1,43,4,21,25,0,0,0,0,0,0
1996,5200,24,1,25,2,19,21,26,2,28,2,6,8
1996,5201,13,1,14,0,4,4,0,0,0,0,0,0
1996,5202,23,2,25,2,12,14,0,0,0,0,0,0
1996,5300,19,1,20,1,4,5,0,0,0,0,0,0
1996,5400,163,8,171,3,71,74,98,24,122,31,11,42
1996,5401,17,0,17,1,5,6,0,0,0,0,0,0
1996,5402,13,1,14,0,1,1,0,0,0,0,0,0
1996,5403,8,2,10,0,1,1,0,0,0,0,0,0
1996,5404,17,1,18,3,5,8,0,0,0,0,0,0
1996,5405,37,4,41,5,19,24,0,0,0,0,0,0
1996,5406,46,1,47,3,17,20,0,0,0,0,0,0
1996,5407,79,8,87,7,34,41,0,0,0,0,0,0
1996,5408,11,0,11,0,1,1,0,0,0,0,0,0
1996,5411,0,0,0,0,1,1,1,0,1,1,0,1
1996,5500,50,0,50,2,20,22,0,0,0,0,0,0
1996,5600,452,58,510,46,126,172,162,28,190,132,102,234
1996,5604,160,14,174,27,68,95,0,0,0,0,0,0
1996,5605,20,1,21,0,7,7,0,0,0,0,0,0
1996,5606,28,1,29,2,7,9,0,0,0,0,0,0
1996,5608,110,8,118,9,59,68,0,0,0,0,0,0
1996,5609,106,6,112,12,45,57,0,0,0,0,0,0
1996,5700,54,4,58,11,19,30,14,5,19,56,50,106
1996,5701,46,6,52,2,17,19,0,0,0,0,0,0
1996,5702,9,1,10,0,1,1,0,0,0,0,0,0
1996,5703,47,7,54,6,19,25,0,0,0,0,0,0
1996,5704,50,4,54,1,22,23,0,0,0,0,0,0
1996,5797,0,0,0,0,0,0,0,0,0,0,0,0
1996,5800,45,4,49,7,16,23,0,0,0,0,0,0
1996,5801,25,1,26,3,10,13,0,0,0,0,0,0
1996,190C,19,2,21,3,3,6,0,0,0,0,0,0
1996,190R,8,1,9,6,3,9,0,0,0,0,0,0
1996,192Q,9,1,10,0,0,0,0,0,0,0,0,0
1996,192R,6,1,7,6,6,12,0,0,0,0,0,0
1997,100,349,44,393,88,165,253,367,55,422,106,173,279
1997,101,99,7,106,6,29,35,0,0,0,0,2,2
1997,102,26,1,27,0,4,4,0,0,0,0,0,0
1997,103,165,29,194,5,85,90,1,0,1,9,7,16
1997,104,31,3,34,1,15,16,0,0,0,0,0,0
1997,105,178,17,195,16,73,89,1,0,1,8,8,16
1997,106,149,21,170,18,56,74,0,0,0,17,12,29
1997,107,65,5,70,7,31,38,0,0,0,0,0,0
1997,108,52,3,55,8,11,19,0,0,0,0,0,0
1997,109,594,65,659,87,232,319,5,0,5,53,23,76
1997,110,18,2,20,1,5,6,0,0,0,0,0,0
1997,111,69,6,75,4,24,28,0,0,0,0,0,0
1997,112,88,6,94,8,26,34,0,2,2,4,0,4
1997,113,62,8,70,4,19,23,0,0,0,0,0,0
1997,114,43,3,46,4,19,23,0,0,0,0,0,0
1997,115,12,1,13,11,7,18,0,0,0,0,0,0
1997,121,148,19,167,37,32,69,0,0,0,0,0,0
1997,122,2,0,2,2,3,5,0,0,0,0,0,0
1997,130,30,5,35,1,5,6,0,0,0,0,0,0
1997,197,59,11,70,20,18,38,0,0,0,0,0,0
1997,200,9,0,9,0,3,3,0,0,0,0,0,0
1997,300,39,0,39,0,16,16,2,0,2,9,11,20
1997,302,6,0,6,0,1,1,0,0,0,0,0,0
1997,303,7,3,10,0,2,2,0,0,0,0,0,0
1997,305,5,0,5,0,1,1,0,0,0,0,0,0
1997,400,90,2,92,3,30,33,1,0,1,48,23,71
1997,402,60,14,74,33,4,37,0,0,0,0,0,0
1997,403,11,1,12,1,5,6,0,0,0,0,0,0
1997,404,22,2,24,1,9,10,0,0,0,0,0,0
1997,405,22,1,23,0,9,9,0,0,0,0,0,0
1997,497,8,2,10,2,2,4,0,0,0,0,0,0
1997,500,43,2,45,1,14,15,1,0,1,8,9,17
1997,501,5,1,6,0,1,1,0,0,0,0,0,0
1997,600,29,1,30,1,12,13,2,1,3,6,6,12
1997,601,8,0,8,0,1,1,0,0,0,0,0,0
1997,602,6,1,7,0,1,1,0,0,0,0,0,0
1997,700,374,59,433,29,95,124,212,32,244,13,37,50
1997,701,90,8,98,2,36,38,0,0,0,0,0,0
1997,702,25,0,25,1,7,8,0,0,0,0,0,0
1997,703,8,2,10,0,2,2,0,0,0,0,0,0
1997,704,139,16,155,6,45,51,0,0,0,4,0,4
1997,705,30,3,33,1,5,6,0,0,0,0,0,0
1997,706,17,3,20,1,3,4,0,0,0,0,0,0
1997,707,24,0,24,4,13,17,0,0,0,0,0,0
1997,708,67,3,70,3,16,19,0,0,0,0,0,0
1997,709,40,3,43,2,19,21,0,0,0,0,0,0
1997,710,172,13,185,5,56,61,0,0,0,4,6,10
1997,711,42,0,42,2,8,10,0,0,0,0,0,0
1997,712,75,5,80,4,21,25,0,0,0,0,0,0
1997,713,9,0,9,0,0,0,0,0,0,0,0,0
1997,714,37,0,37,2,11,13,0,0,0,0,0,0
1997,716,11,1,12,0,1,1,0,0,0,0,0,0
1997,721,17,4,21,4,4,8,0,0,0,0,0,0
1997,800,20,5,25,1,9,10,0,0,0,0,0,0
1997,801,11,0,11,0,1,1,0,0,0,0,0,0
1997,900,149,3,152,9,35,44,1,0,1,57,55,112
1997,901,16,0,16,1,5,6,0,0,0,0,0,0
1997,902,48,3,51,2,15,17,0,0,0,0,0,0
1997,1000,330,31,361,35,125,160,0,0,0,0,0,0
1997,1001,72,9,81,4,31,35,0,0,0,0,0,0
1997,1002,19,0,19,1,6,7,0,0,0,0,0,0
1997,1003,9,1,10,1,3,4,0,0,0,0,0,0
1997,1004,6,0,6,0,1,1,0,0,0,0,0,0
1997,1005,530,51,581,73,211,284,0,0,0,0,0,0
1997,1006,10,1,11,3,2,5,0,0,0,0,0,0
1997,1007,15,0,15,0,2,2,0,0,0,0,0,0
1997,1008,13,0,13,1,4,5,0,0,0,0,0,0
1997,1011,11,0,11,0,2,2,0,0,0,0,0,0
1997,1012,21,2,23,2,11,13,0,0,0,0,0,0
1997,1013,24,1,25,1,7,8,0,0,0,0,0,0
1997,1015,26,2,28,0,12,12,0,0,0,0,0,0
1997,1017,13,1,14,0,1,1,0,0,0,0,0,0
1997,1097,12,3,15,2,7,9,0,0,0,0,0,0
1997,1100,20,2,22,3,10,13,1,0,1,11,7,18
1997,1101,8,0,8,0,1,1,0,0,0,0,0,0
1997,1102,8,0,8,0,1,1,0,0,0,0,0,0
1997,1200,64,3,67,1,28,29,1,0,1,61,24,85
1997,1201,21,1,22,2,6,8,0,0,0,0,0,0
1997,1202,4,0,4,0,0,0,0,0,0,0,0,0
1997,1203,44,5,49,4,25,29,0,0,0,0,0,0
1997,1204,2,0,2,0,0,0,0,0,0,0,0,0
1997,1205,14,1,15,0,6,6,0,0,0,0,0,0
1997,1206,1,0,1,0,0,0,0,0,0,0,0,0
1997,1207,6,1,7,0,0,0,0,0,0,0,0,0
1997,1208,11,0,11,1,4,5,0,0,0,0,0,0
1997,1300,73,18,91,6,29,35,0,0,0,0,0,0
1997,1301,24,1,25,1,9,10,0,0,0,0,0,0
1997,1302,32,3,35,6,10,16,0,0,0,0,0,0
1997,1303,5,0,5,1,1,2,0,0,0,0,0,0
1997,1304,45,3,48,6,15,21,0,0,0,0,0,0
1997,1305,9,2,11,1,2,3,0,0,0,0,0,0
1997,1306,11,0,11,2,1,3,0,0,0,0,0,0
1997,1307,4,0,4,0,0,0,0,0,0,0,0,0
1997,1400,24,0,24,0,2,2,9,1,10,4,19,23
1997,1401,13,0,13,0,7,7,0,0,0,0,0,0
1997,1500,301,26,327,28,111,139,102,19,121,217,167,384
1997,1501,0,0,0,0,6,6,11,0,11,0,0,0
1997,1502,267,13,280,9,92,101,0,0,0,0,0,0
1997,1503,30,3,33,0,11,11,4,0,4,0,0,0
1997,1504,4,0,4,0,1,1,0,0,0,0,0,0
1997,1506,27,1,28,2,11,13,0,0,0,0,0,0
1997,1507,9,1,10,0,6,6,0,0,0,0,0,0
1997,1508,10,0,10,0,7,7,0,0,0,0,0,0
1997,1511,11,1,12,1,5,6,0,0,0,0,0,0
1997,1514,3,0,3,0,0,0,0,0,0,0,0,0
1997,1515,6,0,6,2,2,4,0,0,0,0,0,0
1997,1597,10,0,10,1,2,3,0,0,0,0,0,0
1997,1600,70,3,73,11,33,44,40,15,55,5,9,14
1997,1601,16,1,17,0,3,3,0,0,0,0,0,0
1997,1602,43,1,44,0,16,16,0,0,0,0,0,0
1997,1603,20,2,22,1,5,6,0,0,0,0,0,0
1997,1700,52,2,54,1,18,19,0,0,0,0,0,0
1997,1701,12,0,12,0,2,2,0,0,0,0,0,0
1997,1702,19,0,19,2,8,10,0,0,0,0,0,0
1997,1800,27,0,27,1,5,6,27,19,46,1,12,13
1997,1801,15,2,17,3,1,4,0,0,0,0,0,0
1997,1900,3915,475,4390,936,1650,2586,0,0,0,0,0,0
1997,1901,79,8,87,10,35,45,0,0,0,0,0,0
1997,1902,63,8,71,6,13,19,0,0,0,1,3,4
1997,1905,55,3,58,1,25,26,0,0,0,6,0,6
1997,1906,68,3,71,3,21,24,0,0,0,0,0,0
1997,1907,35,0,35,0,1,1,0,0,0,2,1,3
1997,1909,46,2,48,5,14,19,0,0,0,0,0,0
1997,1910,127,7,134,15,36,51,0,0,0,5,6,11
1997,1912,149,9,158,30,69,99,0,0,0,8,1,9
1997,1913,36,2,38,0,15,15,0,0,0,5,0,5
1997,1915,125,10,135,8,43,51,0,0,0,4,0,4
1997,1916,53,3,56,3,22,25,0,0,0,2,2,4
1997,1918,113,5,118,8,25,33,0,0,0,2,0,2
1997,1920,108,6,114,6,39,45,0,0,0,0,0,0
1997,1922,126,9,135,11,15,26,0,0,0,4,1,5
1997,1923,59,6,65,3,15,18,0,0,0,5,1,6
1997,1924,79,7,86,1,11,12,0,0,0,2,6,8
1997,1925,205,24,229,27,69,96,0,0,0,10,6,16
1997,1926,49,6,55,3,16,19,0,0,0,2,3,5
1997,1927,16,0,16,1,2,3,0,0,0,0,0,0
1997,1928,92,6,98,5,30,35,0,0,0,5,1,6
1997,1929,32,2,34,2,9,11,0,0,0,1,4,5
1997,1931,65,4,69,8,20,28,0,0,0,3,2,5
1997,1933,185,18,203,13,88,101,0,0,0,4,5,9
1997,1934,20,0,20,0,6,6,0,0,0,0,0,0
1997,1938,37,4,41,3,11,14,0,0,0,0,0,0
1997,1941,732,88,820,113,229,342,11,2,13,43,20,63
1997,1942,7813,1673,9486,776,1810,2586,21,3,24,232,109,341
1997,1944,53,6,59,13,11,24,3,1,4,0,0,0
1997,1945,25,0,25,0,5,5,0,0,0,2,2,4
1997,1946,51,4,55,1,18,19,0,0,0,2,0,2
1997,1947,80,5,85,16,25,41,0,0,0,6,0,6
1997,1948,69,11,80,3,32,35,0,0,0,4,1,5
1997,1951,21,1,22,0,7,7,3,2,5,0,0,0
1997,1953,195,33,228,22,63,85,3,0,3,9,8,17
1997,1955,166,5,171,18,96,114,0,0,0,13,6,19
1997,1956,99,4,103,3,41,44,0,0,0,3,6,9
1997,1961,35,2,37,8,12,20,0,0,0,0,0,0
1997,1962,48,7,55,2,11,13,0,0,0,0,0,0
1997,1963,23,4,27,1,4,5,0,0,0,0,0,0
1997,1965,182,26,208,60,87,147,0,0,0,7,6,13
1997,1966,12,1,13,2,3,5,0,0,0,0,0,0
1997,1967,27,4,31,2,6,8,0,0,0,4,1,5
1997,1969,88,3,91,4,27,31,0,0,0,4,1,5
1997,1970,31,2,33,6,8,14,0,0,0,0,0,0
1997,1972,238,10,248,28,57,85,1,0,1,6,8,14
1997,1973,49,3,52,6,13,19,0,0,0,0,0,0
1997,1975,107,7,114,7,26,33,0,0,0,3,3,6
1997,1976,121,6,127,11,39,50,0,0,0,6,0,6
1997,1978,13,2,15,7,13,20,0,0,0,0,0,0
1997,1982,16,5,21,3,3,6,0,0,0,0,0,0
1997,1983,15,2,17,1,4,5,0,0,0,0,0,0
1997,1984,13,1,14,2,4,6,0,0,0,0,0,0
1997,1997,47,8,55,17,20,37,0,0,0,0,0,0
1997,2000,66,5,71,2,22,24,0,0,0,0,0,0
1997,2001,14,0,14,1,5,6,0,0,0,0,0,0
1997,2002,42,2,44,2,11,13,0,0,0,0,0,0
1997,2100,101,16,117,13,49,62,64,19,83,7,13,20
1997,2101,7,0,7,0,0,0,0,0,0,0,0,0
1997,2103,11,0,11,0,4,4,0,0,0,0,0,0
1997,2104,29,2,31,1,10,11,0,0,0,0,0,0
1997,2105,17,2,19,3,7,10,0,0,0,0,0,0
1997,2106,50,7,57,4,18,22,0,0,0,0,0,0
1997,2107,8,1,9,0,0,0,0,0,0,0,0,0
1997,2108,15,1,16,0,3,3,0,0,0,0,0,0
1997,2109,70,4,74,2,29,31,0,0,0,0,0,0
1997,2110,19,0,19,1,4,5,0,0,0,0,0,0
1997,2111,11,1,12,0,2,2,0,0,0,0,0,0
1997,2113,8,0,8,0,1,1,0,0,0,0,0,0
1997,2200,31,5,36,5,5,10,8,5,13,0,0,0
1997,2300,60,1,61,5,19,24,49,8,57,2,6,8
1997,2301,16,2,18,0,4,4,0,0,0,0,0,0
1997,2303,25,1,26,2,7,9,0,0,0,0,0,0
1997,2304,12,0,12,2,5,7,0,0,0,0,0,0
1997,2400,71,2,73,7,18,25,0,0,0,0,0,0
1997,2401,21,1,22,3,5,8,0,0,0,0,0,0
1997,2402,8,0,8,0,0,0,0,0,0,0,0,0
1997,2403,8,1,9,0,1,1,0,0,0,0,0,0
1997,2404,18,1,19,0,6,6,0,0,0,0,0,0
1997,2405,26,2,28,1,11,12,0,0,0,0,0,0
1997,2406,79,2,81,5,29,34,0,0,0,0,0,0
1997,2500,10,1,11,0,1,1,5,4,9,0,0,0
1997,2501,8,0,8,0,1,1,0,0,0,0,0,0
1997,2600,23,1,24,1,3,4,8,8,16,0,0,0
1997,2601,12,2,14,1,3,4,0,0,0,0,0,0
1997,2700,159,8,167,10,59,69,128,34,162,14,23,37
1997,2701,15,0,15,3,6,9,0,0,0,0,0,0
1997,2702,5,0,5,0,0,0,0,0,0,0,0,0
1997,2703,11,0,11,1,1,2,0,0,0,0,0,0
1997,2704,12,0,12,0,2,2,0,0,0,0,0,0
1997,2705,14,0,14,0,2,2,0,0,0,0,0,0
1997,2706,58,3,61,2,6,8,0,0,0,5,5,10
1997,2707,28,2,30,5,6,11,0,0,0,0,0,0
1997,2708,142,6,148,11,37,48,0,0,0,0,0,0
1997,2709,6,0,6,0,1,1,0,0,0,0,0,0
1997,2710,26,6,32,2,8,10,0,0,0,0,0,0
1997,2711,13,1,14,0,2,2,0,0,0,0,0,0
1997,2712,28,2,30,3,4,7,0,0,0,0,0,0
1997,2714,5,0,5,0,0,0,0,0,0,0,0,0
1997,2719,12,2,14,4,4,8,0,0,0,0,0,0
1997,2800,71,3,74,1,17,18,0,0,0,0,0,0
1997,2801,10,0,10,1,3,4,0,0,0,0,0,0
1997,2802,66,6,72,6,39,45,0,0,0,0,0,0
1997,2803,11,1,12,0,5,5,0,0,0,0,0,0
1997,2808,41,9,50,0,1,1,0,0,0,0,0,0
1997,2900,65,3,68,4,29,33,4,0,4,34,33,67
1997,2901,19,0,19,1,7,8,0,0,0,0,0,0
1997,2902,9,0,9,0,1,1,0,0,0,0,0,0
1997,3000,639,69,708,379,479,858,508,80,588,272,163,435
1997,3001,354,30,384,40,121,161,0,0,0,15,10,25
1997,3002,92,10,102,2,22,24,0,0,0,0,0,0
1997,3003,86,4,90,4,38,42,0,0,0,4,1,5
1997,3004,142,5,147,10,54,64,0,0,0,9,1,10
1997,3005,50,3,53,1,13,14,0,0,0,3,0,3
1997,3006,21,2,23,0,6,6,0,0,0,0,0,0
1997,3007,56,7,63,6,25,31,0,0,0,0,0,0
1997,3008,138,11,149,7,56,63,0,0,0,5,0,5
1997,3009,155,12,167,7,56,63,0,0,0,0,0,0
1997,3010,207,10,217,32,87,119,1,0,1,11,7,18
1997,3011,39,7,46,1,31,32,0,0,0,0,0,0
1997,3012,63,7,70,7,24,31,0,0,0,0,0,0
1997,3013,23,2,25,1,1,2,0,0,0,0,0,0
1997,3014,131,3,134,17,50,67,0,0,0,7,1,8
1997,3015,130,13,143,9,53,62,0,0,0,0,0,0
1997,3016,51,1,52,4,12,16,0,0,0,0,0,0
1997,3019,356,12,368,20,158,178,0,0,0,46,64,110
1997,3020,29,3,32,3,7,10,0,0,0,0,0,0
1997,3022,83,6,89,6,33,39,0,0,0,0,0,0
1997,3024,91,5,96,4,38,42,0,0,0,0,0,0
1997,3026,122,20,142,10,49,59,0,0,0,0,0,0
1997,3027,13,1,14,4,12,16,0,0,0,0,0,0
1997,3091,233,37,270,14,63,77,63,11,74,0,0,0
1997,3097,22,6,28,2,6,8,0,0,0,0,0,0
1997,3100,156,14,170,8,70,78,34,4,38,38,38,76
1997,3101,20,1,21,1,9,10,0,0,0,0,0,0
1997,3103,8,2,10,2,4,6,0,0,0,0,0,0
1997,3104,28,1,29,4,11,15,0,0,0,0,0,0
1997,3105,69,3,72,6,34,40,0,0,0,5,5,10
1997,3200,35,0,35,2,10,12,0,0,0,10,8,18
1997,3300,890,107,997,75,391,466,148,24,172,369,239,608
1997,3301,31,0,31,2,12,14,0,0,0,0,0,0
1997,3302,17,0,17,0,6,6,0,0,0,0,0,0
1997,3303,22,2,24,2,12,14,0,0,0,0,0,0
1997,3305,27,2,29,1,3,4,0,0,0,0,0,0
1997,3308,52,4,56,1,16,17,0,0,0,0,0,0
1997,3309,49,1,50,5,18,23,0,0,0,0,0,0
1997,3311,68,5,73,12,23,35,0,0,0,2,2,4
1997,3313,296,29,325,37,122,159,0,0,0,0,0,0
1997,3314,20,1,21,1,9,10,0,0,0,0,0,0
1997,3315,115,13,128,11,49,60,0,0,0,0,0,0
1997,3325,41,2,43,6,15,21,0,0,0,0,0,0
1997,3342,24,2,26,1,8,9,0,0,0,0,0,0
1997,3397,19,2,21,3,4,7,0,0,0,0,0,0
1997,3400,736,127,863,89,209,298,313,81,394,84,105,189
1997,3401,40,1,41,1,11,12,0,0,0,0,0,0
1997,3402,19,1,20,2,8,10,0,0,0,0,0,0
1997,3403,4,0,4,0,0,0,0,0,0,0,0,0
1997,3404,534,83,617,121,296,417,0,0,0,0,0,0
1997,3408,14,0,14,1,5,6,0,0,0,0,0,0
1997,3420,4,0,4,0,1,1,0,0,0,0,0,0
1997,3422,517,126,643,18,59,77,0,0,0,0,0,0
1997,3497,38,7,45,9,25,34,0,0,0,0,0,0
1997,3499,5989,567,6556,1347,1777,3124,0,0,0,0,0,0
1997,3500,19,0,19,1,6,7,0,0,0,15,17,32
1997,3501,25,0,25,2,4,6,0,0,0,0,0,0
1997,3600,736,129,865,179,401,580,298,64,362,117,260,377
1997,3601,43,1,44,1,15,16,0,0,0,0,0,0
1997,3602,77,2,79,3,21,24,0,0,0,0,0,0
1997,3603,59,3,62,4,11,15,0,0,0,0,0,0
1997,3604,112,5,117,5,44,49,0,0,0,0,0,0
1997,3605,49,4,53,1,22,23,0,0,0,0,0,0
1997,3607,204,10,214,22,78,100,0,0,0,0,0,0
1997,3608,71,4,75,15,33,48,0,0,0,0,0,0
1997,3609,99,12,111,3,38,41,0,0,0,0,0,0
1997,3610,253,22,275,29,103,132,0,0,0,9,2,11
1997,3611,80,5,85,6,30,36,0,0,0,0,0,0
1997,3613,26,1,27,2,7,9,0,0,0,0,0,0
1997,3614,11,1,12,1,4,5,0,0,0,0,0,0
1997,3623,17,3,20,21,22,43,0,0,0,0,0,0
1997,3650,12,3,15,0,6,6,0,0,0,0,0,0
1997,3700,847,173,1020,146,306,452,732,150,882,197,410,607
1997,3701,77,8,85,2,25,27,0,0,0,0,0,0
1997,3702,160,19,179,21,62,83,0,0,0,0,0,0
1997,3703,39,3,42,5,12,17,0,0,0,0,0,0
1997,3705,124,10,134,18,55,73,0,0,0,0,0,0
1997,3706,133,14,147,15,50,65,0,0,0,0,0,0
1997,3708,56,5,61,4,15,19,0,0,0,0,0,0
1997,3709,72,4,76,4,23,27,0,0,0,0,0,0
1997,3710,152,15,167,20,48,68,0,0,0,0,0,0
1997,3711,1721,285,2006,269,492,761,0,0,0,0,0,0
1997,3714,19,2,21,2,10,12,0,0,0,0,0,0
1997,3715,98,14,112,6,17,23,0,0,0,0,0,0
1997,3732,5,1,6,4,3,7,0,0,0,0,0,0
1997,3797,21,6,27,13,5,18,0,0,0,0,0,0
1997,3801,1698,300,1998,160,318,478,0,0,0,0,0,0
1997,3803,17,6,23,8,7,15,0,0,0,0,0,0
1997,3816,0,0,0,0,0,0,0,0,0,0,0,0
1997,3897,20,3,23,11,7,18,0,0,0,0,0,0
1997,3900,168,21,189,41,78,119,0,0,0,0,0,0
1997,3901,8,0,8,0,2,2,0,0,0,0,0,0
1997,3902,71,5,76,2,16,18,0,0,0,4,12,16
1997,3903,48,2,50,4,16,20,0,0,0,0,0,0
1997,3904,11,3,14,0,0,0,0,0,0,0,0,0
1997,3905,334,33,367,136,38,174,0,0,0,0,0,0
1997,3906,43,3,46,8,15,23,0,0,0,0,0,0
1997,3915,15,1,16,0,5,5,0,0,0,0,0,0
1997,4000,135,4,139,6,45,51,95,25,120,7,25,32
1997,4001,21,2,23,1,8,9,0,0,0,0,0,0
1997,4002,17,2,19,1,8,9,0,0,0,0,0,0
1997,4003,18,1,19,1,6,7,0,0,0,0,0,0
1997,4004,27,2,29,1,6,7,0,0,0,0,0,0
1997,4005,18,1,19,0,7,7,0,0,0,0,0,0
1997,4006,53,4,57,7,18,25,0,0,0,0,0,0
1997,4007,11,4,15,0,0,0,0,0,0,0,0,0
1997,4008,23,3,26,1,8,9,0,0,0,0,0,0
1997,4016,64,27,91,5,5,10,0,0,0,0,0,0
1997,4100,181,13,194,34,52,86,90,20,110,66,48,114
1997,4101,22,2,24,3,4,7,0,0,0,0,0,0
1997,4102,28,3,31,4,11,15,0,0,0,0,0,0
1997,4103,10,4,14,0,2,2,0,0,0,0,0,0
1997,4104,41,4,45,4,15,19,0,0,0,0,0,0
1997,4105,15,0,15,0,3,3,0,0,0,0,0,0
1997,4106,105,7,112,5,32,37,0,0,0,0,0,0
1997,4107,14,2,16,0,2,2,0,0,0,0,0,0
1997,4108,23,3,26,0,5,5,0,0,0,0,0,0
1997,4109,43,6,49,4,19,23,0,0,0,0,0,0
1997,4110,25,2,27,2,7,9,0,0,0,0,0,0
1997,4111,36,1,37,2,10,12,0,0,0,0,0,0
1997,4113,74,9,83,2,32,34,0,0,0,0,0,0
1997,4114,47,3,50,0,8,8,0,0,0,0,0,0
1997,4115,33,2,35,1,11,12,0,0,0,0,0,0
1997,4116,90,11,101,0,33,33,0,0,0,0,0,0
1997,4117,70,5,75,5,25,30,0,0,0,0,0,0
1997,4119,9,0,9,1,1,2,0,0,0,0,0,0
1997,4120,37,6,43,3,11,14,0,0,0,0,0,0
1997,4127,32,5,37,4,11,15,0,0,0,0,0,0
1997,4200,238,18,256,24,89,113,103,59,162,20,20,40
1997,4201,6,1,7,0,1,1,0,0,0,0,0,0
1997,4202,43,1,44,1,7,8,0,0,0,4,5,9
1997,4203,129,12,141,15,58,73,0,0,0,0,0,0
1997,4204,75,8,83,5,27,32,0,0,0,0,0,0
1997,4211,1,0,1,0,1,1,0,0,0,0,0,0
1997,4297,22,3,25,4,7,11,0,0,0,0,0,0
1997,4300,324,50,374,28,96,124,32,1,33,0,2,2
1997,4302,43,2,45,4,16,20,0,0,0,0,0,0
1997,4304,50,4,54,6,29,35,0,0,0,1,3,4
1997,4305,26,4,30,4,10,14,0,0,0,0,0,0
1997,4307,39,3,42,8,13,21,0,0,0,0,0,0
1997,4308,73,10,83,10,25,35,0,0,0,0,0,0
1997,4310,23,3,26,0,13,13,0,0,0,0,0,0
1997,4311,86,11,97,8,24,32,0,0,0,0,0,0
1997,4312,70,17,87,23,50,73,0,0,0,0,0,0
1997,4313,1208,108,1316,103,349,452,0,0,0,0,0,0
1997,4314,135,5,140,5,33,38,0,0,0,0,0,0
1997,4316,266,6,272,16,38,54,0,0,0,0,0,0
1997,4317,25,4,29,9,11,20,0,0,0,0,0,0
1997,4320,5,1,6,1,2,3,0,0,0,0,0,0
1997,4321,6,2,8,0,2,2,0,0,0,0,0,0
1997,4327,10,0,10,0,1,1,0,0,0,0,0,0
1997,4400,120,11,131,1,30,31,2,0,2,88,40,128
1997,4401,22,0,22,4,6,10,0,0,0,0,0,0
1997,4402,88,5,93,4,26,30,0,0,0,0,0,0
1997,4403,57,3,60,0,11,11,0,0,0,0,0,0
1997,4404,18,2,20,1,7,8,0,0,0,0,0,0
1997,4405,2,0,2,0,2,2,0,0,0,0,0,0
1997,4497,13,4,17,8,11,19,0,0,0,0,0,0
1997,4500,83,10,93,4,40,44,39,16,55,21,18,39
1997,4501,15,0,15,1,8,9,0,0,0,0,0,0
1997,4502,99,5,104,8,41,49,0,0,0,0,0,0
1997,4600,9,1,10,1,5,6,0,0,0,0,0,0
1997,4700,46,0,46,4,13,17,0,0,0,0,0,0
1997,4701,2,0,2,0,0,0,0,0,0,0,0,0
1997,4702,4,0,4,0,0,0,0,0,0,0,0,0
1997,4704,1,0,1,0,0,0,0,0,0,0,0,0
1997,4705,1,0,1,0,0,0,0,0,0,0,0,0
1997,4706,8,1,9,2,3,5,0,0,0,0,0,0
1997,4707,4,0,4,3,0,3,0,0,0,0,0,0
1997,4708,9,0,9,2,2,4,0,0,0,0,0,0
1997,4709,14,0,14,5,2,7,0,0,0,0,0,0
1997,4710,4,0,4,0,0,0,0,0,0,0,0,0
1997,4800,86,2,88,6,48,54,2,0,2,164,90,254
1997,4801,34,0,34,2,12,14,0,0,0,0,0,0
1997,4802,16,1,17,0,2,2,0,0,0,0,0,0
1997,4803,90,7,97,12,39,51,0,0,0,0,0,0
1997,4804,11,0,11,0,1,1,0,0,0,0,0,0
1997,4805,26,1,27,1,7,8,0,0,0,0,0,0
1997,4806,86,10,96,6,50,56,0,0,0,0,0,0
1997,4807,132,10,142,13,51,64,0,0,0,0,0,0
1997,4900,205,7,212,9,81,90,141,52,193,32,59,91
1997,4901,9,1,10,1,3,4,0,0,0,0,0,0
1997,4902,10,1,11,1,5,6,0,0,0,0,0,0
1997,4903,15,1,16,2,8,10,0,0,0,0,0,0
1997,4904,56,4,60,8,22,30,0,0,0,0,0,0
1997,4905,146,12,158,13,66,79,0,0,0,0,0,0
1997,4906,15,0,15,1,4,5,0,0,0,0,0,0
1997,4907,11,3,14,0,3,3,0,0,0,0,0,0
1997,4908,58,3,61,2,26,28,0,0,0,0,0,0
1997,4909,8,2,10,0,4,4,0,0,0,0,0,0
1997,4914,9,1,10,3,3,6,0,0,0,0,0,0
1997,5000,162,8,170,7,66,73,0,0,0,0,0,0
1997,5001,35,3,38,2,11,13,0,0,0,0,0,0
1997,5002,252,10,262,24,72,96,0,0,0,0,0,0
1997,5003,11,0,11,1,2,3,0,0,0,0,0,0
1997,5004,21,2,23,3,6,9,0,0,0,0,0,0
1997,5005,14,0,14,0,2,2,0,0,0,0,0,0
1997,5007,54,2,56,4,27,31,0,0,0,0,0,0
1997,5008,5,0,5,0,2,2,0,0,0,0,0,0
1997,5009,7,0,7,0,1,1,0,0,0,0,0,0
1997,5010,9,1,10,2,4,6,0,0,0,0,0,0
1997,5100,51,3,54,2,16,18,2,0,2,25,24,49
1997,5102,41,1,42,8,17,25,0,0,0,0,0,0
1997,5200,30,0,30,1,20,21,35,3,38,2,4,6
1997,5201,11,2,13,1,5,6,0,0,0,0,0,0
1997,5202,23,2,25,2,12,14,0,0,0,0,0,0
1997,5300,19,1,20,0,5,5,0,0,0,0,0,0
1997,5400,196,17,213,13,69,82,136,21,157,28,10,38
1997,5401,18,1,19,1,5,6,0,0,0,0,0,0
1997,5402,13,1,14,0,1,1,0,0,0,0,0,0
1997,5403,9,1,10,0,1,1,0,0,0,0,0,0
1997,5404,17,1,18,4,4,8,0,0,0,0,0,0
1997,5405,41,3,44,1,21,22,0,0,0,0,0,0
1997,5406,45,5,50,8,13,21,0,0,0,0,0,0
1997,5407,80,8,88,5,34,39,0,0,0,0,0,0
1997,5408,11,0,11,0,1,1,0,0,0,0,0,0
1997,5411,3,1,4,0,1,1,0,0,0,0,0,0
1997,5500,49,0,49,2,21,23,0,0,0,0,0,0
1997,5501,12,1,13,0,4,4,0,0,0,0,0,0
1997,5600,463,53,516,57,158,215,167,29,196,138,101,239
1997,5604,172,16,188,26,83,109,0,0,0,6,3,9
1997,5605,20,1,21,0,7,7,0,0,0,0,0,0
1997,5606,28,1,29,0,7,7,0,0,0,0,0,0
1997,5608,115,9,124,11,57,68,0,0,0,0,0,0
1997,5609,109,7,116,12,48,60,0,0,0,0,0,0
1997,5700,48,8,56,9,20,29,12,4,16,46,48,94
1997,5701,45,6,51,3,20,23,0,0,0,0,1,1
1997,5702,9,0,9,0,1,1,0,0,0,0,0,0
1997,5703,45,4,49,4,15,19,0,0,0,0,0,0
1997,5704,45,4,49,3,23,26,0,0,0,0,0,0
1997,5800,56,6,62,4,15,19,0,0,0,0,0,0
1997,5801,27,0,27,4,10,14,0,0,0,0,0,0
1997,5802,5,0,5,0,0,0,0,0,0,0,0,0
1997,190C,16,3,19,2,5,7,0,0,0,0,0,0
1997,190P,15,1,16,0,1,1,0,0,0,0,0,0
1997,190R,8,1,9,5,5,10,0,0,0,0,0,0
1997,191E,0,0,0,0,0,0,0,0,0,0,0,0
1997,192Q,8,1,9,0,1,1,0,0,0,0,0,0
1997,192R,6,1,7,6,4,10,0,0,0,0,0,0
1998,100,347,48,395,92,171,263,359,55,414,128,170,298
1998,101,101,7,108,6,37,43,0,0,0,0,2,2
1998,102,26,1,27,0,4,4,0,0,0,0,0,0
1998,103,162,26,188,20,56,76,1,0,1,7,9,16
1998,104,34,3,37,2,15,17,0,0,0,0,0,0
1998,105,178,18,196,13,72,85,1,0,1,8,8,16
1998,106,154,22,176,24,70,94,0,0,0,10,4,14
1998,107,67,5,72,6,34,40,0,0,0,0,0,0
1998,108,49,4,53,12,8,20,0,0,0,0,0,0
1998,109,660,68,728,71,239,310,6,0,6,63,21,84
1998,110,17,3,20,1,6,7,0,0,0,0,0,0
1998,111,71,6,77,4,26,30,0,0,0,0,0,0
1998,112,90,6,96,12,34,46,0,0,0,6,2,8
1998,113,61,11,72,3,19,22,0,0,0,0,0,0
1998,114,41,4,45,8,22,30,0,0,0,0,0,0
1998,115,14,1,15,12,7,19,0,0,0,0,0,0
1998,121,155,19,174,39,35,74,0,0,0,0,0,0
1998,122,2,0,2,2,3,5,0,0,0,0,0,0
1998,197,58,13,71,19,16,35,0,0,0,0,0,0
1998,200,11,0,11,0,3,3,0,0,0,0,0,0
1998,300,39,0,39,0,21,21,1,0,1,11,11,22
1998,302,5,0,5,0,1,1,0,0,0,0,0,0
1998,303,6,1,7,0,2,2,0,0,0,0,0,0
1998,305,5,0,5,0,1,1,0,0,0,0,0,0
1998,400,99,2,101,4,31,35,1,0,1,49,32,81
1998,402,60,10,70,2,39,41,0,0,0,0,0,0
1998,403,11,1,12,1,5,6,0,0,0,0,0,0
1998,404,22,2,24,1,9,10,0,0,0,0,0,0
1998,405,22,1,23,0,10,10,0,0,0,0,0,0
1998,497,9,2,11,2,2,4,0,0,0,0,0,0
1998,500,39,1,40,1,15,16,0,0,0,7,8,15
1998,501,6,1,7,0,1,1,0,0,0,0,0,0
1998,600,33,0,33,2,13,15,10,4,14,0,2,2
1998,601,8,1,9,0,1,1,0,0,0,0,0,0
1998,602,7,0,7,0,1,1,0,0,0,0,0,0
1998,700,327,43,370,31,91,122,178,27,205,42,63,105
1998,701,87,6,93,5,33,38,0,0,0,0,0,0
1998,702,25,1,26,1,6,7,0,0,0,0,0,0
1998,703,9,1,10,0,1,1,0,0,0,0,0,0
1998,704,133,23,156,12,43,55,0,0,0,5,0,5
1998,705,29,3,32,1,5,6,0,0,0,0,0,0
1998,706,18,3,21,1,3,4,0,0,0,0,0,0
1998,707,21,0,21,2,12,14,0,0,0,0,0,0
1998,708,73,2,75,0,14,14,0,0,0,0,0,0
1998,709,40,3,43,3,17,20,0,0,0,0,0,0
1998,710,167,15,182,11,55,66,0,0,0,3,7,10
1998,711,39,1,40,3,8,11,0,0,0,0,0,0
1998,712,75,5,80,4,23,27,0,0,0,0,0,0
1998,713,10,0,10,1,0,1,0,0,0,0,0,0
1998,714,36,1,37,2,11,13,0,0,0,0,0,0
1998,716,11,1,12,0,1,1,0,0,0,0,0,0
1998,721,16,4,20,2,5,7,0,0,0,0,0,0
1998,800,24,3,27,2,8,10,0,0,0,0,0,0
1998,801,12,0,12,0,1,1,0,0,0,0,0,0
1998,900,150,6,156,10,65,75,1,0,1,57,54,111
1998,901,17,0,17,1,4,5,0,0,0,0,0,0
1998,902,57,3,60,5,13,18,0,0,0,0,0,0
1998,1000,351,33,384,36,129,165,0,0,0,0,0,0
1998,1001,68,8,76,5,31,36,0,0,0,0,0,0
1998,1002,20,0,20,1,8,9,0,0,0,0,0,0
1998,1003,9,1,10,1,4,5,0,0,0,0,0,0
1998,1004,7,0,7,0,1,1,0,0,0,0,0,0
1998,1005,582,66,648,69,222,291,0,0,0,0,0,0
1998,1006,10,0,10,2,2,4,0,0,0,0,0,0
1998,1007,16,0,16,0,2,2,0,0,0,0,0,0
1998,1008,14,1,15,1,4,5,0,0,0,0,0,0
1998,1011,12,0,12,0,1,1,0,0,0,0,0,0
1998,1012,21,1,22,1,12,13,0,0,0,0,0,0
1998,1013,20,1,21,2,7,9,0,0,0,0,0,0
1998,1015,26,1,27,0,12,12,0,0,0,0,0,0
1998,1017,9,0,9,0,1,1,0,0,0,0,0,0
1998,1031,4,0,4,0,1,1,0,0,0,0,0,0
1998,1097,17,3,20,0,8,8,0,0,0,0,0,0
1998,1100,24,1,25,1,10,11,1,0,1,13,8,21
1998,1101,6,1,7,0,1,1,0,0,0,0,0,0
1998,1102,9,0,9,0,1,1,0,0,0,0,0,0
1998,1200,73,6,79,3,23,26,1,0,1,70,30,100
1998,1201,21,1,22,5,6,11,0,0,0,0,0,0
1998,1202,4,0,4,0,0,0,0,0,0,0,0,0
1998,1203,43,4,47,3,25,28,0,0,0,0,0,0
1998,1204,2,1,3,0,0,0,0,0,0,0,0,0
1998,1205,14,1,15,0,6,6,0,0,0,0,0,0
1998,1206,2,0,2,0,0,0,0,0,0,0,0,0
1998,1207,5,0,5,0,0,0,0,0,0,0,0,0
1998,1208,11,0,11,3,6,9,0,0,0,0,0,0
1998,1300,66,4,70,8,32,40,0,0,0,0,0,0
1998,1301,23,1,24,2,11,13,0,0,0,0,0,0
1998,1302,37,3,40,6,10,16,0,0,0,0,0,0
1998,1303,5,0,5,0,1,1,0,0,0,0,0,0
1998,1304,43,5,48,6,16,22,0,0,0,0,0,0
1998,1305,8,0,8,0,3,3,0,0,0,0,0,0
1998,1306,10,1,11,2,1,3,0,0,0,0,0,0
1998,1307,4,0,4,0,0,0,0,0,0,0,0,0
1998,1400,31,1,32,1,10,11,7,0,7,6,13,19
1998,1401,14,0,14,0,7,7,0,0,0,0,0,0
1998,1500,288,22,310,26,116,142,0,0,0,0,0,0
1998,1501,12,0,12,0,6,6,0,0,0,0,0,0
1998,1502,272,15,287,10,91,101,0,0,0,0,0,0
1998,1503,35,2,37,0,13,13,4,0,4,0,0,0
1998,1504,6,0,6,0,1,1,0,0,0,0,0,0
1998,1506,30,1,31,2,10,12,0,0,0,0,0,0
1998,1507,14,1,15,1,5,6,0,0,0,0,0,0
1998,1508,9,0,9,0,7,7,0,0,0,0,0,0
1998,1511,12,1,13,1,4,5,0,0,0,0,0,0
1998,1513,24,5,29,5,6,11,0,0,0,0,0,0
1998,1514,4,0,4,0,0,0,0,0,0,0,0,0
1998,1515,6,0,6,2,2,4,0,0,0,0,0,0
1998,1597,8,0,8,2,2,4,0,0,0,0,0,0
1998,1600,69,3,72,9,32,41,39,12,51,3,14,17
1998,1601,19,0,19,1,8,9,0,0,0,0,0,0
1998,1602,39,3,42,0,14,14,0,0,0,0,0,0
1998,1603,21,3,24,1,5,6,0,0,0,0,0,0
1998,1606,15,2,17,22,1,23,0,0,0,0,0,0
1998,1700,56,2,58,2,19,21,0,0,0,0,0,0
1998,1701,12,0,12,0,2,2,0,0,0,0,0,0
1998,1702,24,0,24,3,6,9,0,0,0,0,0,0
1998,1800,33,0,33,1,6,7,2,1,3,24,27,51
1998,1801,15,3,18,0,4,4,0,0,0,0,0,0
1998,1900,4088,498,4586,998,1737,2735,0,0,0,0,0,0
1998,1901,80,8,88,9,41,50,0,0,0,0,0,0
1998,1902,65,8,73,5,14,19,0,0,0,1,3,4
1998,1905,55,3,58,1,21,22,0,0,0,5,0,5
1998,1906,73,3,76,7,23,30,0,0,0,8,0,8
1998,1907,33,1,34,0,8,8,0,0,0,0,1,1
1998,1909,52,4,56,5,13,18,0,0,0,0,0,0
1998,1910,123,7,130,16,35,51,0,0,0,3,5,8
1998,1912,148,9,157,22,49,71,0,0,0,8,2,10
1998,1913,38,2,40,0,14,14,0,0,0,5,0,5
1998,1915,142,7,149,7,53,60,0,0,0,4,1,5
1998,1916,52,4,56,3,20,23,0,0,0,3,1,4
1998,1918,117,6,123,8,23,31,0,0,0,4,1,5
1998,1920,101,5,106,7,40,47,0,0,0,0,0,0
1998,1922,125,10,135,9,19,28,0,0,0,5,1,6
1998,1923,58,5,63,8,12,20,0,0,0,4,1,5
1998,1924,61,7,68,0,11,11,0,0,0,2,5,7
1998,1925,205,24,229,18,77,95,0,0,0,9,7,16
1998,1926,50,5,55,2,8,10,0,0,0,3,7,10
1998,1928,82,6,88,3,28,31,0,0,0,2,2,4
1998,1929,32,2,34,2,9,11,0,0,0,1,3,4
1998,1931,65,4,69,8,18,26,0,0,0,4,1,5
1998,1933,169,16,185,21,66,87,0,0,0,3,6,9
1998,1934,20,0,20,0,6,6,0,0,0,0,0,0
1998,1938,38,4,42,10,3,13,0,0,0,0,0,0
1998,1941,762,92,854,135,223,358,10,2,12,42,20,62
1998,1942,7948,1753,9701,755,1843,2598,20,2,22,220,103,323
1998,1944,57,5,62,9,18,27,0,1,1,4,1,5
1998,1945,25,1,26,0,6,6,0,0,0,3,1,4
1998,1946,55,5,60,2,16,18,0,0,0,2,0,2
1998,1947,76,5,81,11,25,36,0,0,0,6,1,7
1998,1948,67,11,78,4,30,34,0,0,0,5,0,5
1998,1951,20,3,23,0,6,6,0,0,0,2,2,4
1998,1953,199,33,232,24,66,90,1,0,1,9,7,16
1998,1955,159,7,166,21,89,110,1,0,1,11,8,19
1998,1956,99,6,105,2,30,32,0,0,0,3,7,10
1998,1961,33,2,35,11,9,20,0,0,0,0,0,0
1998,1962,49,6,55,2,11,13,0,0,0,0,0,0
1998,1963,22,3,25,1,3,4,0,0,0,0,0,0
1998,1965,172,27,199,57,88,145,0,0,0,7,6,13
1998,1966,13,1,14,2,3,5,0,0,0,0,0,0
1998,1967,25,5,30,2,7,9,0,0,0,3,3,6
1998,1969,86,3,89,7,38,45,0,0,0,4,1,5
1998,1970,32,1,33,2,7,9,0,0,0,2,1,3
1998,1972,229,8,237,14,68,82,0,0,0,7,7,14
1998,1973,52,2,54,7,15,22,0,0,0,0,0,0
1998,1975,108,6,114,8,28,36,0,0,0,4,3,7
1998,1976,122,6,128,11,44,55,0,0,0,6,0,6
1998,1978,12,1,13,6,15,21,0,0,0,0,0,0
1998,1981,11,1,12,4,2,6,0,0,0,0,0,0
1998,1982,14,5,19,3,3,6,0,0,0,0,0,0
1998,1983,13,2,15,4,3,7,0,0,0,0,0,0
1998,1984,18,1,19,2,4,6,0,0,0,0,0,0
1998,1997,46,7,53,12,17,29,0,0,0,0,0,0
1998,2000,67,6,73,5,23,28,0,0,0,0,0,0
1998,2001,16,0,16,1,5,6,0,0,0,0,0,0
1998,2002,41,2,43,2,13,15,0,0,0,0,0,0
1998,2100,127,0,127,85,0,85,79,0,79,11,0,11
1998,2101,6,0,6,0,1,1,0,0,0,0,0,0
1998,2103,10,1,11,1,3,4,0,0,0,0,0,0
1998,2104,29,2,31,1,9,10,0,0,0,0,0,0
1998,2105,20,2,22,0,0,0,0,0,0,0,0,0
1998,2106,48,6,54,4,20,24,0,0,0,0,0,0
1998,2107,8,1,9,0,0,0,0,0,0,0,0,0
1998,2108,16,1,17,0,6,6,0,0,0,0,0,0
1998,2109,66,4,70,1,32,33,0,0,0,0,0,0
1998,2110,19,2,21,1,4,5,0,0,0,0,0,0
1998,2111,13,1,14,0,2,2,0,0,0,0,0,0
1998,2113,8,0,8,0,1,1,0,0,0,0,0,0
1998,2200,30,5,35,6,5,11,0,0,0,0,0,0
1998,2300,65,1,66,6,20,26,0,0,0,0,0,0
1998,2301,14,1,15,0,4,4,0,0,0,0,0,0
1998,2303,28,1,29,1,9,10,0,0,0,0,0,0
1998,2304,12,0,12,2,5,7,0,0,0,0,0,0
1998,2400,74,2,76,4,19,23,0,0,0,0,0,0
1998,2401,25,0,25,3,4,7,0,0,0,0,0,0
1998,2402,9,0,9,0,0,0,0,0,0,0,0,0
1998,2403,8,1,9,0,1,1,0,0,0,0,0,0
1998,2404,16,1,17,0,7,7,0,0,0,0,0,0
1998,2405,26,2,28,1,7,8,0,0,0,0,3,3
1998,2406,79,2,81,5,29,34,0,0,0,0,0,0
1998,2500,10,1,11,1,2,3,4,5,9,0,0,0
1998,2501,8,0,8,0,0,0,0,0,0,0,1,1
1998,2600,23,1,24,18,4,22,7,8,15,1,0,1
1998,2601,13,2,15,0,4,4,0,0,0,0,0,0
1998,2700,173,13,186,11,62,73,116,38,154,14,20,34
1998,2701,15,0,15,3,6,9,0,0,0,0,0,0
1998,2702,5,0,5,0,0,0,0,0,0,0,0,0
1998,2703,11,0,11,1,1,2,0,0,0,0,0,0
1998,2704,11,0,11,0,1,1,0,0,0,0,0,0
1998,2705,14,0,14,0,2,2,0,0,0,0,0,0
1998,2706,57,4,61,3,7,10,0,0,0,6,5,11
1998,2707,28,2,30,4,6,10,0,0,0,0,0,0
1998,2708,133,6,139,7,36,43,0,0,0,0,0,0
1998,2709,7,0,7,0,1,1,0,0,0,0,0,0
1998,2710,35,6,41,2,6,8,0,0,0,0,0,0
1998,2711,14,1,15,1,2,3,0,0,0,0,0,0
1998,2712,28,2,30,3,4,7,0,0,0,0,0,0
1998,2714,6,0,6,0,0,0,0,0,0,0,0,0
1998,2719,14,0,14,4,4,8,0,0,0,0,0,0
1998,2800,67,3,70,2,16,18,0,0,0,0,0,0
1998,2801,10,0,10,1,7,8,0,0,0,0,0,0
1998,2802,60,6,66,6,42,48,0,0,0,0,0,0
1998,2803,9,2,11,0,5,5,0,0,0,0,0,0
1998,2808,58,12,70,1,3,4,0,0,0,0,0,0
1998,2900,70,3,73,6,29,35,2,0,2,40,42,82
1998,2901,19,0,19,1,7,8,0,0,0,0,0,0
1998,2902,8,0,8,1,0,1,0,0,0,0,0,0
1998,3000,666,70,736,379,452,831,516,81,597,289,186,475
1998,3001,352,41,393,35,111,146,0,0,0,14,12,26
1998,3002,94,9,103,1,23,24,0,0,0,0,0,0
1998,3003,90,4,94,4,38,42,0,0,0,4,1,5
1998,3004,130,5,135,10,54,64,0,0,0,8,1,9
1998,3005,49,3,52,1,10,11,0,0,0,3,0,3
1998,3006,22,2,24,0,6,6,0,0,0,0,0,0
1998,3007,55,7,62,4,19,23,0,0,0,0,0,0
1998,3008,139,11,150,8,52,60,0,0,0,4,1,5
1998,3009,147,11,158,9,51,60,0,0,0,0,0,0
1998,3010,204,12,216,31,79,110,0,1,1,11,6,17
1998,3011,42,7,49,2,31,33,0,0,0,0,0,0
1998,3012,63,7,70,5,29,34,0,0,0,3,0,3
1998,3013,20,3,23,0,3,3,0,0,0,0,0,0
1998,3014,132,4,136,21,48,69,0,0,0,7,2,9
1998,3015,131,14,145,11,52,63,0,0,0,0,0,0
1998,3016,50,1,51,3,13,16,0,0,0,0,0,0
1998,3019,351,12,363,41,142,183,0,0,0,52,60,112
1998,3020,31,3,34,2,8,10,0,0,0,0,0,0
1998,3022,83,5,88,2,37,39,0,0,0,0,0,0
1998,3024,97,5,102,0,43,43,0,0,0,2,0,2
1998,3026,121,18,139,14,45,59,0,0,0,0,0,0
1998,3027,15,0,15,2,4,6,0,0,0,0,0,0
1998,3034,4,0,4,0,0,0,0,0,0,0,0,0
1998,3091,170,29,199,59,82,141,60,13,73,6,2,8
1998,3097,19,8,27,2,8,10,0,0,0,0,0,0
1998,3100,127,17,144,46,60,106,85,21,106,0,24,24
1998,3101,18,1,19,1,8,9,0,0,0,0,0,0
1998,3103,10,1,11,4,3,7,0,0,0,0,0,0
1998,3104,33,2,35,4,12,16,0,0,0,0,0,0
1998,3105,71,4,75,9,35,44,0,0,0,5,3,8
1998,3200,35,0,35,2,11,13,0,0,0,8,8,16
1998,3300,890,107,997,82,401,483,163,16,179,352,228,580
1998,3301,33,1,34,2,9,11,0,0,0,0,0,0
1998,3302,19,0,19,0,5,5,0,0,0,0,0,0
1998,3303,22,3,25,3,9,12,0,0,0,0,0,0
1998,3305,28,1,29,1,4,5,0,0,0,0,0,0
1998,3308,50,4,54,2,16,18,0,0,0,0,0,0
1998,3309,44,1,45,4,15,19,0,0,0,0,0,0
1998,3311,74,5,79,11,29,40,0,0,0,5,3,8
1998,3313,296,28,324,26,118,144,0,0,0,0,0,0
1998,3314,23,1,24,2,8,10,0,0,0,0,0,0
1998,3315,119,13,132,12,51,63,0,0,0,0,0,0
1998,3325,43,3,46,6,14,20,0,0,0,0,0,0
1998,3342,25,2,27,1,6,7,0,0,0,0,0,0
1998,3397,19,2,21,3,4,7,0,0,0,0,0,0
1998,3400,794,142,936,98,197,295,329,78,407,83,108,191
1998,3401,38,1,39,0,14,14,0,0,0,0,0,0
1998,3402,19,1,20,3,7,10,0,0,0,0,0,0
1998,3403,3,0,3,0,0,0,0,0,0,0,0,0
1998,3404,569,95,664,110,276,386,0,0,0,0,0,0
1998,3408,13,1,14,1,4,5,0,0,0,0,0,0
1998,3420,2,0,2,2,0,2,0,0,0,0,0,0
1998,3422,517,87,604,8,40,48,0,0,0,0,0,0
1998,3497,38,7,45,9,25,34,0,0,0,0,0,0
1998,3499,5974,563,6537,1330,1803,3133,0,0,0,0,0,0
1998,3500,20,1,21,1,5,6,0,0,0,12,11,23
1998,3501,24,1,25,1,4,5,0,0,0,0,0,0
1998,3600,842,128,970,170,432,602,252,57,309,150,279,429
1998,3601,42,1,43,1,15,16,0,0,0,0,0,0
1998,3602,75,4,79,5,25,30,0,0,0,0,0,0
1998,3603,59,2,61,4,12,16,0,0,0,0,0,0
1998,3604,110,6,116,5,45,50,0,0,0,0,0,0
1998,3605,46,5,51,1,23,24,0,0,0,0,0,0
1998,3607,210,11,221,24,82,106,0,0,0,0,0,0
1998,3608,68,6,74,14,30,44,0,0,0,0,0,0
1998,3609,89,12,101,6,34,40,0,0,0,0,0,0
1998,3610,253,23,276,32,108,140,0,0,0,6,3,9
1998,3611,80,5,85,7,32,39,0,0,0,0,0,0
1998,3613,23,1,24,1,6,7,0,0,0,0,0,0
1998,3614,12,1,13,1,4,5,0,0,0,0,0,0
1998,3623,22,3,25,16,26,42,0,0,0,0,0,0
1998,3650,6,3,9,0,6,6,0,0,0,0,0,0
1998,3700,875,161,1036,173,353,526,746,236,982,229,466,695
1998,3701,80,8,88,3,26,29,0,0,0,0,0,0
1998,3702,157,19,176,16,58,74,0,0,0,4,1,5
1998,3703,38,4,42,4,12,16,0,0,0,0,0,0
1998,3705,130,10,140,17,49,66,0,0,0,0,0,0
1998,3706,136,18,154,15,48,63,0,0,0,0,0,0
1998,3708,58,5,63,0,0,0,0,0,0,0,0,0
1998,3709,76,4,80,5,23,28,0,0,0,0,0,0
1998,3710,150,16,166,22,71,93,0,0,0,0,0,0
1998,3711,1731,290,2021,284,502,786,0,0,0,0,0,0
1998,3714,23,2,25,5,8,13,0,0,0,0,0,0
1998,3715,98,12,110,6,13,19,0,0,0,0,0,0
1998,3732,4,1,5,4,3,7,0,0,0,0,0,0
1998,3797,21,6,27,14,5,19,0,0,0,0,0,0
1998,3800,193,70,263,57,56,113,351,94,445,0,0,0
1998,3801,1860,326,2186,163,327,490,0,0,0,0,0,0
1998,3803,18,6,24,7,7,14,0,0,0,0,0,0
1998,3897,20,3,23,5,8,13,0,0,0,0,0,0
1998,3900,166,19,185,26,88,114,0,0,0,0,0,0
1998,3901,8,1,9,0,2,2,0,0,0,0,0,0
1998,3902,71,6,77,1,16,17,0,0,0,4,12,16
1998,3903,49,3,52,4,16,20,0,0,0,0,0,0
1998,3904,12,3,15,0,8,8,0,0,0,0,0,0
1998,3905,321,34,355,37,133,170,0,0,0,0,0,0
1998,3906,44,4,48,10,17,27,0,0,0,0,0,0
1998,3915,16,1,17,0,0,0,0,0,0,0,0,0
1998,4000,134,4,138,7,46,53,94,24,118,7,32,39
1998,4001,22,3,25,2,8,10,0,0,0,0,0,0
1998,4002,18,2,20,0,7,7,0,0,0,0,0,0
1998,4003,17,2,19,2,4,6,0,0,0,0,0,0
1998,4004,31,2,33,0,0,0,0,0,0,0,0,0
1998,4005,18,2,20,0,8,8,0,0,0,0,0,0
1998,4006,52,4,56,5,19,24,0,0,0,0,0,0
1998,4007,11,4,15,0,2,2,0,0,0,0,0,0
1998,4008,23,4,27,1,9,10,0,0,0,0,0,0
1998,4016,61,28,89,3,4,7,0,0,0,0,0,0
1998,4100,184,13,197,39,53,92,78,14,92,117,44,161
1998,4101,22,1,23,3,3,6,0,0,0,0,0,0
1998,4102,32,3,35,2,11,13,0,0,0,0,0,0
1998,4103,12,3,15,0,3,3,0,0,0,0,0,0
1998,4104,42,5,47,4,14,18,0,0,0,0,0,0
1998,4105,13,0,13,0,4,4,0,0,0,0,0,0
1998,4106,104,9,113,6,27,33,0,0,0,0,0,0
1998,4107,14,2,16,1,2,3,0,0,0,0,0,0
1998,4108,23,3,26,0,6,6,0,0,0,0,0,0
1998,4109,42,7,49,5,15,20,0,0,0,0,0,0
1998,4110,25,3,28,1,8,9,0,0,0,0,0,0
1998,4111,37,1,38,3,9,12,0,0,0,0,0,0
1998,4113,79,12,91,3,36,39,0,0,0,0,0,0
1998,4114,47,3,50,0,13,13,0,0,0,0,0,0
1998,4115,34,3,37,1,11,12,0,0,0,0,0,0
1998,4116,96,10,106,0,33,33,0,0,0,0,0,0
1998,4117,75,5,80,9,28,37,0,0,0,0,0,0
1998,4119,8,1,9,1,0,1,0,0,0,0,0,0
1998,4120,38,6,44,4,13,17,0,0,0,0,0,0
1998,4127,42,5,47,7,8,15,0,0,0,0,0,0
1998,4200,254,18,272,42,70,112,110,59,169,24,38,62
1998,4201,7,1,8,0,2,2,0,0,0,0,0,0
1998,4202,41,2,43,1,11,12,0,0,0,4,1,5
1998,4203,138,7,145,22,61,83,0,0,0,0,0,0
1998,4204,76,10,86,3,27,30,0,0,0,0,0,0
1998,4211,3,0,3,0,0,0,0,0,0,0,0,0
1998,4297,25,4,29,5,6,11,0,0,0,0,0,0
1998,4300,380,52,432,24,93,117,0,0,0,0,0,0
1998,4302,44,2,46,1,16,17,0,0,0,0,0,0
1998,4304,52,4,56,6,26,32,0,0,0,2,3,5
1998,4305,26,4,30,2,11,13,0,0,0,0,0,0
1998,4307,36,2,38,7,14,21,0,0,0,0,0,0
1998,4308,78,8,86,5,23,28,0,0,0,0,0,0
1998,4310,24,4,28,0,14,14,0,0,0,0,0,0
1998,4311,82,10,92,7,25,32,0,0,0,0,0,0
1998,4312,68,17,85,20,55,75,0,0,0,0,0,0
1998,4313,1227,114,1341,75,339,414,0,0,0,0,0,0
1998,4314,139,6,145,7,37,44,0,0,0,0,0,0
1998,4316,212,9,221,0,0,0,0,0,0,32,43,75
1998,4317,27,4,31,10,9,19,0,0,0,0,0,0
1998,4320,4,2,6,1,2,3,0,0,0,0,0,0
1998,4321,6,1,7,0,2,2,0,0,0,0,0,0
1998,4324,4,0,4,0,1,1,0,0,0,0,0,0
1998,4327,5,0,5,1,1,2,0,0,0,0,0,0
1998,4400,121,9,130,1,37,38,77,29,106,10,7,17
1998,4401,23,0,23,1,4,5,0,0,0,0,0,0
1998,4402,89,6,95,4,41,45,0,0,0,0,0,0
1998,4403,54,3,57,3,12,15,0,0,0,0,0,0
1998,4404,19,2,21,1,8,9,0,0,0,0,0,0
1998,4405,0,0,0,0,0,0,0,0,0,0,0,0
1998,4497,13,4,17,6,14,20,0,0,0,0,0,0
1998,4500,81,10,91,5,41,46,42,14,56,19,20,39
1998,4501,15,0,15,0,9,9,0,0,0,0,0,0
1998,4502,98,3,101,9,41,50,0,0,0,0,0,0
1998,4600,10,1,11,0,0,0,0,0,0,2,4,6
1998,4700,56,0,56,5,14,19,19,11,30,1,3,4
1998,4706,8,1,9,1,3,4,0,0,0,0,0,0
1998,4707,3,0,3,0,0,0,0,0,0,0,0,0
1998,4708,9,0,9,2,2,4,0,0,0,0,0,0
1998,4709,14,0,14,4,3,7,0,0,0,0,0,0
1998,4710,4,0,4,0,1,1,0,0,0,0,0,0
1998,4800,92,4,96,6,62,68,2,0,2,159,94,253
1998,4801,36,1,37,2,12,14,0,0,0,0,0,0
1998,4802,19,1,20,0,2,2,0,0,0,0,0,0
1998,4803,96,7,103,10,50,60,0,0,0,0,0,0
1998,4804,11,0,11,0,1,1,0,0,0,0,0,0
1998,4805,27,1,28,1,6,7,0,0,0,0,0,0
1998,4806,89,10,99,6,56,62,0,0,0,0,0,0
1998,4807,132,10,142,4,58,62,0,0,0,0,0,0
1998,4900,208,8,216,17,75,92,5,4,9,0,0,0
1998,4901,11,0,11,5,0,5,0,0,0,0,0,0
1998,4902,11,1,12,2,4,6,0,0,0,0,0,0
1998,4903,15,1,16,9,0,9,0,0,0,0,0,0
1998,4904,58,4,62,7,20,27,0,0,0,0,0,0
1998,4905,147,12,159,12,65,77,0,0,0,0,0,0
1998,4906,16,0,16,1,5,6,0,0,0,0,0,0
1998,4907,11,3,14,0,4,4,0,0,0,0,0,0
1998,4908,58,4,62,2,28,30,0,0,0,0,0,0
1998,4909,9,1,10,0,5,5,0,0,0,0,0,0
1998,4913,6,1,7,0,0,0,0,0,0,0,0,0
1998,4914,8,1,9,4,3,7,0,0,0,0,0,0
1998,5000,184,9,193,23,98,121,2,0,2,137,53,190
1998,5001,38,3,41,4,9,13,0,0,0,0,0,0
1998,5002,240,9,249,15,79,94,0,0,0,0,0,0
1998,5003,11,0,11,1,2,3,0,0,0,0,0,0
1998,5004,21,2,23,3,4,7,0,0,0,0,0,0
1998,5005,12,0,12,0,2,2,0,0,0,0,0,0
1998,5007,55,2,57,4,32,36,0,0,0,0,0,0
1998,5009,8,0,8,0,1,1,0,0,0,0,0,0
1998,5010,9,0,9,2,5,7,0,0,0,0,0,0
1998,5100,51,3,54,2,16,18,0,0,0,0,0,0
1998,5102,43,1,44,8,17,25,0,0,0,0,0,0
1998,5200,34,1,35,2,20,22,33,4,37,0,11,11
1998,5201,11,2,13,1,4,5,0,0,0,0,0,0
1998,5300,19,2,21,0,5,5,0,0,0,0,0,0
1998,5400,197,15,212,12,78,90,167,25,192,34,20,54
1998,5401,20,0,20,3,7,10,0,0,0,0,0,0
1998,5402,12,2,14,0,2,2,0,0,0,0,0,0
1998,5403,11,1,12,0,1,1,0,0,0,0,0,0
1998,5404,16,2,18,4,5,9,0,0,0,0,0,0
1998,5405,37,2,39,3,19,22,0,0,0,0,0,0
1998,5406,44,6,50,9,14,23,0,0,0,0,0,0
1998,5407,86,8,94,5,34,39,0,0,0,0,0,0
1998,5408,9,0,9,0,1,1,0,0,0,0,0,0
1998,5411,4,1,5,0,1,1,0,0,0,0,0,0
1998,5500,51,0,51,2,21,23,0,0,0,0,0,0
1998,5501,12,1,13,0,3,3,0,0,0,0,0,0
1998,5600,449,51,500,65,160,225,164,26,190,144,112,256
1998,5604,168,17,185,21,72,93,0,0,0,6,3,9
1998,5605,19,1,20,0,8,8,0,0,0,0,0,0
1998,5606,28,1,29,1,9,10,0,0,0,0,0,0
1998,5608,116,8,124,8,63,71,0,0,0,0,0,0
1998,5609,109,5,114,11,50,61,0,0,0,0,0,0
1998,5700,51,5,56,11,20,31,13,4,17,50,49,99
1998,5701,49,4,53,2,22,24,0,0,0,0,0,0
1998,5702,10,0,10,0,0,0,0,0,0,0,0,0
1998,5703,50,4,54,5,14,19,0,0,0,0,0,0
1998,5704,53,4,57,9,21,30,0,0,0,0,0,0
1998,5800,53,7,60,7,21,28,0,0,0,0,0,0
1998,5801,27,0,27,14,0,14,0,0,0,0,0,0
1998,5802,5,0,5,0,0,0,0,0,0,0,0,0
1998,190C,17,2,19,1,4,5,0,0,0,0,0,0
1998,190P,22,2,24,0,1,1,0,0,0,0,0,0
1998,190R,8,1,9,5,5,10,0,0,0,0,0,0
1998,191E,0,0,0,0,0,0,0,0,0,0,0,0
1998,192Q,8,1,9,9,5,14,0,0,0,0,0,0
1998,192R,5,1,6,6,3,9,0,0,0,0,0,0
1999,100,391,46,437,106,179,285,323,61,384,133,163,296
1999,101,101,7,108,6,29,35,0,0,0,0,2,2
1999,102,26,1,27,0,5,5,0,0,0,0,0,0
1999,103,162,30,192,20,78,98,1,0,1,8,7,15
1999,104,34,2,36,0,14,14,0,0,0,0,0,0
1999,105,181,19,200,14,76,90,1,0,1,8,8,16
1999,106,163,20,183,27,67,94,0,0,0,12,6,18
1999,107,72,8,80,4,43,47,0,0,0,0,0,0
1999,108,48,4,52,6,13,19,0,0,0,0,0,0
1999,109,659,73,732,62,225,287,5,0,5,64,22,86
1999,110,17,2,19,2,5,7,0,0,0,0,0,0
1999,111,73,7,80,5,26,31,0,0,0,0,0,0
1999,112,88,6,94,9,27,36,0,0,0,6,6,12
1999,113,63,10,73,2,20,22,0,0,0,0,0,0
1999,114,45,6,51,2,23,25,0,0,0,0,0,0
1999,115,11,0,11,12,8,20,0,0,0,0,0,0
1999,121,159,16,175,35,38,73,0,0,0,0,0,0
1999,122,2,0,2,2,4,6,0,0,0,0,0,0
1999,197,58,10,68,23,18,41,0,0,0,0,0,0
1999,200,10,0,10,0,3,3,0,0,0,0,0,0
1999,300,40,1,41,0,22,22,1,0,1,11,9,20
1999,302,5,0,5,0,1,1,0,0,0,0,0,0
1999,303,9,0,9,0,2,2,0,0,0,0,0,0
1999,305,6,0,6,0,1,1,0,0,0,0,0,0
1999,400,93,3,96,4,33,37,1,0,1,52,39,91
1999,402,65,8,73,3,39,42,0,0,0,0,0,0
1999,403,11,1,12,0,6,6,0,0,0,0,0,0
1999,404,19,0,19,0,7,7,0,0,0,0,0,0
1999,405,22,1,23,0,11,11,0,0,0,0,0,0
1999,497,8,2,10,1,3,4,0,0,0,0,0,0
1999,500,42,1,43,2,15,17,1,0,1,9,9,18
1999,501,7,0,7,0,0,0,1,0,1,0,0,0
1999,600,35,0,35,1,15,16,8,4,12,0,2,2
1999,601,8,1,9,0,1,1,0,0,0,0,0,0
1999,602,7,0,7,0,1,1,0,0,0,0,0,0
1999,700,361,43,404,55,134,189,202,32,234,46,53,99
1999,701,94,8,102,5,28,33,0,0,0,1,0,1
1999,702,26,1,27,1,8,9,0,0,0,0,0,0
1999,703,9,1,10,0,2,2,0,0,0,0,0,0
1999,704,131,26,157,11,42,53,0,0,0,5,0,5
1999,705,30,2,32,0,5,5,0,0,0,0,0,0
1999,706,18,3,21,1,3,4,0,0,0,0,0,0
1999,707,21,0,21,2,11,13,0,0,0,0,0,0
1999,708,70,0,70,2,17,19,0,0,0,0,0,0
1999,709,41,2,43,3,17,20,0,0,0,0,0,0
1999,710,170,16,186,15,54,69,0,0,0,3,7,10
1999,711,43,1,44,3,7,10,0,0,0,0,0,0
1999,712,73,6,79,5,21,26,0,0,0,0,0,0
1999,713,10,0,10,0,0,0,0,0,0,0,0,0
1999,716,11,1,12,0,1,1,0,0,0,0,0,0
1999,721,16,4,20,3,8,11,0,0,0,0,0,0
1999,800,24,4,28,1,7,8,6,0,6,11,10,21
1999,801,12,0,12,0,1,1,0,0,0,0,0,0
1999,900,97,6,103,11,109,120,23,1,24,55,52,107
1999,901,18,0,18,1,5,6,0,0,0,0,0,0
1999,902,44,5,49,5,14,19,0,0,0,0,0,0
1999,1000,355,31,386,37,113,150,0,0,0,0,0,0
1999,1001,73,7,80,9,37,46,0,0,0,0,0,0
1999,1002,16,0,16,1,6,7,0,0,0,0,0,0
1999,1003,8,1,9,0,5,5,0,0,0,0,0,0
1999,1004,4,0,4,0,1,1,0,0,0,0,0,0
1999,1005,616,76,692,81,242,323,0,0,0,0,0,0
1999,1006,8,0,8,2,3,5,0,0,0,0,0,0
1999,1007,16,0,16,0,2,2,0,0,0,0,0,0
1999,1008,14,1,15,1,4,5,0,0,0,0,0,0
1999,1011,14,0,14,1,0,1,0,0,0,0,0,0
1999,1012,21,2,23,2,12,14,0,0,0,0,0,0
1999,1013,18,2,20,3,4,7,0,0,0,0,0,0
1999,1015,28,1,29,1,15,16,0,0,0,0,0,0
1999,1031,13,0,13,0,1,1,0,0,0,0,0,0
1999,1097,14,5,19,1,8,9,0,0,0,0,0,0
1999,1100,25,1,26,2,11,13,2,0,2,9,9,18
1999,1101,8,0,8,0,2,2,0,0,0,0,0,0
1999,1102,7,0,7,0,1,1,0,0,0,0,0,0
1999,1200,69,7,76,10,34,44,1,0,1,64,25,89
1999,1201,21,1,22,2,7,9,0,0,0,0,0,0
1999,1202,4,0,4,0,0,0,0,0,0,0,0,0
1999,1203,46,4,50,3,28,31,0,0,0,0,0,0
1999,1204,3,0,3,0,0,0,0,0,0,0,0,0
1999,1205,15,0,15,0,5,5,0,0,0,0,0,0
1999,1206,1,1,2,0,0,0,0,0,0,0,0,0
1999,1207,4,1,5,0,0,0,0,0,0,0,0,0
1999,1208,12,0,12,2,6,8,0,0,0,0,0,0
1999,1300,83,5,88,6,35,41,3,0,3,66,39,105
1999,1301,28,2,30,1,10,11,0,0,0,0,0,0
1999,1302,39,2,41,6,9,15,0,0,0,0,0,0
1999,1303,3,0,3,0,1,1,0,0,0,0,0,0
1999,1304,47,4,51,6,15,21,0,0,0,0,0,0
1999,1305,8,0,8,0,3,3,0,0,0,0,0,0
1999,1306,11,1,12,2,1,3,0,0,0,0,0,0
1999,1307,5,0,5,0,0,0,0,0,0,0,0,0
1999,1400,26,1,27,1,5,6,12,1,13,9,17,26
1999,1401,14,0,14,0,7,7,0,0,0,0,0,0
1999,1500,309,21,330,28,121,149,110,18,128,224,185,409
1999,1501,12,0,12,7,0,7,0,0,0,0,0,0
1999,1502,284,15,299,8,100,108,0,0,0,0,0,0
1999,1503,39,1,40,0,14,14,4,0,4,0,0,0
1999,1506,28,2,30,0,9,9,0,0,0,0,0,0
1999,1507,16,1,17,1,5,6,0,0,0,0,0,0
1999,1508,9,0,9,0,7,7,0,0,0,0,0,0
1999,1511,12,1,13,0,6,6,0,0,0,0,0,0
1999,1514,4,0,4,0,0,0,0,0,0,0,0,0
1999,1515,7,0,7,2,2,4,0,0,0,0,0,0
1999,1597,9,0,9,2,1,3,0,0,0,0,0,0
1999,1600,73,3,76,10,37,47,1,0,1,36,29,65
1999,1601,15,0,15,1,5,6,0,0,0,0,0,0
1999,1602,42,3,45,0,14,14,0,0,0,0,0,0
1999,1603,22,4,26,1,5,6,0,0,0,0,0,0
1999,1606,16,2,18,37,5,42,0,0,0,0,0,0
1999,1700,63,2,65,0,24,24,0,0,0,0,0,0
1999,1701,14,0,14,2,2,4,0,0,0,0,0,0
1999,1702,21,0,21,2,6,8,0,0,0,0,0,0
1999,1800,33,0,33,2,6,8,2,1,3,27,26,53
1999,1801,15,3,18,0,4,4,0,0,0,0,0,0
1999,1900,5646,913,6559,1236,2015,3251,0,0,0,0,0,0
1999,1901,78,9,87,9,32,41,0,0,0,8,3,11
1999,1902,64,9,73,5,12,17,0,0,0,1,3,4
1999,1905,56,3,59,1,22,23,0,0,0,5,3,8
1999,1906,60,3,63,1,19,20,0,0,0,0,0,0
1999,1907,31,0,31,0,9,9,0,0,0,0,0,0
1999,1909,43,4,47,4,15,19,0,0,0,0,0,0
1999,1910,127,7,134,16,34,50,0,0,0,3,6,9
1999,1912,155,9,164,22,56,78,0,0,0,9,2,11
1999,1913,40,2,42,0,14,14,0,0,0,4,0,4
1999,1915,124,9,133,8,43,51,0,0,0,4,1,5
1999,1916,51,2,53,3,22,25,0,0,0,3,1,4
1999,1918,116,6,122,9,26,35,0,0,0,4,1,5
1999,1920,106,7,113,7,40,47,0,0,0,0,0,0
1999,1922,130,10,140,11,23,34,0,0,0,5,2,7
1999,1923,61,6,67,5,12,17,0,0,0,5,1,6
1999,1924,62,9,71,0,11,11,0,0,0,2,5,7
1999,1925,204,24,228,20,77,97,1,0,1,8,6,14
1999,1926,50,5,55,2,11,13,0,0,0,2,7,9
1999,1928,77,6,83,6,36,42,0,0,0,5,3,8
1999,1929,32,2,34,2,10,12,0,0,0,2,3,5
1999,1931,67,4,71,9,16,25,0,0,0,4,1,5
1999,1933,159,17,176,18,58,76,0,0,0,3,6,9
1999,1934,21,0,21,0,6,6,0,0,0,0,0,0
1999,1938,41,3,44,3,13,16,0,0,0,0,0,0
1999,1941,742,87,829,150,233,383,11,3,14,41,24,65
1999,1942,7760,1744,9504,813,1886,2699,19,2,21,219,114,333
1999,1944,55,4,59,10,13,23,0,0,0,5,1,6
1999,1945,27,0,27,0,6,6,0,0,0,4,0,4
1999,1946,55,4,59,2,15,17,0,0,0,2,1,3
1999,1947,76,11,87,9,23,32,0,0,0,0,0,0
1999,1948,68,10,78,4,30,34,0,0,0,4,1,5
1999,1951,20,3,23,0,2,2,0,0,0,2,7,9
1999,1953,196,34,230,26,64,90,0,0,0,9,6,15
1999,1955,160,5,165,20,80,100,1,0,1,11,8,19
1999,1956,99,7,106,3,33,36,0,0,0,1,6,7
1999,1961,34,1,35,11,14,25,0,0,0,0,0,0
1999,1962,47,6,53,3,10,13,0,0,0,0,0,0
1999,1963,0,0,0,0,0,0,0,0,0,0,0,0
1999,1965,173,26,199,62,83,145,0,0,0,7,6,13
1999,1966,15,1,16,2,3,5,0,0,0,0,0,0
1999,1967,25,5,30,6,10,16,0,0,0,0,0,0
1999,1969,86,3,89,14,37,51,0,0,0,4,1,5
1999,1970,33,1,34,6,7,13,0,0,0,0,0,0
1999,1972,236,8,244,8,52,60,0,0,0,12,10,22
1999,1973,52,2,54,4,14,18,0,0,0,6,0,6
1999,1975,112,6,118,8,28,36,0,0,0,4,3,7
1999,1976,121,9,130,20,42,62,0,0,0,0,0,0
1999,1978,10,2,12,2,7,9,0,0,0,0,0,0
1999,1981,11,2,13,2,2,4,0,0,0,0,0,0
1999,1982,13,5,18,4,2,6,0,0,0,0,0,0
1999,1983,13,2,15,1,5,6,0,0,0,0,0,0
1999,1984,16,1,17,2,2,4,0,0,0,0,0,0
1999,1997,44,7,51,10,19,29,0,0,0,0,0,0
1999,2000,67,7,74,3,26,29,0,0,0,0,0,0
1999,2001,16,0,16,1,5,6,0,0,0,0,0,0
1999,2002,45,2,47,3,13,16,0,0,0,0,0,0
1999,2100,105,18,123,20,52,72,61,13,74,11,9,20
1999,2101,6,0,6,0,0,0,0,0,0,0,0,0
1999,2103,10,1,11,0,4,4,0,0,0,0,0,0
1999,2104,29,2,31,1,10,11,0,0,0,0,0,0
1999,2105,20,1,21,2,2,4,0,0,0,0,0,0
1999,2106,56,5,61,3,16,19,0,0,0,0,0,0
1999,2107,7,1,8,0,0,0,0,0,0,0,0,0
1999,2108,17,1,18,0,6,6,0,0,0,0,0,0
1999,2109,68,4,72,4,32,36,0,0,0,0,0,0
1999,2110,19,2,21,1,4,5,0,0,0,0,0,0
1999,2111,13,1,14,0,2,2,0,0,0,0,0,0
1999,2113,8,0,8,0,0,0,0,0,0,0,0,0
1999,2200,31,5,36,4,6,10,8,8,16,0,0,0
1999,2300,60,1,61,6,21,27,0,0,0,0,0,0
1999,2301,14,1,15,0,4,4,0,0,0,0,0,0
1999,2303,27,1,28,2,9,11,0,0,0,0,0,0
1999,2304,11,0,11,3,4,7,0,0,0,0,0,0
1999,2400,74,2,76,5,17,22,0,0,0,0,0,0
1999,2401,29,0,29,3,5,8,0,0,0,0,0,0
1999,2402,8,0,8,0,0,0,0,0,0,0,0,0
1999,2403,7,1,8,0,1,1,0,0,0,0,0,0
1999,2404,18,1,19,0,6,6,0,0,0,0,0,0
1999,2405,28,2,30,2,10,12,0,0,0,0,0,0
1999,2406,79,1,80,10,24,34,0,0,0,0,0,0
1999,2500,9,1,10,1,2,3,4,5,9,0,0,0
1999,2501,8,0,8,0,1,1,0,0,0,0,0,0
1999,2600,24,1,25,8,8,16,6,7,13,0,0,0
1999,2601,14,2,16,1,3,4,0,0,0,0,0,0
1999,2700,164,7,171,11,59,70,118,39,157,12,23,35
1999,2701,15,0,15,3,6,9,0,0,0,0,0,0
1999,2702,5,0,5,0,0,0,0,0,0,0,0,0
1999,2703,11,0,11,1,1,2,0,0,0,0,0,0
1999,2704,13,1,14,0,2,2,0,0,0,0,0,0
1999,2705,15,1,16,0,2,2,0,0,0,0,0,0
1999,2706,55,4,59,1,8,9,0,0,0,6,6,12
1999,2707,27,3,30,4,6,10,0,0,0,0,0,0
1999,2708,138,7,145,13,35,48,0,0,0,0,0,0
1999,2709,6,0,6,0,1,1,0,0,0,0,0,0
1999,2710,32,5,37,2,8,10,0,0,0,0,0,0
1999,2711,14,1,15,0,3,3,0,0,0,0,0,0
1999,2712,28,2,30,3,4,7,0,0,0,0,0,0
1999,2714,6,0,6,0,0,0,0,0,0,0,0,0
1999,2719,13,1,14,4,1,5,0,0,0,0,0,0
1999,2800,75,3,78,8,17,25,0,0,0,0,0,0
1999,2801,11,0,11,1,3,4,0,0,0,0,0,0
1999,2802,65,6,71,7,42,49,0,0,0,0,0,0
1999,2803,11,1,12,0,4,4,0,0,0,0,0,0
1999,2808,77,16,93,2,5,7,0,0,0,0,0,0
1999,2900,69,4,73,9,30,39,3,0,3,31,27,58
1999,2901,20,0,20,1,7,8,0,0,0,0,0,0
1999,2902,9,0,9,0,1,1,0,0,0,0,0,0
1999,3000,690,72,762,463,492,955,564,86,650,323,231,554
1999,3001,359,34,393,15,139,154,0,0,0,28,5,33
1999,3002,92,10,102,1,22,23,0,0,0,0,0,0
1999,3003,89,5,94,9,40,49,0,0,0,4,1,5
1999,3004,134,10,144,13,51,64,1,0,1,8,1,9
1999,3005,50,3,53,1,11,12,0,0,0,4,1,5
1999,3006,23,2,25,1,7,8,0,0,0,0,0,0
1999,3007,55,8,63,3,27,30,0,0,0,0,0,0
1999,3008,139,13,152,10,56,66,0,0,0,4,1,5
1999,3009,143,10,153,16,42,58,0,0,0,0,0,0
1999,3010,214,12,226,30,88,118,0,0,0,11,7,18
1999,3011,40,9,49,3,30,33,0,0,0,0,0,0
1999,3012,66,6,72,7,30,37,0,0,0,3,0,3
1999,3013,18,3,21,0,3,3,0,0,0,0,0,0
1999,3014,135,5,140,19,48,67,0,0,0,7,2,9
1999,3015,129,16,145,15,55,70,0,0,0,0,0,0
1999,3016,52,2,54,3,13,16,0,0,0,0,0,0
1999,3019,347,12,359,35,138,173,0,0,0,56,60,116
1999,3020,32,3,35,1,9,10,0,0,0,0,0,0
1999,3022,82,8,90,7,34,41,0,0,0,0,0,0
1999,3024,94,6,100,5,36,41,0,0,0,0,0,0
1999,3026,124,21,145,10,51,61,0,0,0,3,1,4
1999,3027,16,2,18,1,6,7,0,0,0,0,0,0
1999,3034,6,0,6,0,0,0,0,0,0,0,0,0
1999,3091,309,51,360,16,64,80,0,0,0,0,0,0
1999,3097,18,5,23,2,4,6,0,0,0,0,0,0
1999,3100,136,16,152,11,71,82,38,4,42,41,40,81
1999,3101,18,1,19,2,10,12,0,0,0,0,0,0
1999,3103,12,1,13,6,2,8,0,0,0,0,0,0
1999,3104,31,1,32,4,12,16,0,0,0,0,0,0
1999,3105,69,4,73,10,34,44,0,0,0,5,3,8
1999,3200,35,0,35,0,12,12,0,0,0,10,8,18
1999,3300,971,101,1072,106,429,535,172,20,192,383,234,617
1999,3301,30,0,30,2,10,12,0,0,0,0,0,0
1999,3302,20,0,20,0,6,6,0,0,0,0,0,0
1999,3303,21,2,23,3,8,11,0,0,0,0,0,0
1999,3306,15,2,17,1,3,4,0,0,0,0,0,0
1999,3308,53,4,57,3,16,19,0,0,0,0,0,0
1999,3309,42,3,45,6,13,19,0,0,0,0,0,0
1999,3311,74,5,79,14,19,33,0,0,0,0,0,0
1999,3313,289,28,317,24,128,152,0,0,0,0,0,0
1999,3314,23,1,24,3,7,10,0,0,0,0,0,0
1999,3315,119,13,132,11,52,63,0,0,0,0,0,0
1999,3325,41,4,45,7,17,24,0,0,0,0,0,0
1999,3342,30,2,32,0,10,10,0,0,0,0,0,0
1999,3397,16,3,19,3,5,8,0,0,0,0,0,0
1999,3400,799,158,957,97,202,299,329,81,410,88,114,202
1999,3401,44,2,46,0,15,15,0,0,0,0,0,0
1999,3402,20,0,20,2,10,12,0,0,0,0,0,0
1999,3403,3,0,3,0,0,0,0,0,0,0,0,0
1999,3404,564,90,654,105,266,371,0,0,0,0,0,0
1999,3408,13,1,14,1,4,5,0,0,0,0,0,0
1999,3420,4,0,4,0,1,1,0,0,0,0,0,0
1999,3422,498,121,619,5,37,42,0,0,0,0,0,0
1999,3497,35,8,43,12,25,37,0,0,0,0,0,0
1999,3499,6047,565,6612,1288,1829,3117,0,0,0,0,0,0
1999,3500,20,2,22,0,5,5,0,0,0,12,9,21
1999,3501,28,2,30,2,5,7,0,0,0,0,0,0
1999,3600,985,131,1116,196,508,704,262,65,327,141,286,427
1999,3601,43,1,44,1,16,17,0,0,0,0,0,0
1999,3602,75,4,79,5,26,31,0,0,0,0,0,0
1999,3603,59,4,63,4,15,19,0,0,0,0,0,0
1999,3604,125,6,131,4,52,56,0,0,0,0,0,0
1999,3605,47,4,51,1,23,24,0,0,0,0,0,0
1999,3607,211,10,221,22,81,103,0,0,0,0,0,0
1999,3608,70,7,77,9,24,33,0,0,0,0,0,0
1999,3609,94,14,108,4,42,46,0,0,0,0,0,0
1999,3610,254,23,277,34,107,141,0,0,0,0,0,0
1999,3611,79,4,83,7,32,39,0,0,0,0,0,0
1999,3613,24,1,25,0,0,0,0,0,0,0,0,0
1999,3614,13,1,14,1,6,7,0,0,0,0,0,0
1999,3623,23,3,26,21,23,44,0,0,0,0,0,0
1999,3650,9,4,13,0,5,5,0,0,0,0,0,0
1999,3700,853,129,982,171,417,588,885,229,1114,303,451,754
1999,3701,86,9,95,6,29,35,0,0,0,0,0,0
1999,3702,166,20,186,10,74,84,0,0,0,2,1,3
1999,3703,36,4,40,4,13,17,0,0,0,0,0,0
1999,3705,130,12,142,20,51,71,0,0,0,0,0,0
1999,3706,125,17,142,16,41,57,0,0,0,0,0,0
1999,3708,58,5,63,4,17,21,0,0,0,0,0,0
1999,3709,78,2,80,5,24,29,0,0,0,0,0,0
1999,3710,150,18,168,49,44,93,0,0,0,0,0,0
1999,3711,1770,304,2074,249,432,681,0,0,0,0,0,0
1999,3714,21,2,23,4,9,13,0,0,0,0,0,0
1999,3715,98,13,111,8,14,22,0,0,0,0,0,0
1999,3732,8,0,8,4,3,7,0,0,0,0,0,0
1999,3797,21,6,27,11,4,15,0,0,0,0,0,0
1999,3800,189,70,259,29,67,96,396,147,543,26,16,42
1999,3801,1867,338,2205,142,215,357,0,0,0,0,0,0
1999,3803,16,6,22,2,5,7,0,0,0,0,0,0
1999,3897,21,3,24,5,8,13,0,0,0,0,0,0
1999,3900,172,21,193,26,88,114,0,0,0,0,0,0
1999,3901,8,1,9,0,2,2,0,0,0,0,0,0
1999,3902,71,6,77,1,16,17,0,0,0,3,13,16
1999,3903,48,4,52,3,18,21,0,0,0,0,0,0
1999,3904,13,2,15,0,8,8,0,0,0,0,0,0
1999,3905,336,35,371,42,135,177,0,0,0,0,0,0
1999,3906,49,4,53,9,19,28,0,0,0,0,0,0
1999,3915,16,1,17,0,5,5,0,0,0,0,0,0
1999,4000,141,6,147,7,48,55,102,19,121,6,33,39
1999,4001,23,2,25,2,8,10,0,0,0,0,0,0
1999,4002,15,3,18,0,6,6,0,0,0,0,0,0
1999,4003,17,2,19,2,4,6,0,0,0,0,0,0
1999,4004,33,3,36,1,9,10,0,0,0,0,0,0
1999,4005,19,2,21,0,10,10,0,0,0,0,0,0
1999,4006,54,4,58,5,21,26,0,0,0,0,0,0
1999,4007,11,4,15,3,3,6,0,0,0,0,0,0
1999,4008,24,5,29,1,7,8,0,0,0,0,0,0
1999,4016,61,28,89,3,4,7,0,0,0,0,0,0
1999,4100,193,19,212,37,54,91,153,49,202,12,27,39
1999,4101,22,2,24,2,3,5,0,0,0,0,0,0
1999,4102,30,1,31,3,9,12,0,0,0,0,0,0
1999,4103,12,3,15,0,1,1,0,0,0,0,0,0
1999,4104,41,5,46,3,14,17,0,0,0,0,0,0
1999,4105,13,0,13,0,5,5,0,0,0,0,0,0
1999,4106,100,10,110,7,24,31,0,0,0,0,0,0
1999,4107,15,2,17,1,2,3,0,0,0,0,0,0
1999,4108,24,3,27,0,7,7,0,0,0,0,0,0
1999,4109,43,9,52,6,14,20,0,0,0,0,0,0
1999,4110,26,3,29,2,8,10,0,0,0,0,0,0
1999,4111,39,1,40,4,9,13,0,0,0,0,0,0
1999,4113,76,13,89,3,35,38,0,0,0,0,0,0
1999,4114,47,3,50,1,13,14,0,0,0,0,0,0
1999,4115,33,2,35,1,11,12,0,0,0,0,0,0
1999,4116,100,10,110,6,37,43,0,0,0,0,0,0
1999,4119,7,1,8,1,0,1,0,0,0,0,0,0
1999,4120,38,6,44,4,12,16,0,0,0,0,0,0
1999,4127,44,3,47,5,7,12,0,0,0,0,0,0
1999,4200,268,13,281,49,92,141,4,1,5,160,81,241
1999,4201,7,2,9,0,2,2,0,0,0,0,0,0
1999,4202,43,2,45,1,13,14,0,0,0,4,1,5
1999,4203,134,10,144,15,61,76,0,0,0,0,0,0
1999,4204,79,9,88,2,32,34,0,0,0,0,0,0
1999,4211,3,0,3,0,1,1,0,0,0,0,0,0
1999,4297,20,4,24,5,7,12,0,0,0,0,0,0
1999,4300,363,55,418,28,101,129,63,10,73,0,2,2
1999,4302,43,3,46,1,16,17,0,0,0,0,0,0
1999,4304,52,5,57,9,33,42,0,0,0,0,0,0
1999,4305,29,4,33,3,11,14,0,0,0,0,0,0
1999,4307,40,2,42,4,15,19,0,0,0,0,0,0
1999,4308,76,8,84,5,20,25,0,0,0,0,0,0
1999,4310,23,3,26,0,14,14,0,0,0,0,0,0
1999,4311,84,11,95,7,26,33,0,0,0,0,0,0
1999,4312,72,20,92,23,49,72,0,0,0,0,0,0
1999,4313,1280,113,1393,68,341,409,0,0,0,0,0,0
1999,4314,140,5,145,7,39,46,0,0,0,0,0,0
1999,4316,218,9,227,38,53,91,0,0,0,0,0,0
1999,4317,28,3,31,14,12,26,0,0,0,0,0,0
1999,4320,2,1,3,1,2,3,0,0,0,0,0,0
1999,4321,0,0,0,0,0,0,7,2,9,1,2,3
1999,4324,4,0,4,0,1,1,0,0,0,0,0,0
1999,4327,9,0,9,0,1,1,0,0,0,0,0,0
1999,4400,148,9,157,5,43,48,4,0,4,88,43,131
1999,4401,23,0,23,2,5,7,0,0,0,0,0,0
1999,4403,59,3,62,2,11,13,0,0,0,0,0,0
1999,4404,20,2,22,0,8,8,0,0,0,0,0,0
1999,4497,13,4,17,18,16,34,0,0,0,0,0,0
1999,4500,87,11,98,10,39,49,48,12,60,25,19,44
1999,4501,15,0,15,1,9,10,0,0,0,0,0,0
1999,4502,101,5,106,19,47,66,0,0,0,0,0,0
1999,4600,10,1,11,0,0,0,0,0,0,1,3,4
1999,4700,53,1,54,4,15,19,2,0,2,24,15,39
1999,4706,9,0,9,2,5,7,0,0,0,0,0,0
1999,4707,2,0,2,0,0,0,0,0,0,0,0,0
1999,4708,9,0,9,2,2,4,0,0,0,0,0,0
1999,4709,14,0,14,4,3,7,0,0,0,0,0,0
1999,4710,5,1,6,0,0,0,0,0,0,0,0,0
1999,4800,91,3,94,12,51,63,2,0,2,175,102,277
1999,4801,34,1,35,1,12,13,0,0,0,0,0,0
1999,4802,20,1,21,0,3,3,0,0,0,0,0,0
1999,4803,95,5,100,4,63,67,0,0,0,0,0,0
1999,4804,10,0,10,0,1,1,0,0,0,0,0,0
1999,4805,27,1,28,1,9,10,0,0,0,0,0,0
1999,4806,87,10,97,8,49,57,0,0,0,0,0,0
1999,4807,133,10,143,8,53,61,0,0,0,0,0,0
1999,4901,10,1,11,2,3,5,0,0,0,0,0,0
1999,4902,11,1,12,1,5,6,0,0,0,0,0,0
1999,4903,15,1,16,1,8,9,0,0,0,0,0,0
1999,4904,58,4,62,5,25,30,0,0,0,0,0,0
1999,4905,152,12,164,11,68,79,0,0,0,0,0,0
1999,4906,16,0,16,1,4,5,0,0,0,0,0,0
1999,4907,12,3,15,1,5,6,0,0,0,0,0,0
1999,4908,60,8,68,1,30,31,0,0,0,0,0,0
1999,4909,9,2,11,0,5,5,0,0,0,0,0,0
1999,4913,4,1,5,0,0,0,0,0,0,0,0,0
1999,4914,9,1,10,3,4,7,0,0,0,0,0,0
1999,5000,189,11,200,27,104,131,2,0,2,132,61,193
1999,5001,37,4,41,3,11,14,0,0,0,0,0,0
1999,5002,227,9,236,17,77,94,0,0,0,0,0,0
1999,5003,11,0,11,0,1,1,0,0,0,0,0,0
1999,5004,22,1,23,3,4,7,0,0,0,0,0,0
1999,5005,12,0,12,0,2,2,0,0,0,0,0,0
1999,5007,57,2,59,2,23,25,0,0,0,0,0,0
1999,5009,8,0,8,0,1,1,0,0,0,0,0,0
1999,5010,8,1,9,2,5,7,0,0,0,0,0,0
1999,5100,49,3,52,4,18,22,0,0,0,0,0,0
1999,5102,42,2,44,9,17,26,0,0,0,0,0,0
1999,5201,11,3,14,1,5,6,0,0,0,0,0,0
1999,5202,23,0,23,2,10,12,0,0,0,0,0,0
1999,5300,21,2,23,0,5,5,0,0,0,0,0,0
1999,5400,204,18,222,12,77,89,186,16,202,78,46,124
1999,5401,20,0,20,1,5,6,0,0,0,0,0,0
1999,5402,12,2,14,0,2,2,0,0,0,0,0,0
1999,5403,11,1,12,0,1,1,0,0,0,0,0,0
1999,5404,11,2,13,4,5,9,0,0,0,0,0,0
1999,5405,42,4,46,3,20,23,0,0,0,0,0,0
1999,5406,43,5,48,8,16,24,0,0,0,0,0,0
1999,5407,92,8,100,8,32,40,0,0,0,0,0,0
1999,5408,11,1,12,0,2,2,0,0,0,0,0,0
1999,5411,4,2,6,0,1,1,0,0,0,0,0,0
1999,5500,59,0,59,1,22,23,0,0,0,0,0,0
1999,5600,519,63,582,104,190,294,173,31,204,148,100,248
1999,5604,183,16,199,19,58,77,0,0,0,6,3,9
1999,5605,20,2,22,0,8,8,0,0,0,0,0,0
1999,5606,27,2,29,1,9,10,0,0,0,0,0,0
1999,5608,118,9,127,10,56,66,0,0,0,0,0,0
1999,5700,47,6,53,11,20,31,19,3,22,53,48,101
1999,5701,49,4,53,2,22,24,0,0,0,0,0,0
1999,5702,9,0,9,0,1,1,0,0,0,0,0,0
1999,5703,49,5,54,3,10,13,0,0,0,0,0,0
1999,5800,41,10,51,7,20,27,32,9,41,6,3,9
1999,5801,25,0,25,2,12,14,0,0,0,0,0,0
1999,5802,4,0,4,0,0,0,0,0,0,0,0,0
1999,190C,16,3,19,1,4,5,0,0,0,0,0,0
1999,190P,20,1,21,0,3,3,0,0,0,0,0,0
1999,190R,8,1,9,4,3,7,0,0,0,0,0,0
1999,191E,5,2,7,0,0,0,0,0,0,0,0,0
1999,192Q,10,1,11,0,1,1,0,0,0,0,0,0
1999,192R,5,1,6,6,5,11,0,0,0,0,0,0
2000,100,392,50,442,91,176,267,371,60,431,141,178,319
2000,101,102,6,108,6,31,37,0,0,0,0,4,4
2000,102,27,1,28,0,4,4,0,0,0,0,0,0
2000,103,166,30,196,23,68,91,1,0,1,6,7,13
2000,104,35,2,37,1,18,19,0,0,0,0,0,0
2000,105,188,21,209,15,74,89,0,0,0,8,8,16
2000,106,174,19,193,39,54,93,0,0,0,11,7,18
2000,107,76,9,85,7,36,43,0,0,0,0,0,0
2000,108,48,3,51,8,18,26,0,0,0,0,0,0
2000,109,657,77,734,67,241,308,3,0,3,62,24,86
2000,110,18,2,20,3,5,8,0,0,0,0,0,0
2000,111,73,7,80,5,28,33,0,0,0,0,0,0
2000,112,85,6,91,8,28,36,4,3,7,0,0,0
2000,113,65,10,75,2,29,31,0,0,0,0,0,0
2000,114,45,6,51,5,17,22,0,0,0,0,0,0
2000,115,12,0,12,10,7,17,0,0,0,0,0,0
2000,122,2,0,2,2,3,5,0,0,0,0,0,0
2000,130,35,5,40,0,7,7,0,0,0,0,0,0
2000,197,59,13,72,25,18,43,0,0,0,0,0,0
2000,200,11,0,11,0,3,3,0,0,0,0,0,0
2000,300,43,0,43,0,23,23,1,0,1,13,14,27
2000,302,6,0,6,0,1,1,0,0,0,0,0,0
2000,303,9,1,10,0,3,3,0,0,0,0,0,0
2000,305,6,0,6,0,1,1,0,0,0,0,0,0
2000,400,93,3,96,5,33,38,1,0,1,49,40,89
2000,402,65,9,74,5,39,44,0,0,0,0,0,0
2000,403,11,1,12,0,5,5,0,0,0,0,0,0
2000,404,21,1,22,0,0,0,0,0,0,0,0,0
2000,405,25,1,26,0,9,9,0,0,0,0,0,0
2000,497,9,2,11,0,4,4,0,0,0,0,0,0
2000,500,48,3,51,1,17,18,1,0,1,9,9,18
2000,501,7,0,7,0,1,1,0,0,0,0,0,0
2000,600,34,0,34,1,15,16,2,0,2,8,7,15
2000,601,8,1,9,0,1,1,0,0,0,0,0,0
2000,602,7,0,7,0,1,1,0,0,0,0,0,0
2000,700,380,49,429,60,148,208,209,49,258,50,60,110
2000,701,87,8,95,3,34,37,0,0,0,0,0,0
2000,702,25,4,29,3,7,10,0,0,0,0,0,0
2000,703,10,0,10,0,2,2,0,0,0,0,0,0
2000,704,131,26,157,11,41,52,0,0,0,5,0,5
2000,705,26,2,28,0,7,7,0,0,0,0,0,0
2000,706,18,3,21,1,1,2,0,0,0,0,0,0
2000,707,22,0,22,1,10,11,0,0,0,0,0,0
2000,708,70,1,71,2,18,20,0,0,0,0,0,0
2000,709,41,2,43,3,17,20,0,0,0,0,0,0
2000,710,158,16,174,10,56,66,1,0,1,5,5,10
2000,711,42,1,43,4,7,11,0,0,0,0,0,0
2000,712,76,5,81,3,24,27,0,0,0,0,0,0
2000,713,8,2,10,0,0,0,0,0,0,0,0,0
2000,714,36,1,37,2,13,15,0,0,0,0,0,0
2000,716,11,1,12,0,1,1,0,0,0,0,0,0
2000,718,167,17,184,34,38,72,0,0,0,0,0,0
2000,721,18,3,21,3,8,11,0,0,0,0,0,0
2000,800,28,1,29,2,7,9,0,0,0,0,0,0
2000,801,9,1,10,0,1,1,0,0,0,0,0,0
2000,900,126,5,131,8,75,83,25,0,25,87,50,137
2000,901,17,1,18,2,8,10,0,0,0,0,0,0
2000,902,44,5,49,6,13,19,0,0,0,0,0,0
2000,1000,389,35,424,38,139,177,12,2,14,279,126,405
2000,1001,74,7,81,6,36,42,0,0,0,3,0,3
2000,1002,18,0,18,2,4,6,0,0,0,0,0,0
2000,1003,10,1,11,0,5,5,0,0,0,0,0,0
2000,1004,5,0,5,0,1,1,0,0,0,0,0,0
2000,1005,608,74,682,94,248,342,0,0,0,0,0,0
2000,1006,7,0,7,2,3,5,0,0,0,0,0,0
2000,1007,17,0,17,0,2,2,0,0,0,0,0,0
2000,1008,14,1,15,1,4,5,0,0,0,0,0,0
2000,1011,11,0,11,0,1,1,0,0,0,0,0,0
2000,1012,22,2,24,2,12,14,0,0,0,0,0,0
2000,1013,15,2,17,5,6,11,0,0,0,0,0,0
2000,1015,27,1,28,1,13,14,0,0,0,0,0,0
2000,1097,13,4,17,2,7,9,0,0,0,0,0,0
2000,1100,25,1,26,3,12,15,2,0,2,10,12,22
2000,1101,10,1,11,0,1,1,0,0,0,0,0,0
2000,1102,8,0,8,0,2,2,0,0,0,0,0,0
2000,1200,72,8,80,5,25,30,1,0,1,68,35,103
2000,1201,20,0,20,5,6,11,0,0,0,0,0,0
2000,1202,6,1,7,3,2,5,0,0,0,0,0,0
2000,1203,46,4,50,4,27,31,0,0,0,0,0,0
2000,1204,4,0,4,0,0,0,0,0,0,0,0,0
2000,1205,12,0,12,2,6,8,0,0,0,0,0,0
2000,1206,0,0,0,0,0,0,0,0,0,0,0,0
2000,1207,4,1,5,0,0,0,0,0,0,0,0,0
2000,1208,12,0,12,1,5,6,0,0,0,0,0,0
2000,1300,94,6,100,5,35,40,4,0,4,62,50,112
2000,1301,28,2,30,0,10,10,0,0,0,0,0,0
2000,1302,39,2,41,7,8,15,0,0,0,0,0,0
2000,1303,5,0,5,1,0,1,0,0,0,0,0,0
2000,1304,47,3,50,6,14,20,0,0,0,0,0,0
2000,1305,0,0,0,0,0,0,8,0,8,0,3,3
2000,1306,11,1,12,0,1,1,0,0,0,0,0,0
2000,1307,5,0,5,0,0,0,0,0,0,0,0,0
2000,1400,27,1,28,1,6,7,10,1,11,9,16,25
2000,1401,14,0,14,0,7,7,0,0,0,0,0,0
2000,1500,335,30,365,29,116,145,111,16,127,209,181,390
2000,1501,14,0,14,0,6,6,0,0,0,0,0,0
2000,1502,286,16,302,11,112,123,0,0,0,0,0,0
2000,1503,41,2,43,0,15,15,0,0,0,4,0,4
2000,1506,27,2,29,1,10,11,0,0,0,0,0,0
2000,1507,16,1,17,1,4,5,0,0,0,0,0,0
2000,1508,11,0,11,0,7,7,0,0,0,0,0,0
2000,1511,12,1,13,1,5,6,0,0,0,0,0,0
2000,1514,4,0,4,0,0,0,0,0,0,0,0,0
2000,1597,9,0,9,1,1,2,0,0,0,0,0,0
2000,1600,74,3,77,8,37,45,0,0,0,40,32,72
2000,1601,16,1,17,1,6,7,0,0,0,0,0,0
2000,1602,39,3,42,0,12,12,0,0,0,0,0,0
2000,1603,22,4,26,1,5,6,0,0,0,0,0,0
2000,1606,22,3,25,45,4,49,0,0,0,0,0,0
2000,1700,60,4,64,8,17,25,1,0,1,53,31,84
2000,1701,14,0,14,0,2,2,0,0,0,0,0,0
2000,1702,23,0,23,1,6,7,0,0,0,0,0,0
2000,1801,16,3,19,0,3,3,0,0,0,0,0,0
2000,1900,5675,907,6582,1232,2117,3349,0,0,0,0,0,0
2000,1901,75,6,81,8,38,46,0,0,0,0,0,0
2000,1902,65,9,74,10,26,36,0,0,0,1,2,3
2000,1905,55,2,57,1,22,23,0,0,0,2,6,8
2000,1906,66,6,72,0,21,21,0,0,0,0,0,0
2000,1907,37,0,37,0,8,8,0,0,0,0,0,0
2000,1909,42,4,46,6,11,17,0,0,0,0,0,0
2000,1910,125,8,133,15,37,52,0,0,0,3,5,8
2000,1918,120,5,125,10,25,35,0,0,0,4,1,5
2000,1920,104,8,112,8,39,47,0,0,0,0,0,0
2000,1922,136,10,146,23,29,52,0,0,0,5,2,7
2000,1923,54,7,61,7,20,27,5,1,6,0,0,0
2000,1924,68,10,78,0,10,10,0,0,0,2,6,8
2000,1925,213,24,237,16,79,95,1,0,1,10,7,17
2000,1926,47,8,55,2,11,13,0,0,0,3,8,11
2000,1928,77,6,83,7,30,37,0,0,0,0,0,0
2000,1929,34,2,36,0,6,6,0,0,0,1,4,5
2000,1931,69,3,72,11,19,30,0,0,0,4,1,5
2000,1933,172,17,189,18,53,71,0,0,0,5,4,9
2000,1934,22,0,22,0,6,6,0,0,0,0,0,0
2000,1938,44,2,46,4,13,17,0,0,0,0,0,0
2000,1941,795,93,888,163,332,495,13,1,14,43,21,64
2000,1942,7489,1703,9192,765,1895,2660,0,0,0,205,99,304
2000,1944,58,5,63,9,17,26,0,0,0,5,1,6
2000,1945,24,0,24,3,7,10,0,0,0,2,0,2
2000,1946,55,5,60,2,15,17,0,0,0,2,1,3
2000,1947,79,8,87,5,30,35,0,0,0,0,0,0
2000,1948,68,12,80,2,26,28,0,0,0,3,2,5
2000,1951,21,3,24,2,3,5,0,0,0,2,7,9
2000,1953,191,31,222,22,88,110,1,0,1,8,8,16
2000,1955,157,7,164,17,87,104,1,0,1,11,8,19
2000,1956,100,7,107,3,35,38,0,0,0,2,7,9
2000,1961,38,1,39,7,10,17,0,0,0,0,0,0
2000,1962,49,5,54,3,11,14,0,0,0,0,0,0
2000,1963,25,2,27,1,3,4,0,0,0,0,0,0
2000,1965,174,26,200,51,103,154,0,0,0,7,5,12
2000,1966,16,1,17,1,3,4,0,0,0,0,0,0
2000,1967,25,5,30,1,7,8,0,0,0,5,3,8
2000,1969,90,4,94,10,26,36,0,0,0,5,2,7
2000,1970,35,1,36,6,8,14,0,0,0,0,0,0
2000,1972,239,9,248,1,41,42,0,0,0,14,14,28
2000,1973,49,4,53,5,14,19,0,0,0,3,0,3
2000,1975,115,9,124,8,28,36,0,0,0,5,2,7
2000,1976,125,8,133,15,52,67,0,0,0,0,0,0
2000,1978,10,2,12,7,13,20,0,0,0,0,0,0
2000,1981,14,2,16,3,1,4,0,0,0,0,0,0
2000,1982,17,5,22,4,3,7,0,0,0,0,0,0
2000,1983,16,2,18,1,4,5,0,0,0,0,0,0
2000,1984,16,1,17,3,5,8,0,0,0,0,0,0
2000,1997,45,6,51,6,16,22,0,0,0,0,0,0
2000,2000,74,7,81,6,27,33,0,0,0,0,0,0
2000,2001,16,0,16,1,5,6,0,0,0,0,0,0
2000,2002,44,1,45,2,8,10,0,0,0,0,0,0
2000,2100,112,12,124,19,52,71,59,16,75,8,11,19
2000,2101,6,0,6,0,1,1,0,0,0,0,0,0
2000,2103,10,1,11,0,4,4,0,0,0,0,0,0
2000,2104,32,1,33,1,10,11,0,0,0,0,0,0
2000,2105,21,1,22,1,3,4,0,0,0,0,0,0
2000,2106,51,8,59,2,18,20,0,0,0,0,0,0
2000,2107,8,1,9,0,0,0,0,0,0,0,0,0
2000,2108,17,1,18,0,7,7,0,0,0,0,0,0
2000,2109,65,6,71,7,28,35,0,0,0,0,0,0
2000,2110,18,3,21,0,0,0,0,0,0,0,0,0
2000,2111,13,1,14,0,3,3,0,0,0,0,0,0
2000,2113,8,0,8,0,1,1,0,0,0,0,0,0
2000,2200,32,4,36,3,8,11,0,0,0,8,8,16
2000,2300,73,2,75,5,21,26,35,14,49,2,7,9
2000,2301,12,2,14,0,4,4,0,0,0,0,0,0
2000,2303,26,1,27,3,9,12,0,0,0,0,0,0
2000,2304,13,0,13,2,5,7,0,0,0,0,0,0
2000,2400,80,1,81,10,27,37,1,0,1,65,35,100
2000,2401,30,0,30,3,5,8,0,0,0,0,0,0
2000,2402,9,0,9,0,0,0,0,0,0,0,0,0
2000,2403,7,1,8,0,1,1,0,0,0,0,0,0
2000,2404,18,1,19,0,6,6,0,0,0,0,0,0
2000,2405,26,3,29,4,9,13,0,0,0,0,0,0
2000,2406,79,1,80,7,25,32,0,0,0,0,0,0
2000,2500,10,1,11,0,0,0,3,4,7,1,2,3
2000,2501,8,0,8,0,1,1,0,0,0,0,0,0
2000,2600,24,1,25,16,5,21,0,0,0,7,8,15
2000,2601,13,2,15,1,3,4,0,0,0,0,0,0
2000,2700,168,9,177,16,63,79,123,36,159,24,23,47
2000,2701,15,0,15,3,6,9,0,0,0,0,0,0
2000,2702,5,0,5,0,0,0,0,0,0,0,0,0
2000,2703,11,0,11,1,1,2,0,0,0,0,0,0
2000,2705,14,2,16,2,1,3,0,0,0,0,0,0
2000,2706,57,5,62,3,6,9,0,0,0,6,6,12
2000,2707,27,3,30,3,7,10,0,0,0,0,0,0
2000,2709,8,1,9,0,2,2,0,0,0,0,0,0
2000,2710,32,6,38,3,6,9,0,0,0,0,0,0
2000,2711,12,1,13,0,0,0,0,0,0,0,0,0
2000,2712,29,2,31,3,3,6,0,0,0,0,0,0
2000,2714,5,1,6,0,0,0,0,0,0,0,0,0
2000,2719,12,1,13,0,2,2,0,0,0,0,0,0
2000,2800,77,4,81,8,19,27,0,0,0,0,0,0
2000,2801,11,0,11,1,3,4,0,0,0,0,0,0
2000,2802,66,6,72,6,39,45,0,0,0,0,0,0
2000,2803,11,1,12,0,5,5,0,0,0,0,0,0
2000,2808,67,15,82,2,4,6,0,0,0,0,0,0
2000,2901,19,0,19,1,7,8,0,0,0,0,0,0
2000,2902,9,0,9,0,1,1,0,0,0,0,0,0
2000,3000,937,111,1048,860,810,1670,600,85,685,55,33,88
2000,3001,353,35,388,28,119,147,0,0,0,18,12,30
2000,3002,99,10,109,5,30,35,0,0,0,0,0,0
2000,3003,89,5,94,5,40,45,0,0,0,4,1,5
2000,3004,140,9,149,12,47,59,1,0,1,7,2,9
2000,3005,51,2,53,1,11,12,0,0,0,4,1,5
2000,3006,21,5,26,1,7,8,0,0,0,0,0,0
2000,3007,52,8,60,3,22,25,0,0,0,0,0,0
2000,3008,140,12,152,6,60,66,0,0,0,4,1,5
2000,3009,151,9,160,10,53,63,0,0,0,0,0,0
2000,3010,223,10,233,43,95,138,1,0,1,11,7,18
2000,3011,39,10,49,3,30,33,0,0,0,0,0,0
2000,3012,65,5,70,10,29,39,0,0,0,3,0,3
2000,3013,18,3,21,1,4,5,0,0,0,0,0,0
2000,3014,132,5,137,16,53,69,0,0,0,7,2,9
2000,3015,138,13,151,13,53,66,0,0,0,0,0,0
2000,3016,58,2,60,3,14,17,0,0,0,0,0,0
2000,3019,357,12,369,36,144,180,0,0,0,60,62,122
2000,3020,33,3,36,2,7,9,0,0,0,0,0,0
2000,3022,84,6,90,6,36,42,0,0,0,0,0,0
2000,3024,94,5,99,6,37,43,0,0,0,2,0,2
2000,3026,137,21,158,14,52,66,0,0,0,0,0,0
2000,3027,18,2,20,1,8,9,0,0,0,0,0,0
2000,3034,6,0,6,0,1,1,0,0,0,0,0,0
2000,3097,17,4,21,0,0,0,0,0,0,0,0,0
2000,3100,153,15,168,14,75,89,38,8,46,43,47,90
2000,3101,19,1,20,2,9,11,0,0,0,0,0,0
2000,3103,12,1,13,10,2,12,0,0,0,0,0,0
2000,3104,31,2,33,4,13,17,0,0,0,0,0,0
2000,3105,77,4,81,10,36,46,0,0,0,4,3,7
2000,3200,37,0,37,0,13,13,0,0,0,11,7,18
2000,3300,982,111,1093,111,462,573,214,21,235,388,245,633
2000,3301,32,0,32,1,11,12,0,0,0,0,0,0
2000,3302,20,0,20,0,7,7,0,0,0,0,0,0
2000,3303,19,2,21,3,8,11,0,0,0,0,0,0
2000,3306,13,1,14,1,3,4,0,0,0,0,0,0
2000,3308,58,4,62,3,19,22,0,0,0,0,0,0
2000,3309,46,3,49,5,13,18,0,0,0,0,0,0
2000,3311,80,5,85,8,20,28,0,0,0,0,0,0
2000,3313,296,25,321,21,124,145,0,0,0,0,0,0
2000,3314,23,1,24,3,6,9,0,0,0,0,0,0
2000,3315,127,14,141,16,54,70,0,0,0,0,0,0
2000,3325,38,4,42,10,15,25,0,0,0,0,0,0
2000,3342,30,3,33,0,10,10,0,0,0,0,0,0
2000,3397,18,3,21,3,5,8,0,0,0,0,0,0
2000,3400,842,169,1011,35,238,273,296,87,383,87,121,208
2000,3401,45,3,48,0,17,17,0,0,0,0,0,0
2000,3402,20,0,20,0,12,12,0,0,0,0,0,0
2000,3403,3,0,3,0,0,0,0,0,0,0,0,0
2000,3404,567,90,657,109,260,369,0,0,0,0,0,0
2000,3408,12,1,13,0,5,5,0,0,0,0,0,0
2000,3420,6,0,6,0,1,1,0,0,0,0,0,0
2000,3422,484,122,606,21,51,72,0,0,0,0,0,0
2000,3499,5928,581,6509,1438,1841,3279,0,0,0,0,0,0
2000,3500,15,2,17,1,7,8,0,0,0,17,12,29
2000,3501,31,3,34,3,4,7,0,0,0,0,0,0
2000,3600,952,170,1122,177,494,671,300,32,332,137,305,442
2000,3601,41,2,43,1,17,18,0,0,0,0,0,0
2000,3602,77,6,83,2,28,30,0,0,0,0,0,0
2000,3603,61,4,65,3,18,21,0,0,0,0,0,0
2000,3604,131,5,136,5,54,59,0,0,0,0,0,0
2000,3605,49,3,52,2,22,24,0,0,0,0,0,0
2000,3607,207,11,218,15,85,100,0,0,0,0,0,0
2000,3608,72,5,77,17,38,55,0,0,0,0,0,0
2000,3609,87,15,102,8,34,42,0,0,0,0,0,0
2000,3610,262,23,285,31,119,150,0,0,0,6,3,9
2000,3611,74,3,77,7,27,34,0,0,0,0,0,0
2000,3613,20,0,20,1,8,9,0,0,0,0,0,0
2000,3614,13,0,13,7,17,24,0,0,0,0,0,0
2000,3623,20,3,23,21,20,41,0,0,0,0,0,0
2000,3639,2,2,4,0,2,2,0,0,0,0,0,0
2000,3650,8,4,12,1,4,5,0,0,0,0,0,0
2000,3700,1123,203,1326,264,477,741,792,217,1009,316,447,763
2000,3701,82,11,93,4,34,38,0,0,0,0,0,0
2000,3702,183,24,207,25,79,104,0,0,0,0,2,2
2000,3703,36,4,40,4,11,15,0,0,0,0,0,0
2000,3705,132,8,140,16,55,71,0,0,0,0,0,0
2000,3706,137,19,156,16,52,68,0,0,0,0,0,0
2000,3708,59,4,63,4,19,23,0,0,0,0,0,0
2000,3709,82,2,84,5,21,26,0,0,0,0,0,0
2000,3711,1805,307,2112,270,486,756,0,0,0,0,0,0
2000,3714,25,2,27,7,10,17,0,0,0,0,0,0
2000,3715,98,13,111,7,13,20,0,0,0,0,0,0
2000,3732,8,0,8,3,3,6,0,0,0,0,0,0
2000,3797,21,6,27,11,3,14,0,0,0,0,0,0
2000,3801,1894,350,2244,162,221,383,0,0,0,0,0,0
2000,3803,18,6,24,7,10,17,0,0,0,0,0,0
2000,3816,0,0,0,11,1,12,0,0,0,0,0,0
2000,3897,19,4,23,5,9,14,0,0,0,0,0,0
2000,3900,184,23,207,40,122,162,33,6,39,122,106,228
2000,3901,8,1,9,0,2,2,0,0,0,0,0,0
2000,3902,70,7,77,1,17,18,0,0,0,3,14,17
2000,3903,53,4,57,5,14,19,0,0,0,0,0,0
2000,3904,13,2,15,0,8,8,0,0,0,0,0,0
2000,3905,334,34,368,0,0,0,0,0,0,0,0,0
2000,3906,57,5,62,8,23,31,0,0,0,0,0,0
2000,3915,16,0,16,1,4,5,0,0,0,0,0,0
2000,4000,141,6,147,9,50,59,101,20,121,8,31,39
2000,4001,23,3,26,2,8,10,0,0,0,0,0,0
2000,4002,17,3,20,0,8,8,0,0,0,0,0,0
2000,4003,19,1,20,2,5,7,0,0,0,0,0,0
2000,4004,33,3,36,1,10,11,0,0,0,0,0,0
2000,4005,19,2,21,0,8,8,0,0,0,0,0,0
2000,4006,57,5,62,5,22,27,0,0,0,0,0,0
2000,4007,12,3,15,3,3,6,0,0,0,0,0,0
2000,4008,24,5,29,1,8,9,0,0,0,0,0,0
2000,4019,5,0,5,9,3,12,0,0,0,0,0,0
2000,4100,195,25,220,47,68,115,157,37,194,15,29,44
2000,4101,16,1,17,2,4,6,0,0,0,0,0,0
2000,4102,31,1,32,3,8,11,0,0,0,0,0,0
2000,4103,15,3,18,0,2,2,0,0,0,0,0,0
2000,4104,43,6,49,3,16,19,0,0,0,0,0,0
2000,4105,14,1,15,0,5,5,0,0,0,0,0,0
2000,4106,107,11,118,8,22,30,0,0,0,0,0,0
2000,4107,14,1,15,0,3,3,0,0,0,0,0,0
2000,4108,24,3,27,0,7,7,0,0,0,0,0,0
2000,4109,44,9,53,7,13,20,0,0,0,0,0,0
2000,4110,28,2,30,2,8,10,0,0,0,0,0,0
2000,4111,38,0,38,3,10,13,0,0,0,0,0,0
2000,4113,86,13,99,13,31,44,0,0,0,0,0,0
2000,4114,47,3,50,1,17,18,0,0,0,0,0,0
2000,4115,32,4,36,1,10,11,0,0,0,0,0,0
2000,4116,98,10,108,6,38,44,0,0,0,0,0,0
2000,4117,72,4,76,1,24,25,0,0,0,0,0,0
2000,4119,8,1,9,1,0,1,0,0,0,0,0,0
2000,4120,35,6,41,3,13,16,0,0,0,0,0,0
2000,4127,45,2,47,6,9,15,0,0,0,0,0,0
2000,4200,284,14,298,30,86,116,130,56,186,34,34,68
2000,4201,8,2,10,0,2,2,0,0,0,0,0,0
2000,4202,44,3,47,2,9,11,0,0,0,4,6,10
2000,4203,132,10,142,20,58,78,0,0,0,0,0,0
2000,4204,79,9,88,1,34,35,0,0,0,0,0,0
2000,4211,5,0,5,0,1,1,0,0,0,0,0,0
2000,4297,24,4,28,5,8,13,0,0,0,0,0,0
2000,4300,347,53,400,36,98,134,71,10,81,0,1,1
2000,4302,43,3,46,2,16,18,0,0,0,0,0,0
2000,4304,51,6,57,7,28,35,0,0,0,2,3,5
2000,4305,21,1,22,4,9,13,0,0,0,0,0,0
2000,4307,38,3,41,8,12,20,0,0,0,0,0,0
2000,4308,80,8,88,5,25,30,0,0,0,0,0,0
2000,4310,27,4,31,0,14,14,0,0,0,0,0,0
2000,4311,83,7,90,7,25,32,0,0,0,0,0,0
2000,4313,1264,121,1385,70,323,393,0,0,0,0,0,0
2000,4314,142,6,148,4,40,44,0,0,0,2,2,4
2000,4316,220,15,235,25,48,73,0,0,0,0,0,0
2000,4317,29,2,31,14,12,26,0,0,0,0,0,0
2000,4320,3,1,4,1,2,3,0,0,0,0,0,0
2000,4321,7,2,9,1,2,3,0,0,0,0,0,0
2000,4324,7,0,7,0,1,1,0,0,0,0,0,0
2000,4327,10,0,10,1,1,2,0,0,0,0,0,0
2000,4400,145,11,156,6,33,39,72,29,101,8,8,16
2000,4401,23,0,23,6,0,6,0,0,0,0,0,0
2000,4402,79,9,88,7,27,34,0,0,0,0,0,0
2000,4403,59,3,62,2,11,13,0,0,0,0,0,0
2000,4404,20,2,22,0,8,8,0,0,0,0,0,0
2000,4497,13,4,17,8,13,21,0,0,0,0,0,0
2000,4500,88,10,98,9,40,49,47,13,60,25,19,44
2000,4501,14,0,14,1,9,10,0,0,0,0,0,0
2000,4502,102,5,107,11,41,52,0,0,0,0,0,0
2000,4600,10,1,11,0,0,0,0,0,0,2,4,6
2000,4700,53,1,54,5,15,20,2,0,2,24,15,39
2000,4706,9,0,9,2,5,7,0,0,0,0,0,0
2000,4707,3,0,3,0,1,1,0,0,0,0,0,0
2000,4708,9,0,9,6,2,8,0,0,0,0,0,0
2000,4709,14,0,14,4,3,7,0,0,0,0,0,0
2000,4710,4,0,4,0,1,1,0,0,0,0,0,0
2000,4800,99,3,102,13,54,67,3,0,3,186,106,292
2000,4801,33,1,34,2,8,10,0,0,0,0,0,0
2000,4802,19,1,20,0,4,4,0,0,0,0,0,0
2000,4803,94,6,100,7,46,53,0,0,0,0,0,0
2000,4804,10,0,10,0,1,1,0,0,0,0,0,0
2000,4805,26,1,27,2,6,8,0,0,0,0,0,0
2000,4806,89,10,99,4,52,56,0,0,0,0,0,0
2000,4807,138,10,148,10,53,63,0,0,0,0,0,0
2000,4900,164,15,179,24,84,108,0,0,0,3,0,3
2000,4901,10,1,11,4,4,8,0,0,0,0,0,0
2000,4902,12,1,13,1,5,6,0,0,0,0,0,0
2000,4903,15,1,16,8,6,14,0,0,0,0,0,0
2000,4904,59,4,63,5,23,28,0,0,0,0,0,0
2000,4905,154,13,167,16,67,83,0,0,0,0,0,0
2000,4906,16,0,16,1,6,7,0,0,0,0,0,0
2000,4907,11,4,15,1,4,5,0,0,0,0,0,0
2000,4908,59,7,66,1,29,30,0,0,0,0,0,0
2000,4909,10,2,12,2,5,7,0,0,0,0,0,0
2000,4913,5,1,6,0,0,0,0,0,0,0,0,0
2000,4914,9,1,10,3,4,7,0,0,0,0,0,0
2000,5000,197,7,204,9,80,89,2,0,2,153,84,237
2000,5001,35,3,38,3,13,16,0,0,0,0,0,0
2000,5002,236,10,246,13,86,99,0,0,0,0,0,0
2000,5003,12,0,12,0,1,1,0,0,0,0,0,0
2000,5004,24,1,25,3,5,8,0,0,0,0,0,0
2000,5005,13,0,13,0,2,2,0,0,0,0,0,0
2000,5007,56,2,58,2,27,29,0,0,0,0,0,0
2000,5009,7,0,7,0,1,1,0,0,0,0,0,0
2000,5010,15,2,17,4,7,11,0,0,0,0,0,0
2000,5100,50,3,53,5,21,26,0,0,0,0,0,0
2000,5102,41,3,44,10,15,25,0,0,0,0,0,0
2000,5201,10,1,11,2,5,7,0,0,0,0,0,0
2000,5202,24,0,24,1,10,11,0,0,0,0,0,0
2000,5300,21,2,23,1,5,6,0,0,0,0,0,0
2000,5400,218,20,238,8,77,85,225,30,255,51,45,96
2000,5401,21,0,21,1,6,7,0,0,0,0,0,0
2000,5402,13,2,15,0,2,2,0,0,0,0,0,0
2000,5403,11,1,12,0,1,1,0,0,0,0,0,0
2000,5404,14,3,17,3,5,8,0,0,0,0,0,0
2000,5405,40,4,44,3,19,22,0,0,0,0,0,0
2000,5406,40,5,45,9,15,24,0,0,0,0,0,0
2000,5407,98,11,109,8,35,43,0,0,0,0,0,0
2000,5408,10,2,12,0,3,3,0,0,0,0,0,0
2000,5411,4,2,6,0,1,1,0,0,0,0,0,0
2000,5500,59,0,59,2,19,21,1,0,1,19,19,38
2000,5501,12,2,14,0,4,4,0,0,0,0,0,0
2000,5600,496,55,551,108,209,317,171,27,198,145,106,251
2000,5604,184,18,202,20,91,111,0,0,0,6,3,9
2000,5605,19,2,21,0,5,5,0,0,0,0,0,0
2000,5606,28,2,30,0,6,6,0,0,0,0,0,0
2000,5608,121,10,131,9,44,53,0,0,0,0,0,0
2000,5609,110,6,116,16,43,59,0,0,0,0,0,0
2000,5700,52,5,57,10,22,32,19,3,22,56,48,104
2000,5701,45,5,50,1,24,25,0,0,0,0,0,0
2000,5702,10,0,10,0,1,1,0,0,0,0,0,0
2000,5703,51,7,58,4,16,20,0,0,0,0,0,0
2000,5704,53,6,59,3,20,23,0,0,0,0,0,0
2000,5801,23,0,23,2,12,14,0,0,0,0,0,0
2000,5802,7,0,7,0,0,0,0,0,0,0,0,0
2000,190C,16,3,19,1,5,6,0,0,0,0,0,0
2000,190R,8,1,9,10,0,10,0,0,0,0,0,0
2001,100,428,49,477,87,198,285,363,65,428,119,163,282
2001,101,94,7,101,6,32,38,0,0,0,3,6,9
2001,102,27,1,28,0,4,4,0,0,0,0,0,0
2001,103,160,32,192,14,58,72,1,0,1,11,11,22
2001,104,35,2,37,1,17,18,0,0,0,0,0,0
2001,105,184,23,207,20,77,97,1,0,1,8,8,16
2001,106,175,20,195,22,70,92,0,0,0,17,8,25
2001,107,79,9,88,7,43,50,0,0,0,0,0,0
2001,108,49,3,52,8,17,25,0,0,0,0,0,0
2001,109,657,78,735,150,203,353,3,0,3,50,34,84
2001,110,18,2,20,3,5,8,0,0,0,0,0,0
2001,111,72,8,80,5,28,33,0,0,0,0,0,0
2001,112,83,5,88,9,25,34,0,0,0,4,3,7
2001,113,63,10,73,2,24,26,0,0,0,0,0,0
2001,114,48,7,55,4,19,23,0,0,0,0,0,0
2001,115,12,0,12,10,11,21,0,0,0,0,0,0
2001,121,166,19,185,39,40,79,0,0,0,0,0,0
2001,122,2,0,2,2,3,5,0,0,0,0,0,0
2001,130,39,6,45,0,7,7,0,0,0,0,0,0
2001,197,59,12,71,22,21,43,0,0,0,0,0,0
2001,200,12,1,13,1,3,4,0,0,0,0,0,0
2001,300,47,0,47,1,17,18,2,0,2,6,8,14
2001,302,6,0,6,0,1,1,0,0,0,0,0,0
2001,303,9,1,10,0,3,3,0,0,0,0,0,0
2001,305,7,0,7,0,1,1,0,0,0,0,0,0
2001,400,106,3,109,4,39,43,1,0,1,53,39,92
2001,402,66,9,75,7,39,46,0,0,0,0,0,0
2001,403,15,1,16,0,6,6,0,0,0,0,0,0
2001,404,21,3,24,0,0,0,0,0,0,0,0,0
2001,405,23,1,24,0,9,9,0,0,0,0,0,0
2001,497,8,2,10,0,3,3,0,0,0,0,0,0
2001,500,52,3,55,1,15,16,1,0,1,7,11,18
2001,501,7,0,7,0,1,1,0,0,0,0,0,0
2001,600,29,0,29,1,16,17,2,0,2,7,9,16
2001,601,7,1,8,0,1,1,0,0,0,0,0,0
2001,602,7,1,8,0,1,1,0,0,0,0,0,0
2001,700,417,51,468,67,173,240,184,35,219,39,44,83
2001,701,96,7,103,5,29,34,0,0,0,0,0,0
2001,702,30,5,35,2,9,11,0,0,0,0,0,0
2001,703,11,0,11,0,2,2,0,0,0,0,0,0
2001,704,133,25,158,12,45,57,0,0,0,5,0,5
2001,705,32,2,34,0,8,8,0,0,0,0,0,0
2001,706,19,2,21,1,1,2,0,0,0,0,0,0
2001,707,24,0,24,1,9,10,0,0,0,0,0,0
2001,708,72,1,73,2,18,20,0,0,0,0,0,0
2001,709,39,3,42,3,19,22,0,0,0,0,0,0
2001,710,172,16,188,12,53,65,0,0,0,3,5,8
2001,711,45,1,46,5,6,11,0,0,0,0,0,0
2001,712,75,5,80,5,27,32,0,0,0,0,0,0
2001,713,8,2,10,0,0,0,0,0,0,0,0,0
2001,714,36,1,37,3,10,13,0,0,0,0,0,0
2001,716,11,1,12,0,1,1,0,0,0,0,0,0
2001,721,19,2,21,5,5,10,0,0,0,0,0,0
2001,800,27,2,29,2,7,9,0,0,0,0,0,0
2001,801,12,1,13,0,1,1,0,0,0,0,0,0
2001,900,133,5,138,7,64,71,25,1,26,59,53,112
2001,901,16,0,16,2,8,10,0,0,0,0,0,0
2001,902,44,5,49,5,15,20,0,0,0,0,0,0
2001,1000,383,38,421,55,133,188,7,2,9,275,117,392
2001,1001,75,7,82,9,37,46,0,0,0,3,0,3
2001,1002,19,0,19,2,4,6,0,0,0,0,0,0
2001,1003,11,1,12,0,5,5,0,0,0,0,0,0
2001,1004,6,0,6,0,1,1,0,0,0,0,0,0
2001,1005,614,79,693,83,258,341,0,0,0,0,0,0
2001,1006,10,0,10,3,5,8,0,0,0,0,0,0
2001,1007,18,2,20,0,0,0,0,0,0,0,0,0
2001,1008,14,1,15,1,4,5,0,0,0,0,0,0
2001,1011,11,1,12,0,2,2,0,0,0,0,0,0
2001,1012,25,2,27,2,13,15,0,0,0,0,0,0
2001,1013,22,1,23,4,6,10,0,0,0,0,0,0
2001,1015,27,1,28,1,12,13,0,0,0,0,0,0
2001,1017,13,0,13,1,2,3,0,0,0,0,0,0
2001,1031,4,0,4,0,0,0,0,0,0,0,0,0
2001,1097,14,4,18,2,8,10,0,0,0,0,0,0
2001,1100,25,3,28,5,11,16,1,0,1,10,12,22
2001,1101,8,1,9,0,1,1,0,0,0,0,0,0
2001,1102,7,1,8,0,1,1,0,0,0,0,0,0
2001,1200,66,8,74,8,25,33,1,0,1,70,35,105
2001,1201,23,0,23,5,6,11,0,0,0,0,0,0
2001,1202,5,3,8,2,1,3,0,0,0,0,0,0
2001,1203,42,4,46,5,21,26,0,0,0,0,0,0
2001,1204,3,1,4,0,0,0,0,0,0,0,0,0
2001,1205,14,1,15,2,4,6,0,0,0,0,0,0
2001,1206,1,0,1,0,1,1,0,0,0,0,0,0
2001,1207,6,1,7,0,0,0,0,0,0,0,0,0
2001,1208,11,0,11,6,1,7,0,0,0,0,0,0
2001,1300,97,6,103,5,31,36,5,0,5,65,50,115
2001,1301,28,2,30,0,10,10,0,0,0,0,0,0
2001,1302,35,2,37,7,11,18,0,0,0,0,0,0
2001,1303,5,0,5,0,0,0,0,0,0,0,0,0
2001,1304,45,2,47,5,15,20,0,0,0,0,0,0
2001,1305,7,0,7,0,0,0,0,0,0,1,3,4
2001,1306,11,1,12,0,1,1,0,0,0,0,0,0
2001,1307,5,0,5,0,0,0,0,0,0,0,0,0
2001,1400,25,1,26,8,2,10,11,1,12,5,11,16
2001,1401,14,0,14,0,7,7,0,0,0,0,0,0
2001,1500,329,26,355,50,133,183,121,17,138,218,164,382
2001,1501,12,1,13,1,6,7,0,0,0,0,0,0
2001,1502,282,19,301,10,111,121,0,0,0,0,0,0
2001,1503,28,1,29,6,14,20,4,0,4,0,0,0
2001,1506,27,2,29,2,12,14,0,0,0,0,0,0
2001,1507,17,1,18,3,3,6,0,0,0,0,0,0
2001,1508,12,0,12,0,7,7,0,0,0,0,0,0
2001,1511,12,2,14,1,5,6,0,0,0,0,0,0
2001,1514,4,0,4,0,0,0,0,0,0,0,0,0
2001,1515,7,0,7,1,3,4,0,0,0,0,0,0
2001,1597,8,1,9,0,1,1,0,0,0,0,0,0
2001,1600,77,4,81,9,39,48,39,18,57,2,17,19
2001,1601,18,1,19,2,7,9,0,0,0,0,0,0
2001,1602,38,3,41,0,17,17,0,0,0,0,0,0
2001,1603,23,5,28,1,6,7,0,0,0,0,0,0
2001,1606,49,4,53,24,1,25,0,0,0,0,0,0
2001,1700,61,4,65,3,17,20,0,0,0,50,35,85
2001,1701,14,0,14,0,2,2,0,0,0,0,0,0
2001,1702,23,0,23,1,6,7,0,0,0,0,0,0
2001,1800,37,0,37,0,7,7,25,19,44,5,9,14
2001,1801,17,2,19,0,4,4,0,0,0,0,0,0
2001,1900,5835,938,6773,1333,2265,3598,0,0,0,0,0,0
2001,1901,76,6,82,8,38,46,0,0,0,0,0,0
2001,1902,63,8,71,7,23,30,0,0,0,2,3,5
2001,1905,55,2,57,1,18,19,0,0,0,0,0,0
2001,1906,59,6,65,2,23,25,0,0,0,0,0,0
2001,1907,36,2,38,0,9,9,0,0,0,0,0,0
2001,1909,46,4,50,4,14,18,0,0,0,0,0,0
2001,1910,121,10,131,17,38,55,0,0,0,4,5,9
2001,1912,148,11,159,25,82,107,0,0,0,9,2,11
2001,1913,37,3,40,0,15,15,0,0,0,4,1,5
2001,1916,55,1,56,5,21,26,0,0,0,3,0,3
2001,1918,121,6,127,10,27,37,0,0,0,2,1,3
2001,1920,100,8,108,10,37,47,0,0,0,0,0,0
2001,1922,137,8,145,15,32,47,0,0,0,4,2,6
2001,1923,55,7,62,20,5,25,0,0,0,6,1,7
2001,1924,73,8,81,0,12,12,0,0,0,2,6,8
2001,1925,209,21,230,10,82,92,1,0,1,11,7,18
2001,1926,49,10,59,10,17,27,0,0,0,2,2,4
2001,1928,87,5,92,5,29,34,0,0,0,5,3,8
2001,1929,35,2,37,8,5,13,0,0,0,2,6,8
2001,1931,71,2,73,11,22,33,0,0,0,4,1,5
2001,1933,178,19,197,9,40,49,0,0,0,4,5,9
2001,1934,21,0,21,0,6,6,0,0,0,0,0,0
2001,1938,46,1,47,4,13,17,0,0,0,0,0,0
2001,1941,751,90,841,166,253,419,15,3,18,39,26,65
2001,1942,7256,1665,8921,813,1905,2718,17,5,22,203,115,318
2001,1944,54,5,59,13,17,30,0,0,0,5,0,5
2001,1945,28,0,28,0,6,6,0,0,0,4,0,4
2001,1946,56,7,63,4,16,20,0,0,0,2,1,3
2001,1947,76,8,84,9,28,37,7,0,7,0,0,0
2001,1948,70,12,82,3,30,33,0,0,0,3,1,4
2001,1951,21,3,24,1,7,8,0,0,0,1,3,4
2001,1953,198,36,234,28,66,94,1,0,1,10,8,18
2001,1955,155,8,163,19,85,104,1,0,1,11,7,18
2001,1956,100,7,107,2,17,19,0,0,0,2,6,8
2001,1961,38,1,39,11,20,31,0,0,0,0,0,0
2001,1962,50,5,55,3,11,14,0,0,0,0,0,0
2001,1963,21,3,24,1,4,5,0,0,0,0,0,0
2001,1965,173,28,201,81,92,173,0,0,0,5,6,11
2001,1966,17,1,18,0,0,0,1,5,6,0,0,0
2001,1967,27,4,31,6,6,12,0,0,0,0,0,0
2001,1969,84,3,87,2,28,30,0,0,0,4,1,5
2001,1970,34,1,35,4,7,11,0,0,0,0,0,0
2001,1972,229,8,237,19,53,72,0,0,0,7,6,13
2001,1973,53,4,57,0,13,13,0,0,0,4,0,4
2001,1975,107,8,115,7,26,33,0,0,0,5,2,7
2001,1976,127,6,133,15,52,67,0,0,0,0,0,0
2001,1978,13,1,14,6,15,21,0,0,0,0,0,0
2001,1981,12,2,14,9,3,12,0,0,0,0,0,0
2001,1982,19,4,23,5,3,8,0,0,0,0,0,0
2001,1983,17,2,19,1,8,9,0,0,0,0,0,0
2001,1984,19,2,21,9,7,16,0,0,0,0,0,0
2001,1997,49,6,55,15,20,35,0,0,0,0,0,0
2001,2000,72,7,79,5,24,29,0,0,0,0,0,0
2001,2001,17,0,17,1,6,7,0,0,0,0,0,0
2001,2002,50,1,51,2,13,15,0,0,0,0,0,0
2001,2100,114,13,127,22,54,76,61,18,79,8,11,19
2001,2101,7,0,7,0,1,1,0,0,0,0,0,0
2001,2103,11,1,12,0,5,5,0,0,0,0,0,0
2001,2104,32,1,33,1,9,10,0,0,0,0,0,0
2001,2105,20,2,22,2,2,4,0,0,0,0,0,0
2001,2106,50,8,58,2,19,21,0,0,0,0,0,0
2001,2107,7,1,8,1,0,1,0,0,0,0,0,0
2001,2108,17,1,18,0,7,7,0,0,0,0,0,0
2001,2109,59,10,69,6,27,33,0,0,0,0,0,0
2001,2110,18,3,21,1,4,5,0,0,0,0,0,0
2001,2111,14,1,15,0,3,3,0,0,0,0,0,0
2001,2113,9,0,9,0,1,1,0,0,0,0,0,0
2001,2200,34,5,39,4,8,12,0,0,0,8,8,16
2001,2300,74,0,74,4,25,29,44,14,58,1,6,7
2001,2301,13,2,15,0,4,4,0,0,0,0,0,0
2001,2303,26,1,27,1,8,9,0,0,0,0,0,0
2001,2304,14,0,14,2,5,7,0,0,0,1,0,1
2001,2400,80,1,81,6,26,32,1,0,1,65,29,94
2001,2401,30,0,30,5,5,10,0,0,0,0,0,0
2001,2402,8,1,9,0,0,0,0,0,0,0,0,0
2001,2403,9,0,9,0,1,1,0,0,0,0,0,0
2001,2404,17,1,18,1,4,5,0,0,0,0,0,0
2001,2405,29,2,31,6,10,16,0,0,0,0,0,0
2001,2406,79,1,80,4,30,34,0,0,0,0,0,0
2001,2500,13,1,14,1,6,7,6,4,10,0,0,0
2001,2501,10,0,10,0,1,1,0,0,0,0,0,0
2001,2600,24,1,25,14,4,18,9,6,15,0,0,0
2001,2601,16,2,18,1,3,4,0,0,0,0,0,0
2001,2700,167,9,176,10,69,79,117,35,152,22,25,47
2001,2701,13,0,13,3,6,9,0,0,0,0,0,0
2001,2702,6,0,6,0,0,0,0,0,0,0,0,0
2001,2703,12,0,12,1,1,2,0,0,0,0,0,0
2001,2704,16,0,16,0,3,3,0,0,0,0,0,0
2001,2705,14,2,16,2,2,4,0,0,0,0,0,0
2001,2706,53,5,58,4,7,11,0,0,0,5,6,11
2001,2707,27,3,30,3,6,9,0,0,0,0,0,0
2001,2708,141,10,151,17,39,56,0,0,0,0,0,0
2001,2709,8,2,10,1,1,2,0,0,0,0,0,0
2001,2710,32,5,37,1,7,8,0,0,0,0,0,0
2001,2711,14,1,15,0,1,1,0,0,0,0,0,0
2001,2712,29,2,31,3,4,7,0,0,0,0,0,0
2001,2714,5,0,5,0,0,0,0,0,0,0,0,0
2001,2719,12,1,13,4,3,7,0,0,0,0,0,0
2001,2800,78,5,83,7,22,29,0,0,0,0,0,0
2001,2801,10,1,11,0,4,4,0,0,0,0,0,0
2001,2802,70,8,78,3,46,49,0,0,0,0,0,0
2001,2803,13,0,13,0,5,5,0,0,0,0,0,0
2001,2808,74,13,87,1,6,7,0,0,0,0,0,0
2001,2900,64,4,68,11,38,49,3,0,3,37,35,72
2001,2901,21,0,21,1,6,7,0,0,0,0,0,0
2001,2902,9,0,9,0,1,1,0,0,0,0,0,0
2001,3000,874,211,1085,863,965,1828,592,83,675,54,36,90
2001,3001,347,35,382,26,120,146,12,7,19,0,6,6
2001,3002,95,12,107,4,26,30,0,0,0,0,0,0
2001,3003,90,4,94,5,45,50,0,0,0,4,1,5
2001,3004,139,9,148,10,43,53,1,0,1,7,2,9
2001,3005,52,3,55,0,0,0,0,0,0,4,4,8
2001,3006,22,4,26,1,8,9,0,0,0,0,0,0
2001,3007,48,8,56,3,17,20,0,0,0,0,0,0
2001,3008,136,11,147,7,54,61,0,0,0,4,1,5
2001,3009,157,8,165,19,52,71,0,0,0,0,0,0
2001,3010,210,17,227,32,89,121,1,0,1,8,8,16
2001,3011,42,8,50,1,32,33,0,0,0,0,0,0
2001,3012,63,4,67,11,28,39,0,0,0,0,0,0
2001,3013,20,5,25,0,3,3,0,0,0,0,0,0
2001,3014,139,6,145,23,51,74,0,0,0,7,2,9
2001,3015,131,13,144,27,68,95,0,0,0,0,0,0
2001,3016,56,2,58,2,13,15,0,0,0,0,0,0
2001,3019,357,17,374,40,151,191,0,0,0,52,70,122
2001,3020,34,3,37,2,8,10,0,0,0,0,0,0
2001,3022,85,6,91,7,39,46,0,0,0,0,0,0
2001,3024,92,4,96,6,36,42,0,0,0,0,0,0
2001,3026,131,22,153,15,51,66,0,0,0,0,0,0
2001,3027,18,2,20,1,8,9,0,0,0,0,0,0
2001,3034,6,0,6,0,1,1,0,0,0,0,0,0
2001,3097,18,4,22,2,4,6,0,0,0,0,0,0
2001,3100,152,16,168,16,84,100,43,7,50,45,53,98
2001,3101,21,1,22,4,9,13,0,0,0,0,0,0
2001,3103,16,1,17,5,2,7,0,0,0,0,0,0
2001,3104,38,2,40,5,14,19,0,0,0,0,0,0
2001,3105,82,6,88,10,40,50,0,0,0,5,3,8
2001,3200,39,0,39,0,14,14,0,0,0,11,9,20
2001,3300,1091,117,1208,154,529,683,211,26,237,423,232,655
2001,3301,34,0,34,1,11,12,0,0,0,0,0,0
2001,3302,20,0,20,0,7,7,0,0,0,0,0,0
2001,3303,22,2,24,5,6,11,0,0,0,0,0,0
2001,3306,13,1,14,1,4,5,0,0,0,0,0,0
2001,3308,57,5,62,4,18,22,0,0,0,0,0,0
2001,3309,46,3,49,7,14,21,0,0,0,0,0,0
2001,3311,83,5,88,13,35,48,0,0,0,4,5,9
2001,3313,317,29,346,19,132,151,0,0,0,0,0,0
2001,3314,24,0,24,3,7,10,0,0,0,0,0,0
2001,3315,135,13,148,16,65,81,0,0,0,0,0,0
2001,3325,44,5,49,11,18,29,0,0,0,0,0,0
2001,3342,35,3,38,3,13,16,0,0,0,0,0,0
2001,3344,10,3,13,1,5,6,0,0,0,0,0,0
2001,3397,18,1,19,3,7,10,0,0,0,0,0,0
2001,3400,907,182,1089,122,126,248,497,82,579,104,127,231
2001,3401,46,5,51,0,19,19,0,0,0,0,0,0
2001,3402,19,2,21,0,10,10,0,0,0,0,0,0
2001,3403,4,0,4,0,0,0,0,0,0,0,0,0
2001,3404,539,82,621,108,247,355,0,0,0,0,0,0
2001,3408,15,2,17,1,5,6,0,0,0,0,0,0
2001,3414,14,2,16,2,3,5,0,0,0,0,0,0
2001,3420,4,0,4,0,1,1,0,0,0,0,0,0
2001,3422,524,134,658,24,48,72,0,0,0,0,0,0
2001,3499,6242,616,6858,1452,1859,3311,0,0,0,0,0,0
2001,3500,23,3,26,0,6,6,0,0,0,14,9,23
2001,3501,28,4,32,1,6,7,0,0,0,0,0,0
2001,3600,1104,147,1251,189,492,681,269,55,324,134,316,450
2001,3601,35,1,36,1,19,20,0,0,0,0,0,0
2001,3602,79,7,86,1,32,33,0,0,0,0,0,0
2001,3603,58,4,62,4,18,22,0,0,0,0,0,0
2001,3604,125,9,134,4,50,54,0,0,0,0,0,0
2001,3605,49,3,52,2,22,24,0,0,0,0,0,0
2001,3607,208,14,222,15,88,103,0,0,0,0,0,0
2001,3608,69,8,77,17,45,62,0,0,0,0,0,0
2001,3609,84,14,98,8,34,42,0,0,0,0,0,0
2001,3610,257,22,279,28,115,143,0,0,0,0,0,0
2001,3611,72,2,74,7,32,39,0,0,0,0,0,0
2001,3613,19,0,19,1,6,7,0,0,0,0,0,0
2001,3614,13,0,13,2,6,8,0,0,0,0,0,0
2001,3623,23,3,26,30,21,51,0,0,0,0,0,0
2001,3639,2,1,3,0,3,3,0,0,0,0,0,0
2001,3650,11,3,14,2,4,6,0,0,0,0,0,0
2001,3700,816,126,942,106,274,380,835,211,1046,347,528,875
2001,3701,94,8,102,4,35,39,0,0,0,0,0,0
2001,3702,189,21,210,20,71,91,0,0,0,2,2,4
2001,3703,39,4,43,5,12,17,0,0,0,0,0,0
2001,3705,135,6,141,15,60,75,0,0,0,0,0,0
2001,3706,136,18,154,13,54,67,0,0,0,0,0,0
2001,3708,53,4,57,4,18,22,0,0,0,0,0,0
2001,3709,83,3,86,7,28,35,0,0,0,0,0,0
2001,3710,147,19,166,14,67,81,0,0,0,0,0,0
2001,3711,1844,310,2154,259,501,760,0,0,0,0,0,0
2001,3714,23,2,25,5,10,15,0,0,0,0,0,0
2001,3715,103,16,119,5,16,21,0,0,0,0,0,0
2001,3732,10,0,10,3,3,6,0,0,0,0,0,0
2001,3797,22,5,27,15,6,21,0,0,0,0,0,0
2001,3800,179,49,228,52,51,103,382,123,505,0,0,0
2001,3801,1886,357,2243,161,225,386,0,0,0,0,0,0
2001,3803,16,5,21,11,10,21,0,0,0,0,0,0
2001,3816,0,0,0,0,0,0,0,0,0,0,0,0
2001,3897,20,7,27,5,14,19,0,0,0,0,0,0
2001,3900,185,27,212,28,95,123,181,93,274,20,62,82
2001,3901,9,1,10,0,2,2,0,0,0,0,0,0
2001,3902,72,6,78,1,18,19,0,0,0,3,17,20
2001,3903,57,4,61,5,14,19,0,0,0,0,0,0
2001,3904,13,2,15,0,8,8,0,0,0,0,0,0
2001,3905,338,37,375,137,41,178,0,0,0,0,0,0
2001,3906,60,6,66,12,29,41,0,0,0,0,0,0
2001,3915,16,0,16,0,5,5,0,0,0,0,0,0
2001,3923,7,0,7,0,0,0,0,0,0,0,0,0
2001,4000,147,6,153,10,51,61,1,0,1,103,57,160
2001,4001,23,3,26,2,8,10,0,0,0,0,0,0
2001,4002,15,4,19,1,6,7,0,0,0,0,0,0
2001,4003,18,2,20,1,6,7,0,0,0,0,0,0
2001,4004,31,3,34,1,7,8,0,0,0,0,0,0
2001,4005,19,2,21,0,8,8,0,0,0,0,0,0
2001,4006,57,4,61,5,23,28,0,0,0,0,0,0
2001,4007,12,3,15,3,3,6,0,0,0,0,0,0
2001,4008,26,4,30,1,8,9,0,0,0,0,0,0
2001,4016,64,32,96,3,9,12,0,0,0,0,0,0
2001,4019,5,1,6,12,3,15,0,0,0,0,0,0
2001,4100,196,25,221,46,65,111,154,37,191,14,22,36
2001,4101,19,2,21,1,5,6,0,0,0,0,0,0
2001,4102,27,3,30,8,9,17,0,0,0,0,0,0
2001,4103,14,3,17,0,2,2,0,0,0,0,0,0
2001,4104,43,5,48,3,16,19,0,0,0,0,0,0
2001,4105,15,1,16,0,5,5,0,0,0,0,0,0
2001,4106,106,11,117,9,27,36,0,0,0,0,0,0
2001,4107,11,1,12,1,4,5,0,0,0,0,0,0
2001,4108,23,3,26,0,8,8,0,0,0,0,0,0
2001,4109,44,9,53,5,16,21,0,0,0,0,0,0
2001,4110,30,3,33,1,10,11,0,0,0,0,0,0
2001,4111,36,1,37,3,12,15,0,0,0,0,0,0
2001,4113,85,14,99,8,32,40,0,0,0,0,0,0
2001,4114,48,3,51,0,18,18,0,0,0,0,0,0
2001,4115,31,4,35,2,14,16,0,0,0,0,0,0
2001,4116,94,11,105,5,39,44,0,0,0,0,0,0
2001,4117,74,5,79,4,32,36,0,0,0,0,0,0
2001,4119,8,1,9,1,0,1,0,0,0,0,0,0
2001,4120,36,6,42,4,14,18,0,0,0,0,0,0
2001,4127,45,2,47,1,7,8,0,0,0,0,0,0
2001,4200,265,18,283,22,98,120,127,57,184,29,41,70
2001,4201,10,2,12,0,2,2,0,0,0,0,0,0
2001,4202,44,4,48,1,8,9,0,0,0,5,5,10
2001,4203,138,8,146,20,57,77,0,0,0,0,0,0
2001,4204,83,9,92,2,36,38,0,0,0,0,0,0
2001,4211,4,1,5,0,1,1,0,0,0,0,0,0
2001,4297,27,4,31,6,9,15,0,0,0,0,0,0
2001,4300,370,52,422,32,118,150,57,13,70,0,2,2
2001,4302,40,2,42,2,16,18,0,0,0,0,0,0
2001,4304,53,5,58,9,31,40,0,0,0,2,3,5
2001,4305,26,2,28,6,10,16,0,0,0,0,0,0
2001,4307,41,5,46,13,15,28,0,0,0,0,0,0
2001,4308,79,10,89,4,22,26,0,0,0,0,0,0
2001,4310,27,4,31,1,14,15,0,0,0,0,0,0
2001,4311,85,9,94,7,32,39,0,0,0,0,0,0
2001,4312,68,22,90,26,50,76,0,0,0,0,0,0
2001,4313,1266,121,1387,82,344,426,0,0,0,0,0,0
2001,4314,145,7,152,5,39,44,0,0,0,4,2,6
2001,4316,222,16,238,19,43,62,0,0,0,0,0,0
2001,4317,29,2,31,15,12,27,0,0,0,0,0,0
2001,4320,4,0,4,4,2,6,0,0,0,0,0,0
2001,4321,7,2,9,2,2,4,0,0,0,0,0,0
2001,4324,6,0,6,0,2,2,0,0,0,0,0,0
2001,4327,8,0,8,1,1,2,0,0,0,0,0,0
2001,4400,135,15,150,4,35,39,5,0,5,71,28,99
2001,4401,20,0,20,6,5,11,0,0,0,0,0,0
2001,4402,82,9,91,6,26,32,0,0,0,0,0,0
2001,4403,57,3,60,4,16,20,0,0,0,0,0,0
2001,4404,21,1,22,0,9,9,0,0,0,0,0,0
2001,4497,14,4,18,9,14,23,0,0,0,0,0,0
2001,4500,80,10,90,5,46,51,50,13,63,24,12,36
2001,4501,14,1,15,1,10,11,0,0,0,0,0,0
2001,4502,105,4,109,10,39,49,0,0,0,0,0,0
2001,4600,11,1,12,0,1,1,2,4,6,0,0,0
2001,4700,53,1,54,5,18,23,2,0,2,30,13,43
2001,4703,2,0,2,0,0,0,0,0,0,0,0,0
2001,4706,9,0,9,2,5,7,0,0,0,0,0,0
2001,4707,2,1,3,0,0,0,0,0,0,0,0,0
2001,4708,9,0,9,1,5,6,0,0,0,0,0,0
2001,4709,16,0,16,4,4,8,0,0,0,0,0,0
2001,4710,4,0,4,0,1,1,0,0,0,0,0,0
2001,4800,96,7,103,12,67,79,1,0,1,187,99,286
2001,4801,33,1,34,2,13,15,0,0,0,0,0,0
2001,4802,22,2,24,0,4,4,0,0,0,0,0,0
2001,4803,99,8,107,11,47,58,0,0,0,0,0,0
2001,4804,11,1,12,0,2,2,0,0,0,0,0,0
2001,4805,26,2,28,1,9,10,0,0,0,0,0,0
2001,4806,96,9,105,8,53,61,0,0,0,0,0,0
2001,4807,140,11,151,9,55,64,0,0,0,0,0,0
2001,4900,185,15,200,22,77,99,0,0,0,2,1,3
2001,4901,11,1,12,3,4,7,0,0,0,0,0,0
2001,4902,12,0,12,1,6,7,0,0,0,0,0,0
2001,4903,15,1,16,2,9,11,0,0,0,0,0,0
2001,4904,63,1,64,4,32,36,0,0,0,0,0,0
2001,4905,160,16,176,12,73,85,0,0,0,0,0,0
2001,4906,15,1,16,1,6,7,0,0,0,0,0,0
2001,4907,12,4,16,3,5,8,0,0,0,0,0,0
2001,4908,57,8,65,2,28,30,0,0,0,0,0,0
2001,4909,9,3,12,3,4,7,0,0,0,0,0,0
2001,4913,5,1,6,0,0,0,0,0,0,0,0,0
2001,4914,10,2,12,3,4,7,0,0,0,0,0,0
2001,5000,202,9,211,8,79,87,0,0,0,174,101,275
2001,5001,39,3,42,2,13,15,0,0,0,0,0,0
2001,5002,240,18,258,17,91,108,0,0,0,0,0,0
2001,5003,12,0,12,0,2,2,0,0,0,0,0,0
2001,5004,24,2,26,3,5,8,0,0,0,0,0,0
2001,5005,13,0,13,0,2,2,0,0,0,0,0,0
2001,5006,14,0,14,0,3,3,0,0,0,0,0,0
2001,5007,60,3,63,5,32,37,0,0,0,0,0,0
2001,5009,4,0,4,0,1,1,0,0,0,0,0,0
2001,5010,17,2,19,3,5,8,0,0,0,0,0,0
2001,5100,44,3,47,5,17,22,0,0,0,0,0,0
2001,5102,43,2,45,5,21,26,0,0,0,0,0,0
2001,5200,42,5,47,2,22,24,31,4,35,2,8,10
2001,5201,13,1,14,2,6,8,0,0,0,0,0,0
2001,5202,27,0,27,2,17,19,0,0,0,0,0,0
2001,5300,22,1,23,1,5,6,0,0,0,0,0,0
2001,5400,216,18,234,9,70,79,197,33,230,43,43,86
2001,5401,23,0,23,2,5,7,0,0,0,0,0,0
2001,5402,13,2,15,0,2,2,0,0,0,0,0,0
2001,5403,11,2,13,1,1,2,0,0,0,0,0,0
2001,5404,13,5,18,5,5,10,0,0,0,0,0,0
2001,5405,43,2,45,2,21,23,0,0,0,0,0,0
2001,5406,44,5,49,8,16,24,0,0,0,0,0,0
2001,5407,102,11,113,6,43,49,0,0,0,0,0,0
2001,5408,11,2,13,0,2,2,0,0,0,0,0,0
2001,5411,4,1,5,0,1,1,0,0,0,0,0,0
2001,5500,66,2,68,2,21,23,1,0,1,21,10,31
2001,5501,12,2,14,0,4,4,0,0,0,0,0,0
2001,5600,534,58,592,97,188,285,176,26,202,138,108,246
2001,5604,188,17,205,23,94,117,0,0,0,6,3,9
2001,5605,20,3,23,1,6,7,0,0,0,0,0,0
2001,5606,28,2,30,2,9,11,0,0,0,0,0,0
2001,5608,119,9,128,15,41,56,0,0,0,0,0,0
2001,5609,116,6,122,14,45,59,0,0,0,0,0,0
2001,5622,10,2,12,0,4,4,0,0,0,0,0,0
2001,5700,61,10,71,3,16,19,2,0,2,60,48,108
2001,5701,46,6,52,4,24,28,0,0,0,0,0,0
2001,5702,9,0,9,0,0,0,0,0,0,0,0,0
2001,5703,53,6,59,4,15,19,0,0,0,0,0,0
2001,5704,54,6,60,3,21,24,0,0,0,0,0,0
2001,5797,36,10,46,12,28,40,0,0,0,0,0,0
2001,5800,52,4,56,7,21,28,49,20,69,6,4,10
2001,5801,21,0,21,2,14,16,0,0,0,0,0,0
2001,5802,6,1,7,0,0,0,0,0,0,0,0,0
2001,190C,14,5,19,1,5,6,0,0,0,0,0,0
2001,190P,17,3,20,0,2,2,0,0,0,0,0,0
2001,190R,8,1,9,5,5,10,0,0,0,0,0,0
2001,191E,7,3,10,0,2,2,0,0,0,0,0,0
2002,100,470,55,525,128,217,345,344,58,402,132,156,288
2002,101,95,9,104,10,36,46,0,0,0,4,5,9
2002,102,22,2,24,0,5,5,0,0,0,0,0,0
2002,103,148,32,180,22,73,95,1,0,1,7,10,17
2002,104,30,3,33,2,12,14,0,0,0,0,0,0
2002,105,177,22,199,17,84,101,0,0,0,8,8,16
2002,106,186,19,205,29,71,100,0,0,0,12,6,18
2002,107,84,9,93,5,38,43,0,0,0,0,0,0
2002,108,54,3,57,8,17,25,0,0,0,0,0,0
2002,109,718,92,810,70,256,326,4,0,4,68,24,92
2002,110,18,2,20,2,6,8,0,0,0,0,0,0
2002,111,73,8,81,5,15,20,0,0,0,0,0,0
2002,112,88,6,94,6,31,37,0,0,0,4,4,8
2002,113,65,9,74,6,44,50,0,0,0,0,0,0
2002,114,45,6,51,0,14,14,0,0,0,0,0,0
2002,115,11,2,13,7,5,12,0,0,0,0,0,0
2002,122,2,0,2,3,2,5,0,0,0,0,0,0
2002,130,39,7,46,1,7,8,0,0,0,0,0,0
2002,197,47,15,62,35,21,56,0,0,0,0,0,0
2002,200,13,1,14,1,3,4,0,0,0,0,0,0
2002,300,46,1,47,3,17,20,1,0,1,13,8,21
2002,302,7,0,7,0,1,1,0,0,0,0,0,0
2002,303,9,1,10,2,1,3,0,0,0,0,0,0
2002,305,7,0,7,0,1,1,0,0,0,0,0,0
2002,400,97,3,100,6,36,42,1,0,1,50,42,92
2002,402,76,9,85,10,44,54,0,0,0,0,0,0
2002,403,14,1,15,0,5,5,0,0,0,0,0,0
2002,404,20,2,22,0,8,8,0,0,0,0,0,0
2002,405,22,0,22,3,12,15,0,0,0,0,0,0
2002,497,9,3,12,0,5,5,0,0,0,0,0,0
2002,500,51,4,55,2,18,20,1,0,1,8,11,19
2002,501,8,0,8,1,0,1,0,0,0,0,0,0
2002,600,33,0,33,1,13,14,2,0,2,5,9,14
2002,601,6,1,7,0,1,1,0,0,0,0,0,0
2002,602,8,1,9,0,1,1,0,0,0,0,0,0
2002,700,398,51,449,93,188,281,184,37,221,67,62,129
2002,701,91,6,97,9,35,44,0,0,0,4,0,4
2002,702,35,7,42,2,11,13,0,0,0,0,0,0
2002,703,11,0,11,0,3,3,0,0,0,0,0,0
2002,704,135,22,157,12,45,57,0,0,0,5,0,5
2002,705,33,1,34,0,7,7,0,0,0,0,0,0
2002,706,19,2,21,3,0,3,0,0,0,0,0,0
2002,707,27,0,27,3,11,14,0,0,0,0,0,0
2002,708,75,3,78,6,26,32,0,0,0,0,0,0
2002,709,42,3,45,6,16,22,0,0,0,0,0,0
2002,710,179,19,198,17,56,73,0,0,0,4,6,10
2002,711,42,2,44,4,18,22,0,0,0,0,0,0
2002,712,70,8,78,5,28,33,0,0,0,0,0,0
2002,713,8,2,10,0,0,0,0,0,0,0,0,0
2002,714,38,1,39,3,10,13,0,0,0,0,0,0
2002,716,9,3,12,0,1,1,0,0,0,0,0,0
2002,718,160,20,180,40,38,78,0,0,0,0,0,0
2002,721,17,1,18,5,6,11,0,0,0,0,0,0
2002,800,25,2,27,1,4,5,4,0,4,9,7,16
2002,801,12,1,13,0,1,1,0,0,0,0,0,0
2002,900,169,8,177,7,59,66,2,0,2,72,55,127
2002,901,18,0,18,2,10,12,0,0,0,0,0,0
2002,902,45,4,49,3,15,18,0,0,0,0,0,0
2002,1000,403,40,443,53,155,208,36,3,39,285,110,395
2002,1001,77,9,86,10,35,45,0,0,0,1,0,1
2002,1002,18,0,18,3,3,6,0,0,0,0,0,0
2002,1003,11,1,12,0,4,4,0,0,0,0,0,0
2002,1004,7,0,7,0,1,1,0,0,0,0,0,0
2002,1005,611,77,688,89,269,358,0,0,0,0,0,0
2002,1006,8,0,8,1,3,4,0,0,0,0,0,0
2002,1007,16,0,16,0,3,3,0,0,0,0,0,0
2002,1008,14,1,15,1,4,5,0,0,0,0,0,0
2002,1011,13,1,14,0,2,2,0,0,0,0,0,0
2002,1012,25,2,27,2,12,14,0,0,0,0,0,0
2002,1013,21,1,22,3,8,11,0,0,0,0,0,0
2002,1015,26,1,27,1,12,13,0,0,0,0,0,0
2002,1017,11,0,11,1,2,3,0,0,0,0,0,0
2002,1097,11,4,15,2,8,10,0,0,0,0,0,0
2002,1100,25,2,27,4,12,16,2,0,2,8,13,21
2002,1101,9,1,10,0,1,1,0,0,0,0,0,0
2002,1102,9,2,11,0,3,3,0,0,0,0,0,0
2002,1200,77,7,84,2,33,35,0,0,0,75,40,115
2002,1201,25,1,26,5,7,12,0,0,0,0,0,0
2002,1202,1,1,2,0,0,0,0,0,0,0,0,0
2002,1203,39,5,44,7,24,31,0,0,0,0,0,0
2002,1204,4,1,5,0,0,0,0,0,0,0,0,0
2002,1205,14,2,16,0,0,0,0,0,0,0,0,0
2002,1206,3,0,3,0,0,0,0,0,0,0,0,0
2002,1207,5,1,6,0,0,0,0,0,0,0,0,0
2002,1208,9,2,11,0,6,6,0,0,0,0,0,0
2002,1300,99,5,104,8,34,42,65,18,83,16,31,47
2002,1301,29,2,31,0,13,13,0,0,0,0,0,0
2002,1302,43,2,45,4,12,16,0,0,0,0,0,0
2002,1303,6,0,6,0,1,1,0,0,0,0,0,0
2002,1304,48,2,50,4,18,22,0,0,0,0,0,0
2002,1305,8,0,8,0,3,3,0,0,0,0,0,0
2002,1306,11,1,12,0,1,1,0,0,0,0,0,0
2002,1307,4,0,4,0,0,0,0,0,0,0,0,0
2002,1400,29,0,29,1,10,11,9,1,10,9,11,20
2002,1401,14,0,14,1,5,6,0,0,0,0,0,0
2002,1500,428,39,467,57,205,262,36,5,41,214,132,346
2002,1501,9,1,10,4,4,8,0,0,0,0,0,0
2002,1502,298,18,316,13,110,123,0,0,0,0,0,0
2002,1503,42,3,45,2,14,16,0,0,0,4,0,4
2002,1506,30,2,32,0,13,13,0,0,0,0,0,0
2002,1507,17,1,18,2,4,6,0,0,0,0,0,0
2002,1508,10,0,10,2,8,10,0,0,0,0,0,0
2002,1511,12,2,14,1,5,6,0,0,0,0,0,0
2002,1514,3,0,3,0,0,0,0,0,0,0,0,0
2002,1515,7,0,7,3,3,6,0,0,0,0,0,0
2002,1597,9,1,10,1,3,4,0,0,0,0,0,0
2002,1600,78,4,82,6,35,41,0,0,0,42,38,80
2002,1601,18,1,19,2,7,9,0,0,0,0,0,0
2002,1602,40,3,43,0,18,18,0,0,0,0,0,0
2002,1603,20,5,25,1,6,7,0,0,0,0,0,0
2002,1606,54,3,57,24,3,27,0,0,0,0,0,0
2002,1700,58,3,61,1,20,21,0,0,0,46,31,77
2002,1701,13,0,13,2,2,4,0,0,0,0,0,0
2002,1702,24,0,24,1,8,9,0,0,0,0,0,0
2002,1800,31,0,31,1,7,8,25,15,40,4,10,14
2002,1801,17,3,20,0,3,3,0,0,0,0,0,0
2002,1900,5728,933,6661,1321,2233,3554,1883,445,2328,923,1483,2406
2002,1901,77,6,83,8,40,48,0,0,0,0,0,0
2002,1902,66,9,75,7,24,31,0,0,0,1,3,4
2002,1905,58,2,60,1,23,24,0,0,0,0,0,0
2002,1906,69,6,75,0,22,22,0,0,0,6,1,7
2002,1907,36,1,37,1,8,9,0,0,0,0,0,0
2002,1909,45,3,48,4,15,19,0,0,0,0,0,0
2002,1910,131,10,141,17,46,63,0,0,0,3,7,10
2002,1912,156,11,167,20,56,76,0,0,0,8,3,11
2002,1913,38,4,42,1,13,14,0,0,0,4,1,5
2002,1916,56,2,58,6,22,28,0,0,0,3,0,3
2002,1918,118,6,124,18,26,44,0,0,0,5,1,6
2002,1920,101,8,109,11,37,48,0,0,0,0,0,0
2002,1922,146,10,156,17,34,51,0,0,0,5,4,9
2002,1923,60,5,65,4,21,25,0,0,0,5,1,6
2002,1924,77,6,83,1,14,15,0,0,0,1,6,7
2002,1925,209,28,237,32,67,99,0,0,0,10,9,19
2002,1926,48,10,58,5,22,27,0,0,0,2,2,4
2002,1928,90,6,96,3,24,27,0,0,0,5,9,14
2002,1929,36,2,38,0,4,4,0,0,0,1,6,7
2002,1931,72,1,73,14,18,32,0,0,0,4,1,5
2002,1933,170,18,188,11,40,51,0,0,0,3,8,11
2002,1934,23,1,24,0,7,7,0,0,0,0,0,0
2002,1938,46,1,47,4,13,17,0,0,0,0,0,0
2002,1941,767,84,851,168,260,428,14,4,18,43,26,69
2002,1942,7327,1707,9034,833,1949,2782,17,5,22,227,113,340
2002,1944,54,6,60,10,14,24,5,1,6,0,0,0
2002,1945,28,0,28,1,6,7,4,0,4,0,4,4
2002,1946,53,5,58,4,17,21,0,0,0,2,2,4
2002,1947,76,8,84,8,29,37,0,0,0,8,0,8
2002,1948,63,11,74,35,74,109,0,0,0,3,2,5
2002,1951,21,3,24,0,3,3,0,0,0,3,3,6
2002,1953,211,36,247,41,79,120,1,0,1,11,8,19
2002,1955,173,7,180,79,60,139,1,0,1,12,7,19
2002,1956,98,7,105,5,38,43,0,0,0,1,8,9
2002,1961,36,2,38,1,8,9,0,0,0,5,2,7
2002,1962,48,4,52,4,11,15,0,0,0,0,0,0
2002,1963,23,4,27,2,7,9,0,0,0,0,0,0
2002,1965,182,25,207,80,101,181,0,0,0,5,6,11
2002,1966,17,1,18,0,4,4,0,0,0,0,0,0
2002,1967,20,4,24,1,6,7,0,0,0,5,3,8
2002,1969,80,3,83,3,28,31,0,0,0,4,2,6
2002,1970,34,1,35,4,7,11,0,0,0,0,0,0
2002,1972,226,7,233,33,77,110,1,0,1,7,8,15
2002,1973,54,4,58,0,19,19,0,0,0,4,0,4
2002,1975,110,6,116,13,25,38,0,0,0,5,1,6
2002,1976,123,6,129,25,45,70,0,0,0,0,0,0
2002,1978,12,0,12,1,8,9,0,0,0,0,0,0
2002,1981,9,2,11,10,2,12,0,0,0,0,0,0
2002,1982,19,5,24,5,2,7,0,0,0,0,0,0
2002,1983,15,2,17,2,8,10,0,0,0,0,0,0
2002,1984,17,3,20,3,7,10,0,0,0,0,0,0
2002,1997,39,6,45,19,20,39,0,0,0,0,0,0
2002,2000,70,7,77,6,24,30,0,0,0,0,0,0
2002,2001,17,0,17,1,6,7,0,0,0,0,0,0
2002,2002,46,3,49,2,12,14,0,0,0,0,0,0
2002,2100,109,13,122,21,52,73,59,17,76,8,11,19
2002,2101,7,0,7,0,1,1,0,0,0,0,0,0
2002,2103,10,2,12,0,5,5,0,0,0,0,0,0
2002,2104,33,1,34,2,9,11,0,0,0,0,0,0
2002,2105,17,2,19,2,4,6,0,0,0,0,0,0
2002,2106,48,11,59,1,22,23,0,0,0,0,0,0
2002,2107,5,1,6,1,0,1,0,0,0,0,0,0
2002,2108,19,0,19,7,0,7,0,0,0,0,0,0
2002,2109,69,9,78,21,7,28,0,0,0,0,0,0
2002,2110,19,3,22,1,4,5,0,0,0,0,0,0
2002,2111,12,2,14,0,3,3,0,0,0,0,0,0
2002,2113,5,0,5,1,1,2,0,0,0,0,0,0
2002,2200,35,4,39,3,10,13,7,7,14,0,0,0
2002,2300,76,1,77,4,24,28,40,13,53,1,6,7
2002,2301,12,2,14,1,5,6,0,0,0,0,0,0
2002,2303,27,1,28,1,8,9,0,0,0,0,0,0
2002,2304,15,0,15,2,5,7,0,0,0,2,0,2
2002,2400,86,1,87,11,27,38,0,0,0,0,0,0
2002,2401,31,0,31,4,6,10,0,0,0,0,0,0
2002,2402,7,1,8,0,0,0,0,0,0,0,0,0
2002,2403,10,0,10,0,1,1,0,0,0,0,0,0
2002,2404,17,1,18,0,5,5,0,0,0,0,0,0
2002,2405,29,3,32,7,12,19,0,0,0,0,0,0
2002,2406,75,1,76,7,22,29,0,0,0,0,0,0
2002,2500,15,1,16,0,0,0,0,0,0,7,4,11
2002,2501,10,0,10,0,1,1,0,0,0,0,0,0
2002,2600,24,1,25,2,3,5,0,0,0,11,6,17
2002,2601,15,2,17,2,3,5,0,0,0,0,0,0
2002,2700,160,12,172,14,64,78,132,40,172,16,23,39
2002,2701,14,0,14,3,5,8,0,0,0,0,0,0
2002,2702,6,0,6,0,0,0,0,0,0,0,0,0
2002,2703,12,1,13,0,1,1,0,0,0,0,0,0
2002,2704,17,0,17,0,3,3,0,0,0,0,0,0
2002,2705,15,1,16,2,2,4,0,0,0,0,0,0
2002,2706,0,0,0,0,0,0,0,0,0,6,6,12
2002,2707,25,3,28,3,6,9,0,0,0,0,0,0
2002,2708,148,11,159,17,39,56,0,0,0,0,0,0
2002,2709,8,1,9,0,1,1,0,0,0,0,0,0
2002,2710,36,5,41,3,9,12,0,0,0,0,0,0
2002,2711,15,1,16,0,0,0,0,0,0,0,0,0
2002,2712,30,2,32,2,5,7,0,0,0,0,0,0
2002,2714,5,0,5,0,0,0,0,0,0,0,0,0
2002,2719,12,1,13,2,3,5,0,0,0,0,0,0
2002,2800,80,4,84,9,22,31,0,0,0,0,0,0
2002,2801,8,2,10,0,0,0,0,0,0,0,0,0
2002,2802,67,8,75,6,38,44,0,0,0,0,0,0
2002,2803,12,1,13,0,6,6,0,0,0,0,0,0
2002,2808,76,15,91,2,4,6,0,0,0,0,0,0
2002,2900,66,2,68,8,44,52,3,0,3,47,24,71
2002,2901,22,0,22,4,6,10,0,0,0,0,0,0
2002,2902,9,0,9,0,1,1,0,0,0,0,0,0
2002,3000,939,124,1063,609,670,1279,701,97,798,276,173,449
2002,3001,348,33,381,10,185,195,11,8,19,0,6,6
2002,3002,95,11,106,0,23,23,0,0,0,1,0,1
2002,3003,88,6,94,4,42,46,0,0,0,4,1,5
2002,3004,150,8,158,9,56,65,1,0,1,7,2,9
2002,3005,54,3,57,5,13,18,0,0,0,0,0,0
2002,3006,22,4,26,1,8,9,0,0,0,0,0,0
2002,3007,57,7,64,1,22,23,0,0,0,0,0,0
2002,3008,140,11,151,11,55,66,0,0,0,5,0,5
2002,3009,156,9,165,26,47,73,0,0,0,0,0,0
2002,3010,210,11,221,42,90,132,1,0,1,9,8,17
2002,3011,43,7,50,2,34,36,0,0,0,0,0,0
2002,3012,59,5,64,15,29,44,0,0,0,0,0,0
2002,3013,19,5,24,0,3,3,0,0,0,0,0,0
2002,3014,142,6,148,26,51,77,0,0,0,7,2,9
2002,3015,140,13,153,14,57,71,0,0,0,0,0,0
2002,3016,53,2,55,2,14,16,0,0,0,0,0,0
2002,3019,335,18,353,40,151,191,0,0,0,52,73,125
2002,3020,30,3,33,1,8,9,0,0,0,0,0,0
2002,3022,86,6,92,7,33,40,0,0,0,0,0,0
2002,3024,96,3,99,5,0,5,0,0,0,2,37,39
2002,3026,120,22,142,17,53,70,0,0,0,0,0,0
2002,3027,16,4,20,1,7,8,0,0,0,0,0,0
2002,3034,7,3,10,0,2,2,0,0,0,0,0,0
2002,3097,18,3,21,4,4,8,0,0,0,0,0,0
2002,3100,154,17,171,17,84,101,46,8,54,45,44,89
2002,3101,23,1,24,2,8,10,0,0,0,0,0,0
2002,3103,22,1,23,2,2,4,0,0,0,0,0,0
2002,3104,42,1,43,4,16,20,0,0,0,0,0,0
2002,3105,82,7,89,10,42,52,0,0,0,5,4,9
2002,3200,41,0,41,0,14,14,0,0,0,10,9,19
2002,3300,1058,116,1174,150,564,714,213,30,243,430,240,670
2002,3301,33,1,34,0,14,14,0,0,0,0,0,0
2002,3302,23,0,23,0,7,7,0,0,0,0,0,0
2002,3303,22,2,24,4,8,12,0,0,0,0,0,0
2002,3306,16,1,17,1,4,5,0,0,0,0,0,0
2002,3308,63,4,67,5,24,29,0,0,0,0,0,0
2002,3309,50,2,52,9,20,29,0,0,0,0,0,0
2002,3311,73,6,79,17,31,48,0,0,0,2,4,6
2002,3313,328,30,358,23,145,168,0,0,0,0,0,0
2002,3314,24,0,24,4,5,9,0,0,0,0,0,0
2002,3315,137,16,153,15,68,83,0,0,0,0,0,0
2002,3325,49,3,52,12,18,30,0,0,0,0,0,0
2002,3342,44,2,46,3,15,18,0,0,0,0,0,0
2002,3344,13,4,17,2,5,7,0,0,0,0,0,0
2002,3397,22,1,23,2,6,8,0,0,0,0,0,0
2002,3400,916,192,1108,130,261,391,323,192,515,80,125,205
2002,3401,52,6,58,0,23,23,0,0,0,0,0,0
2002,3402,21,2,23,1,10,11,0,0,0,0,0,0
2002,3403,3,0,3,0,0,0,0,0,0,0,0,0
2002,3404,589,91,680,109,266,375,0,0,0,0,0,0
2002,3408,15,1,16,1,5,6,0,0,0,0,0,0
2002,3414,19,1,20,0,3,3,0,0,0,0,0,0
2002,3420,3,0,3,0,1,1,0,0,0,0,0,0
2002,3422,567,146,713,22,56,78,0,0,0,0,0,0
2002,3499,6245,602,6847,1544,1926,3470,0,0,0,0,0,0
2002,3500,29,3,32,0,7,7,0,0,0,0,0,0
2002,3501,29,5,34,1,6,7,0,0,0,0,0,0
2002,3600,998,131,1129,183,526,709,349,80,429,134,332,466
2002,3601,30,1,31,4,16,20,0,0,0,0,0,0
2002,3602,83,8,91,0,28,28,0,0,0,0,0,0
2002,3603,58,3,61,7,21,28,0,0,0,0,0,0
2002,3604,130,11,141,9,52,61,0,0,0,0,0,0
2002,3605,50,3,53,4,22,26,0,0,0,0,0,0
2002,3607,201,13,214,16,94,110,0,0,0,0,0,0
2002,3608,70,9,79,17,49,66,0,0,0,0,0,0
2002,3609,83,13,96,6,32,38,0,0,0,0,0,0
2002,3610,258,21,279,32,119,151,0,0,0,0,0,0
2002,3611,76,4,80,7,33,40,0,0,0,0,0,0
2002,3614,14,0,14,2,6,8,0,0,0,0,0,0
2002,3623,20,2,22,32,21,53,0,0,0,0,0,0
2002,3639,3,1,4,0,4,4,0,0,0,0,0,0
2002,3650,9,4,13,3,6,9,0,0,0,0,0,0
2002,3700,1319,373,1692,265,440,705,660,141,801,283,470,753
2002,3701,96,10,106,4,34,38,0,0,0,0,0,0
2002,3702,201,25,226,24,78,102,0,0,0,2,2,4
2002,3703,37,4,41,3,12,15,0,0,0,0,0,0
2002,3705,131,8,139,15,55,70,0,0,0,0,0,0
2002,3706,140,21,161,14,52,66,0,0,0,0,0,0
2002,3708,59,5,64,4,22,26,0,0,0,0,0,0
2002,3709,76,3,79,6,30,36,0,0,0,0,0,0
2002,3710,158,20,178,17,68,85,0,0,0,0,0,0
2002,3711,1818,305,2123,276,514,790,0,0,0,0,0,0
2002,3714,28,2,30,0,7,7,0,0,0,0,0,0
2002,3715,109,18,127,6,14,20,0,0,0,0,0,0
2002,3732,8,1,9,3,2,5,0,0,0,0,0,0
2002,3797,24,4,28,15,8,23,0,0,0,0,0,0
2002,3800,231,57,288,43,57,100,429,113,542,27,8,35
2002,3801,1908,366,2274,162,225,387,0,0,0,0,0,0
2002,3803,15,4,19,11,11,22,0,0,0,0,0,0
2002,3816,0,0,0,9,1,10,0,0,0,0,0,0
2002,3897,24,7,31,4,13,17,0,0,0,0,0,0
2002,3900,238,34,272,22,98,120,25,4,29,145,152,297
2002,3901,7,0,7,0,3,3,0,0,0,0,0,0
2002,3902,71,7,78,1,16,17,0,0,0,1,17,18
2002,3903,60,4,64,7,20,27,0,0,0,0,0,0
2002,3904,17,2,19,0,8,8,0,0,0,0,0,0
2002,3905,345,39,384,49,137,186,0,0,0,0,0,0
2002,3906,66,6,72,10,31,41,0,0,0,0,0,0
2002,3915,14,4,18,0,0,0,0,0,0,0,0,0
2002,4000,152,6,158,9,50,59,1,0,1,100,59,159
2002,4001,24,2,26,2,8,10,0,0,0,0,0,0
2002,4002,13,4,17,2,7,9,0,0,0,0,0,0
2002,4003,19,2,21,1,7,8,0,0,0,0,0,0
2002,4004,33,3,36,1,8,9,0,0,0,0,0,0
2002,4005,20,3,23,1,8,9,0,0,0,0,0,0
2002,4006,53,7,60,5,21,26,0,0,0,0,0,0
2002,4007,13,3,16,4,15,19,0,0,0,0,0,0
2002,4008,26,4,30,1,8,9,0,0,0,0,0,0
2002,4016,87,35,122,3,10,13,0,0,0,0,0,0
2002,4019,5,1,6,0,2,2,0,0,0,0,0,0
2002,4100,193,28,221,37,69,106,165,40,205,19,38,57
2002,4101,20,2,22,1,5,6,0,0,0,0,0,0
2002,4102,27,3,30,7,8,15,0,0,0,0,0,0
2002,4103,11,6,17,0,3,3,0,0,0,0,0,0
2002,4104,43,7,50,6,15,21,0,0,0,0,0,0
2002,4105,17,1,18,0,5,5,0,0,0,0,0,0
2002,4106,103,11,114,9,28,37,0,0,0,0,0,0
2002,4107,17,1,18,1,4,5,0,0,0,0,0,0
2002,4108,21,3,24,0,8,8,0,0,0,0,0,0
2002,4109,43,11,54,7,15,22,0,0,0,0,0,0
2002,4110,25,2,27,2,11,13,0,0,0,0,0,0
2002,4111,40,2,42,3,8,11,0,0,0,0,0,0
2002,4113,84,16,100,6,34,40,0,0,0,0,0,0
2002,4114,49,3,52,0,0,0,0,0,0,1,17,18
2002,4115,24,7,31,3,12,15,0,0,0,0,0,0
2002,4116,102,11,113,5,40,45,0,0,0,0,0,0
2002,4117,76,7,83,6,25,31,0,0,0,0,0,0
2002,4119,11,1,12,0,1,1,0,0,0,0,0,0
2002,4120,34,6,40,6,13,19,0,0,0,0,0,0
2002,4127,30,2,32,6,9,15,0,0,0,0,0,0
2002,4200,273,17,290,21,96,117,124,55,179,32,41,73
2002,4201,11,1,12,0,3,3,0,0,0,0,0,0
2002,4202,43,4,47,1,7,8,0,0,0,6,7,13
2002,4203,136,8,144,21,57,78,0,0,0,0,0,0
2002,4204,85,10,95,2,36,38,0,0,0,0,0,0
2002,4211,4,1,5,0,1,1,0,0,0,0,0,0
2002,4297,26,4,30,4,8,12,0,0,0,0,0,0
2002,4300,430,58,488,69,121,190,55,15,70,0,2,2
2002,4302,41,3,44,3,18,21,0,0,0,0,0,0
2002,4304,48,5,53,7,30,37,0,0,0,3,2,5
2002,4305,29,1,30,5,10,15,0,0,0,0,0,0
2002,4307,42,4,46,3,16,19,0,0,0,0,0,0
2002,4308,81,10,91,4,25,29,0,0,0,0,0,0
2002,4310,27,5,32,3,13,16,0,0,0,0,0,0
2002,4311,85,10,95,9,26,35,0,0,0,0,0,0
2002,4312,77,24,101,24,49,73,0,0,0,0,0,0
2002,4313,1251,127,1378,132,309,441,0,0,0,0,0,0
2002,4314,138,10,148,6,40,46,0,0,0,2,4,6
2002,4316,225,12,237,4,13,17,5,1,6,0,0,0
2002,4317,28,6,34,16,15,31,0,0,0,0,0,0
2002,4320,5,0,5,1,2,3,0,0,0,0,0,0
2002,4321,7,2,9,1,1,2,0,0,0,0,0,0
2002,4324,8,0,8,0,0,0,0,0,0,0,0,0
2002,4327,11,0,11,5,2,7,0,0,0,0,0,0
2002,4400,108,19,127,0,40,40,5,0,5,80,20,100
2002,4401,21,0,21,6,5,11,0,0,0,0,0,0
2002,4402,86,9,95,6,26,32,0,0,0,0,0,0
2002,4403,57,4,61,4,15,19,0,0,0,0,0,0
2002,4404,19,1,20,0,8,8,0,0,0,0,0,0
2002,4497,14,4,18,9,14,23,0,0,0,0,0,0
2002,4500,79,12,91,5,50,55,48,16,64,21,13,34
2002,4501,15,1,16,0,10,10,0,0,0,0,0,0
2002,4502,106,5,111,11,40,51,0,0,0,0,0,0
2002,4600,10,1,11,0,0,0,0,0,0,2,4,6
2002,4700,58,0,58,6,19,25,2,0,2,31,15,46
2002,4703,2,0,2,0,1,1,0,0,0,0,0,0
2002,4706,9,0,9,2,5,7,0,0,0,0,0,0
2002,4707,2,0,2,0,2,2,0,0,0,0,0,0
2002,4708,9,1,10,2,4,6,0,0,0,0,0,0
2002,4709,16,0,16,4,4,8,0,0,0,0,0,0
2002,4710,4,0,4,0,1,1,0,0,0,0,0,0
2002,4800,102,7,109,13,69,82,1,0,1,178,92,270
2002,4801,34,1,35,2,12,14,0,0,0,0,0,0
2002,4802,20,2,22,0,4,4,0,0,0,0,0,0
2002,4803,99,8,107,8,49,57,0,0,0,0,0,0
2002,4804,1,0,1,0,1,1,0,0,0,0,0,0
2002,4805,24,4,28,1,9,10,0,0,0,0,0,0
2002,4806,99,8,107,9,53,62,0,0,0,0,0,0
2002,4807,149,9,158,9,63,72,0,0,0,0,0,0
2002,4900,226,18,244,17,76,93,1,0,1,213,114,327
2002,4901,11,1,12,2,5,7,0,0,0,0,0,0
2002,4902,13,0,13,1,6,7,0,0,0,0,0,0
2002,4903,13,3,16,2,8,10,0,0,0,0,0,0
2002,4904,65,2,67,5,29,34,0,0,0,0,0,0
2002,4905,159,15,174,18,70,88,0,0,0,0,0,0
2002,4906,14,2,16,1,6,7,0,0,0,0,0,0
2002,4907,11,3,14,2,6,8,0,0,0,0,0,0
2002,4908,55,11,66,0,0,0,0,0,0,0,0,0
2002,4909,8,4,12,1,4,5,0,0,0,0,0,0
2002,4913,9,1,10,0,2,2,0,0,0,0,0,0
2002,4914,11,1,12,2,5,7,0,0,0,0,0,0
2002,5000,228,8,236,9,63,72,160,43,203,5,38,43
2002,5001,37,3,40,2,14,16,0,0,0,0,0,0
2002,5002,238,12,250,13,90,103,0,0,0,0,0,0
2002,5003,12,0,12,0,3,3,0,0,0,0,0,0
2002,5004,23,3,26,1,2,3,0,0,0,0,0,0
2002,5005,13,0,13,0,2,2,0,0,0,0,0,0
2002,5007,56,3,59,1,26,27,0,0,0,0,0,0
2002,5009,4,0,4,0,1,1,0,0,0,0,0,0
2002,5010,10,0,10,5,6,11,0,0,0,0,0,0
2002,5100,47,4,51,4,22,26,0,0,0,0,0,0
2002,5102,41,4,45,8,19,27,0,0,0,0,0,0
2002,5200,44,4,48,2,19,21,28,7,35,1,7,8
2002,5201,14,1,15,1,7,8,0,0,0,0,0,0
2002,5202,25,1,26,2,11,13,0,0,0,0,0,0
2002,5300,25,1,26,1,6,7,0,0,0,0,0,0
2002,5400,210,20,230,24,62,86,189,28,217,40,36,76
2002,5401,23,0,23,2,6,8,0,0,0,0,0,0
2002,5402,14,2,16,0,2,2,0,0,0,0,0,0
2002,5403,12,2,14,0,1,1,0,0,0,0,0,0
2002,5404,14,3,17,5,5,10,0,0,0,0,0,0
2002,5405,36,5,41,2,19,21,0,0,0,0,0,0
2002,5406,43,7,50,7,17,24,0,0,0,0,0,0
2002,5407,101,10,111,7,44,51,0,0,0,0,0,0
2002,5408,13,0,13,0,2,2,0,0,0,0,0,0
2002,5411,4,2,6,0,1,1,0,0,0,0,0,0
2002,5500,64,2,66,2,21,23,1,0,1,21,20,41
2002,5501,12,1,13,0,4,4,0,0,0,0,0,0
2002,5600,475,58,533,91,214,305,234,40,274,149,125,274
2002,5604,184,25,209,35,64,99,0,0,0,0,0,0
2002,5605,21,2,23,0,0,0,0,0,0,0,0,0
2002,5606,30,2,32,1,9,10,0,0,0,0,0,0
2002,5608,118,7,125,18,52,70,0,0,0,0,0,0
2002,5609,115,7,122,15,48,63,0,0,0,0,0,0
2002,5622,11,1,12,0,6,6,0,0,0,0,0,0
2002,5700,60,9,69,9,26,35,1,0,1,61,48,109
2002,5701,47,6,53,6,29,35,0,0,0,0,0,0
2002,5702,10,0,10,0,1,1,0,0,0,0,0,0
2002,5703,62,3,65,4,17,21,0,0,0,0,0,0
2002,5704,52,5,57,3,27,30,0,0,0,0,0,0
2002,5797,36,9,45,18,29,47,0,0,0,0,0,0
2002,5800,53,8,61,7,23,30,0,0,0,0,0,0
2002,5801,23,0,23,3,10,13,0,0,0,0,0,0
2002,5802,7,1,8,0,0,0,0,0,0,0,0,0
2002,190C,13,3,16,1,5,6,0,0,0,0,0,0
2002,190P,11,2,13,1,0,1,0,0,0,0,0,0
2002,190R,8,1,9,5,4,9,0,0,0,0,0,0
2002,191E,6,1,7,0,1,1,0,0,0,0,0,0
2003,100,437,56,493,115,211,326,382,61,443,98,146,244
2003,101,92,10,102,11,38,49,0,0,0,4,6,10
2003,102,27,1,28,0,7,7,0,0,0,0,0,0
2003,103,150,36,186,19,70,89,1,0,1,7,8,15
2003,104,33,2,35,3,12,15,0,0,0,0,0,0
2003,105,166,19,185,9,81,90,1,0,1,8,8,16
2003,106,180,22,202,29,74,103,0,0,0,15,7,22
2003,107,85,8,93,7,45,52,0,0,0,0,0,0
2003,108,54,3,57,8,18,26,0,0,0,0,0,0
2003,109,707,81,788,75,254,329,4,0,4,65,26,91
2003,110,18,2,20,2,6,8,0,0,0,0,0,0
2003,111,74,8,82,4,31,35,0,0,0,0,0,0
2003,112,90,5,95,6,28,34,0,0,0,5,3,8
2003,113,65,8,73,2,27,29,0,0,0,0,0,0
2003,114,56,4,60,7,24,31,0,0,0,0,0,0
2003,115,12,2,14,8,5,13,0,0,0,0,0,0
2003,122,2,0,2,4,3,7,0,0,0,0,0,0
2003,197,50,14,64,31,29,60,0,0,0,0,0,0
2003,200,10,1,11,0,3,3,0,0,0,0,0,0
2003,300,47,0,47,2,21,23,1,0,1,12,7,19
2003,302,6,0,6,0,1,1,0,0,0,0,0,0
2003,303,8,1,9,1,2,3,0,0,0,0,0,0
2003,305,7,0,7,0,0,0,0,0,0,0,0,0
2003,400,102,3,105,5,42,47,1,0,1,58,45,103
2003,402,76,9,85,10,44,54,0,0,0,0,0,0
2003,403,14,1,15,0,6,6,0,0,0,0,0,0
2003,404,23,2,25,0,10,10,0,0,0,0,0,0
2003,405,25,0,25,3,12,15,0,0,0,0,0,0
2003,497,8,3,11,0,6,6,0,0,0,0,0,0
2003,500,49,5,54,4,17,21,1,0,1,10,9,19
2003,501,8,0,8,0,1,1,0,0,0,0,0,0
2003,600,29,0,29,0,14,14,3,0,3,6,8,14
2003,601,8,0,8,0,1,1,0,0,0,0,0,0
2003,602,8,1,9,0,1,1,0,0,0,0,0,0
2003,700,397,51,448,72,173,245,216,46,262,44,61,105
2003,701,98,6,104,10,52,62,0,0,0,2,1,3
2003,702,37,7,44,1,12,13,0,0,0,0,0,0
2003,703,11,0,11,0,3,3,0,0,0,0,0,0
2003,704,135,26,161,12,42,54,0,0,0,5,0,5
2003,705,35,1,36,1,6,7,0,0,0,0,0,0
2003,706,18,2,20,1,2,3,0,0,0,0,0,0
2003,707,26,1,27,2,11,13,0,0,0,0,0,0
2003,708,66,3,69,2,20,22,0,0,0,2,5,7
2003,709,42,5,47,3,18,21,0,0,0,0,0,0
2003,710,166,18,184,14,67,81,0,0,0,3,7,10
2003,711,43,2,45,4,10,14,0,0,0,0,0,0
2003,712,71,9,80,4,29,33,0,0,0,0,0,0
2003,713,8,2,10,0,1,1,0,0,0,0,0,0
2003,714,38,1,39,4,12,16,0,0,0,0,0,0
2003,716,10,3,13,0,1,1,0,0,0,0,0,0
2003,718,170,22,192,44,43,87,0,0,0,0,0,0
2003,721,18,1,19,5,6,11,0,0,0,0,0,0
2003,800,24,2,26,1,7,8,3,0,3,12,7,19
2003,801,12,1,13,0,1,1,0,0,0,0,0,0
2003,900,160,8,168,9,80,89,2,0,2,68,57,125
2003,901,17,0,17,2,11,13,0,0,0,0,0,0
2003,902,41,5,46,4,14,18,0,0,0,0,0,0
2003,1000,424,34,458,51,175,226,7,2,9,274,109,383
2003,1001,75,11,86,6,33,39,0,0,0,2,1,3
2003,1002,16,1,17,4,2,6,0,0,0,0,0,0
2003,1003,9,2,11,1,4,5,0,0,0,0,0,0
2003,1004,6,0,6,0,1,1,0,0,0,0,0,0
2003,1005,622,85,707,101,261,362,0,0,0,0,0,0
2003,1006,9,0,9,1,3,4,0,0,0,0,0,0
2003,1007,16,0,16,0,3,3,0,0,0,0,0,0
2003,1008,14,1,15,1,5,6,0,0,0,0,0,0
2003,1011,10,1,11,0,2,2,0,0,0,0,0,0
2003,1012,25,2,27,2,11,13,0,0,0,0,0,0
2003,1013,23,2,25,3,6,9,0,0,0,0,0,0
2003,1015,24,2,26,1,13,14,0,0,0,0,0,0
2003,1017,12,1,13,1,2,3,0,0,0,0,0,0
2003,1097,12,4,16,1,9,10,0,0,0,0,0,0
2003,1100,25,2,27,4,10,14,2,0,2,11,12,23
2003,1101,9,1,10,0,1,1,0,0,0,0,0,0
2003,1102,9,2,11,1,2,3,0,0,0,0,0,0
2003,1200,78,7,85,2,31,33,72,32,104,5,9,14
2003,1201,23,1,24,5,7,12,0,0,0,0,0,0
2003,1202,4,1,5,4,2,6,0,0,0,0,0,0
2003,1203,40,7,47,7,21,28,0,0,0,0,0,0
2003,1204,4,1,5,0,0,0,0,0,0,0,0,0
2003,1205,13,1,14,2,5,7,0,0,0,0,0,0
2003,1206,3,0,3,0,0,0,0,0,0,0,0,0
2003,1207,4,1,5,0,0,0,0,0,0,0,0,0
2003,1208,9,3,12,1,7,8,0,0,0,0,0,0
2003,1300,88,5,93,11,40,51,63,17,80,11,24,35
2003,1301,30,2,32,0,13,13,0,0,0,0,0,0
2003,1302,41,2,43,3,17,20,0,0,0,0,0,0
2003,1303,6,0,6,0,1,1,0,0,0,0,0,0
2003,1304,46,2,48,4,15,19,0,0,0,0,0,0
2003,1305,7,0,7,0,2,2,0,0,0,0,0,0
2003,1306,13,1,14,1,1,2,0,0,0,0,0,0
2003,1307,5,0,5,0,0,0,0,0,0,0,0,0
2003,1400,30,0,30,0,11,11,20,8,28,1,3,4
2003,1401,14,0,14,2,4,6,0,0,0,0,0,0
2003,1500,330,26,356,51,165,216,106,12,118,219,154,373
2003,1501,9,1,10,3,3,6,0,0,0,0,0,0
2003,1502,300,17,317,13,105,118,0,0,0,0,0,0
2003,1503,37,3,40,1,12,13,0,0,0,4,0,4
2003,1506,27,3,30,1,11,12,0,0,0,0,0,0
2003,1507,18,1,19,2,5,7,0,0,0,0,0,0
2003,1508,12,0,12,0,6,6,0,0,0,0,0,0
2003,1511,11,2,13,1,4,5,0,0,0,0,0,0
2003,1514,3,0,3,0,0,0,0,0,0,0,0,0
2003,1515,7,0,7,3,2,5,0,0,0,0,0,0
2003,1597,7,3,10,1,3,4,0,0,0,0,0,0
2003,1600,71,3,74,7,35,42,0,0,0,40,37,77
2003,1601,15,1,16,1,7,8,0,0,0,0,0,0
2003,1602,42,3,45,0,18,18,0,0,0,0,0,0
2003,1603,23,5,28,1,6,7,0,0,0,0,0,0
2003,1700,59,2,61,4,17,21,0,0,0,36,32,68
2003,1701,14,0,14,0,2,2,0,0,0,0,0,0
2003,1702,22,0,22,1,9,10,0,0,0,0,0,0
2003,1800,31,0,31,2,7,9,25,18,43,4,9,13
2003,1801,17,2,19,0,3,3,0,0,0,0,0,0
2003,1900,5550,903,6453,1330,2216,3546,1714,414,2128,882,1452,2334
2003,1901,77,7,84,7,41,48,0,0,0,0,0,0
2003,1902,62,7,69,10,25,35,0,0,0,1,4,5
2003,1905,59,2,61,1,23,24,0,0,0,0,0,0
2003,1906,73,5,78,1,25,26,0,0,0,6,1,7
2003,1907,37,1,38,1,11,12,0,0,0,0,0,0
2003,1909,51,3,54,7,19,26,0,0,0,0,0,0
2003,1910,127,10,137,44,21,65,0,0,0,0,0,0
2003,1912,148,11,159,18,61,79,0,0,0,7,4,11
2003,1913,37,4,41,2,15,17,0,0,0,4,1,5
2003,1916,54,2,56,4,22,26,0,0,0,4,0,4
2003,1918,112,7,119,23,25,48,0,0,0,2,0,2
2003,1920,100,9,109,12,36,48,0,0,0,0,0,0
2003,1922,141,8,149,14,36,50,0,0,0,5,4,9
2003,1923,62,4,66,5,24,29,0,0,0,5,1,6
2003,1924,77,6,83,0,13,13,0,0,0,3,5,8
2003,1925,218,26,244,20,65,85,1,0,1,11,8,19
2003,1926,47,9,56,4,23,27,0,0,0,2,2,4
2003,1928,95,6,101,15,36,51,0,0,0,5,4,9
2003,1929,34,3,37,9,7,16,0,0,0,2,6,8
2003,1931,66,2,68,16,19,35,4,1,5,0,0,0
2003,1933,178,22,200,20,59,79,0,0,0,2,8,10
2003,1934,24,1,25,0,8,8,0,0,0,0,0,0
2003,1938,42,3,45,4,13,17,0,0,0,0,0,0
2003,1941,808,87,895,178,265,443,18,3,21,49,30,79
2003,1942,7508,1738,9246,1957,843,2800,14,5,19,221,108,329
2003,1944,52,6,58,15,15,30,0,0,0,4,1,5
2003,1945,31,0,31,0,6,6,0,0,0,4,0,4
2003,1946,51,5,56,5,18,23,0,0,0,1,2,3
2003,1947,76,7,83,4,30,34,0,0,0,6,1,7
2003,1948,64,10,74,4,25,29,0,0,0,3,2,5
2003,1951,21,3,24,2,4,6,0,0,0,2,2,4
2003,1953,206,34,240,46,75,121,1,0,1,10,9,19
2003,1955,165,9,174,20,101,121,1,0,1,11,8,19
2003,1956,95,6,101,3,36,39,0,0,0,3,6,9
2003,1961,33,4,37,2,8,10,0,0,0,4,2,6
2003,1962,49,4,53,4,10,14,0,0,0,0,0,0
2003,1963,21,7,28,2,4,6,0,0,0,0,0,0
2003,1965,180,25,205,104,135,239,5,6,11,0,0,0
2003,1966,16,1,17,0,6,6,0,0,0,0,0,0
2003,1967,26,3,29,5,7,12,0,0,0,0,0,0
2003,1969,76,3,79,6,27,33,0,0,0,4,1,5
2003,1970,33,1,34,5,7,12,0,0,0,0,0,0
2003,1972,228,8,236,29,55,84,1,0,1,7,7,14
2003,1973,55,3,58,0,17,17,0,0,0,6,0,6
2003,1975,113,7,120,9,28,37,0,0,0,6,1,7
2003,1976,123,6,129,9,61,70,0,0,0,0,0,0
2003,1978,14,1,15,3,8,11,0,0,0,0,0,0
2003,1981,13,2,15,4,1,5,0,0,0,0,0,0
2003,1982,20,5,25,5,3,8,0,0,0,0,0,0
2003,1983,17,2,19,0,7,7,0,0,0,0,0,0
2003,1984,19,3,22,4,6,10,0,0,0,0,0,0
2003,1997,51,6,57,16,6,22,0,0,0,0,0,0
2003,2000,73,5,78,5,27,32,0,0,0,0,0,0
2003,2001,16,1,17,1,6,7,0,0,0,0,0,0
2003,2002,47,3,50,2,17,19,0,0,0,0,0,0
2003,2100,112,14,126,24,55,79,64,17,81,8,12,20
2003,2101,7,0,7,0,1,1,0,0,0,0,0,0
2003,2103,10,2,12,1,4,5,0,0,0,0,0,0
2003,2104,33,1,34,1,9,10,0,0,0,0,0,0
2003,2105,19,2,21,1,4,5,0,0,0,0,0,0
2003,2106,48,10,58,1,20,21,0,0,0,0,0,0
2003,2107,6,1,7,1,0,1,0,0,0,0,0,0
2003,2108,19,0,19,0,7,7,0,0,0,0,0,0
2003,2109,70,9,79,6,22,28,0,0,0,0,0,0
2003,2110,16,3,19,1,4,5,0,0,0,0,0,0
2003,2111,13,2,15,0,3,3,0,0,0,0,0,0
2003,2113,5,0,5,1,2,3,0,0,0,0,0,0
2003,2200,30,4,34,2,8,10,7,8,15,0,0,0
2003,2300,76,2,78,4,28,32,45,11,56,1,6,7
2003,2301,13,2,15,0,4,4,0,0,0,0,0,0
2003,2303,27,0,27,1,8,9,0,0,0,0,0,0
2003,2304,12,0,12,2,4,6,0,0,0,2,0,2
2003,2400,98,1,99,6,24,30,58,19,77,16,11,27
2003,2401,30,0,30,4,5,9,0,0,0,0,0,0
2003,2402,6,1,7,1,1,2,0,0,0,0,0,0
2003,2403,9,0,9,0,1,1,0,0,0,0,0,0
2003,2404,17,1,18,2,4,6,0,0,0,0,0,0
2003,2405,30,4,34,9,14,23,0,0,0,0,0,0
2003,2406,81,0,81,3,32,35,0,0,0,0,0,0
2003,2500,12,1,13,1,4,5,5,4,9,0,0,0
2003,2501,9,0,9,0,1,1,0,0,0,0,0,0
2003,2600,25,1,26,0,2,2,0,0,0,7,8,15
2003,2601,17,1,18,2,3,5,0,0,0,0,0,0
2003,2700,150,8,158,11,63,74,125,44,169,17,26,43
2003,2701,11,1,12,1,4,5,0,0,0,0,0,0
2003,2702,6,0,6,0,0,0,0,0,0,0,0,0
2003,2703,11,1,12,0,1,1,0,0,0,0,0,0
2003,2704,15,1,16,0,2,2,0,0,0,0,0,0
2003,2705,12,1,13,1,2,3,0,0,0,0,0,0
2003,2706,47,6,53,1,9,10,0,0,0,6,6,12
2003,2707,15,5,20,2,4,6,0,0,0,0,0,0
2003,2708,139,12,151,14,37,51,0,0,0,0,0,0
2003,2709,8,1,9,0,1,1,0,0,0,0,0,0
2003,2710,38,5,43,2,8,10,0,0,0,0,0,0
2003,2711,9,0,9,0,2,2,0,0,0,0,0,0
2003,2712,30,2,32,4,5,9,0,0,0,0,0,0
2003,2714,6,0,6,0,0,0,0,0,0,0,0,0
2003,2719,12,1,13,1,1,2,0,0,0,0,0,0
2003,2800,83,3,86,8,21,29,0,0,0,0,0,0
2003,2801,9,2,11,0,5,5,0,0,0,0,0,0
2003,2802,66,8,74,5,39,44,0,0,0,0,0,0
2003,2803,11,1,12,0,4,4,0,0,0,0,0,0
2003,2808,80,12,92,3,4,7,0,0,0,0,0,0
2003,2810,0,0,0,0,0,0,0,0,0,0,0,0
2003,2900,65,4,69,13,37,50,2,0,2,38,38,76
2003,2901,26,0,26,2,8,10,0,0,0,0,0,0
2003,2902,8,0,8,0,1,1,0,0,0,0,0,0
2003,2908,19,1,20,1,4,5,0,0,0,0,0,0
2003,3000,957,120,1077,612,729,1341,612,104,716,313,206,519
2003,3001,344,30,374,48,135,183,9,6,15,0,6,6
2003,3002,90,11,101,1,24,25,0,0,0,0,0,0
2003,3003,81,5,86,4,41,45,0,0,0,4,1,5
2003,3004,148,10,158,11,54,65,0,0,0,7,2,9
2003,3005,52,3,55,1,12,13,0,0,0,5,1,6
2003,3006,22,3,25,0,8,8,0,0,0,0,0,0
2003,3007,54,7,61,1,25,26,0,0,0,0,0,0
2003,3008,136,11,147,6,58,64,0,0,0,4,1,5
2003,3009,154,8,162,15,56,71,0,0,0,0,0,0
2003,3010,202,13,215,26,83,109,1,0,1,11,8,19
2003,3011,41,6,47,6,29,35,0,0,0,0,0,0
2003,3012,64,4,68,11,26,37,0,0,0,0,0,0
2003,3013,20,5,25,0,4,4,0,0,0,0,0,0
2003,3014,141,7,148,23,57,80,0,0,0,7,2,9
2003,3015,137,15,152,12,57,69,0,0,0,0,0,0
2003,3016,51,2,53,3,14,17,0,0,0,0,0,0
2003,3019,330,22,352,42,128,170,0,0,0,56,65,121
2003,3020,33,3,36,1,8,9,0,0,0,0,0,0
2003,3022,88,6,94,6,44,50,0,0,0,0,0,0
2003,3024,100,3,103,5,40,45,0,0,0,2,0,2
2003,3026,127,25,152,12,54,66,0,0,0,0,0,0
2003,3027,17,4,21,1,7,8,0,0,0,0,0,0
2003,3097,20,4,24,2,7,9,0,0,0,0,0,0
2003,3100,157,17,174,14,87,101,39,6,45,51,25,76
2003,3101,23,1,24,3,8,11,0,0,0,0,0,0
2003,3103,22,1,23,2,3,5,0,0,0,0,0,0
2003,3104,39,2,41,6,13,19,0,0,0,0,0,0
2003,3105,92,7,99,10,43,53,0,0,0,4,4,8
2003,3200,38,0,38,0,14,14,0,0,0,10,9,19
2003,3300,1139,123,1262,146,558,704,224,31,255,466,257,723
2003,3301,31,1,32,0,10,10,0,0,0,0,0,0
2003,3302,25,0,25,0,8,8,0,0,0,0,0,0
2003,3303,22,1,23,4,9,13,0,0,0,0,0,0
2003,3306,19,1,20,0,7,7,0,0,0,0,0,0
2003,3308,67,3,70,7,22,29,0,0,0,0,0,0
2003,3309,59,2,61,8,20,28,0,0,0,0,0,0
2003,3311,76,7,83,29,21,50,0,0,0,5,4,9
2003,3313,326,30,356,23,143,166,0,0,0,0,0,0
2003,3314,25,1,26,4,5,9,0,0,0,0,0,0
2003,3315,149,16,165,26,60,86,0,0,0,4,0,4
2003,3325,45,3,48,9,16,25,0,0,0,0,0,0
2003,3342,46,2,48,6,20,26,0,0,0,0,0,0
2003,3344,16,3,19,1,4,5,0,0,0,0,0,0
2003,3397,24,2,26,1,7,8,0,0,0,0,0,0
2003,3400,910,183,1093,148,283,431,316,98,414,110,210,320
2003,3401,56,6,62,0,25,25,0,0,0,0,0,0
2003,3402,22,2,24,2,9,11,0,0,0,0,0,0
2003,3403,2,0,2,0,0,0,0,0,0,0,0,0
2003,3404,575,85,660,108,277,385,0,0,0,0,0,0
2003,3408,12,2,14,1,5,6,0,0,0,0,0,0
2003,3414,18,1,19,1,3,4,0,0,0,0,0,0
2003,3420,4,0,4,3,2,5,0,0,0,0,0,0
2003,3422,558,146,704,32,56,88,0,0,0,0,0,0
2003,3477,107,13,120,69,22,91,0,0,0,0,0,0
2003,3499,6581,668,7249,1192,1761,2953,0,0,0,0,0,0
2003,3500,27,2,29,0,7,7,1,0,1,15,10,25
2003,3501,28,6,34,1,6,7,0,0,0,0,0,0
2003,3600,999,138,1137,247,633,880,321,76,397,149,283,432
2003,3601,32,1,33,3,16,19,0,0,0,0,0,0
2003,3602,85,7,92,0,31,31,0,0,0,0,0,0
2003,3603,62,3,65,2,23,25,0,0,0,0,0,0
2003,3604,129,16,145,5,56,61,0,0,0,0,0,0
2003,3605,52,4,56,2,23,25,0,0,0,0,0,0
2003,3607,205,15,220,12,88,100,0,0,0,0,0,0
2003,3608,77,13,90,29,50,79,0,0,0,0,0,0
2003,3609,89,15,104,6,32,38,0,0,0,0,0,0
2003,3610,274,21,295,31,130,161,0,0,0,4,5,9
2003,3611,75,4,79,5,34,39,0,0,0,0,0,0
2003,3614,13,0,13,2,5,7,0,0,0,0,0,0
2003,3623,23,3,26,33,18,51,0,0,0,0,0,0
2003,3639,5,3,8,0,3,3,0,0,0,0,0,0
2003,3650,10,5,15,3,6,9,0,0,0,0,0,0
2003,3700,855,123,978,110,286,396,802,200,1002,315,475,790
2003,3701,93,11,104,7,34,41,0,0,0,0,0,0
2003,3702,197,24,221,22,71,93,0,0,0,0,0,0
2003,3703,39,4,43,2,13,15,0,0,0,0,0,0
2003,3705,136,6,142,17,55,72,0,0,0,0,0,0
2003,3706,139,19,158,15,51,66,0,0,0,0,0,0
2003,3708,59,4,63,4,21,25,0,0,0,0,0,0
2003,3709,83,4,87,5,28,33,0,0,0,0,0,0
2003,3710,158,20,178,18,67,85,0,0,0,0,0,0
2003,3711,1761,301,2062,278,483,761,0,0,0,0,0,0
2003,3714,28,2,30,6,13,19,0,0,0,0,0,0
2003,3715,110,17,127,10,19,29,0,0,0,0,0,0
2003,3732,9,2,11,3,3,6,0,0,0,0,0,0
2003,3797,24,4,28,12,9,21,0,0,0,0,0,0
2003,3800,236,59,295,62,75,137,425,107,532,20,10,30
2003,3801,1841,368,2209,132,244,376,0,0,0,0,0,0
2003,3803,16,5,21,11,11,22,0,0,0,0,0,0
2003,3816,11,1,12,0,0,0,0,0,0,0,0,0
2003,3897,27,7,34,3,11,14,0,0,0,0,0,0
2003,3900,234,32,266,22,107,129,28,4,32,156,135,291
2003,3901,9,0,9,0,3,3,0,0,0,0,0,0
2003,3902,68,10,78,4,35,39,0,0,0,0,0,0
2003,3903,57,4,61,6,19,25,0,0,0,0,0,0
2003,3904,17,2,19,1,9,10,0,0,0,0,0,0
2003,3905,339,35,374,47,150,197,0,0,0,0,0,0
2003,3906,67,6,73,11,30,41,0,0,0,0,0,0
2003,3915,14,1,15,2,4,6,0,0,0,0,0,0
2003,4000,149,6,155,8,53,61,1,0,1,97,56,153
2003,4001,23,3,26,3,7,10,0,0,0,0,0,0
2003,4002,15,4,19,2,8,10,0,0,0,0,0,0
2003,4003,19,1,20,1,6,7,0,0,0,0,0,0
2003,4004,35,2,37,1,10,11,0,0,0,0,0,0
2003,4005,21,2,23,0,11,11,0,0,0,0,0,0
2003,4006,46,10,56,5,25,30,0,0,0,0,0,0
2003,4007,12,3,15,3,15,18,0,0,0,0,0,0
2003,4008,24,5,29,1,8,9,0,0,0,0,0,0
2003,4016,88,36,124,3,11,14,0,0,0,0,0,0
2003,4019,5,1,6,0,2,2,0,0,0,0,0,0
2003,4100,196,26,222,38,71,109,148,40,188,13,36,49
2003,4101,19,2,21,1,5,6,0,0,0,0,0,0
2003,4102,30,3,33,5,7,12,0,0,0,0,0,0
2003,4103,12,5,17,0,3,3,0,0,0,0,0,0
2003,4104,38,6,44,2,16,18,0,0,0,0,0,0
2003,4105,15,2,17,0,5,5,0,0,0,0,0,0
2003,4106,104,11,115,12,29,41,0,0,0,0,0,0
2003,4107,14,1,15,1,4,5,0,0,0,0,0,0
2003,4108,21,3,24,1,8,9,0,0,0,0,0,0
2003,4109,39,9,48,6,11,17,0,0,0,0,0,0
2003,4110,23,2,25,2,9,11,0,0,0,0,0,0
2003,4111,36,1,37,6,10,16,0,0,0,0,0,0
2003,4113,80,15,95,7,36,43,0,0,0,0,0,0
2003,4114,48,3,51,3,18,21,0,0,0,0,0,0
2003,4115,26,8,34,1,11,12,0,0,0,0,0,0
2003,4116,94,9,103,4,36,40,0,0,0,0,0,0
2003,4117,73,6,79,1,25,26,0,0,0,0,0,0
2003,4119,10,0,10,0,0,0,0,0,0,0,0,0
2003,4120,34,6,40,5,12,17,0,0,0,0,0,0
2003,4127,33,3,36,2,8,10,0,0,0,0,0,0
2003,4200,253,13,266,20,96,116,130,51,181,24,36,60
2003,4201,11,1,12,0,3,3,0,0,0,0,0,0
2003,4202,43,4,47,1,7,8,0,0,0,6,7,13
2003,4203,133,9,142,18,55,73,0,0,0,0,0,0
2003,4204,94,8,102,3,34,37,0,0,0,0,0,0
2003,4211,4,1,5,10,4,14,0,0,0,0,0,0
2003,4297,25,3,28,3,8,11,0,0,0,0,0,0
2003,4300,432,58,490,40,117,157,50,13,63,0,0,0
2003,4302,42,3,45,4,17,21,0,0,0,0,0,0
2003,4304,55,5,60,6,34,40,0,0,0,2,3,5
2003,4305,29,1,30,4,12,16,0,0,0,0,0,0
2003,4307,42,4,46,2,17,19,0,0,0,0,0,0
2003,4308,83,9,92,4,26,30,0,0,0,0,0,0
2003,4310,28,5,33,3,14,17,0,0,0,0,0,0
2003,4311,86,10,96,15,33,48,0,0,0,0,0,0
2003,4312,68,22,90,27,52,79,0,0,0,0,0,0
2003,4313,1266,134,1400,80,312,392,0,0,0,0,0,0
2003,4314,135,12,147,6,37,43,0,0,0,2,3,5
2003,4316,18,211,229,23,45,68,0,0,0,0,0,0
2003,4317,30,4,34,21,15,36,0,0,0,0,0,0
2003,4320,6,0,6,2,2,4,0,0,0,0,0,0
2003,4321,7,2,9,2,2,4,0,0,0,0,0,0
2003,4327,9,1,10,5,3,8,0,0,0,0,0,0
2003,4400,130,19,149,1,40,41,90,22,112,8,9,17
2003,4401,20,1,21,6,6,12,0,0,0,0,0,0
2003,4402,82,10,92,9,24,33,0,0,0,0,0,0
2003,4403,56,6,62,6,18,24,0,0,0,0,0,0
2003,4404,20,1,21,1,8,9,0,0,0,0,0,0
2003,4497,15,4,19,9,16,25,0,0,0,0,0,0
2003,4500,88,12,100,6,51,57,26,9,35,36,21,57
2003,4501,15,1,16,0,10,10,0,0,0,0,0,0
2003,4502,103,6,109,12,37,49,0,0,0,0,0,0
2003,4600,10,1,11,0,1,1,0,0,0,2,3,5
2003,4700,56,0,56,5,18,23,28,12,40,4,5,9
2003,4703,2,0,2,0,1,1,0,0,0,0,0,0
2003,4706,9,0,9,2,6,8,0,0,0,0,0,0
2003,4707,3,1,4,0,0,0,0,0,0,0,0,0
2003,4708,9,1,10,4,3,7,0,0,0,0,0,0
2003,4709,15,0,15,5,3,8,0,0,0,0,0,0
2003,4710,4,0,4,0,1,1,0,0,0,0,0,0
2003,4800,102,7,109,13,67,80,1,0,1,180,102,282
2003,4801,34,2,36,1,13,14,0,0,0,0,0,0
2003,4802,21,2,23,0,4,4,0,0,0,0,0,0
2003,4803,103,7,110,10,44,54,0,0,0,0,0,0
2003,4804,11,1,12,0,2,2,0,0,0,0,0,0
2003,4805,21,2,23,2,9,11,0,0,0,0,0,0
2003,4806,95,8,103,9,47,56,0,0,0,0,0,0
2003,4807,147,9,156,9,63,72,0,0,0,0,0,0
2003,4813,6,0,6,0,1,1,0,0,0,0,0,0
2003,4900,221,16,237,17,80,97,24,8,32,190,107,297
2003,4901,11,1,12,1,6,7,0,0,0,0,0,0
2003,4902,12,0,12,1,6,7,0,0,0,0,0,0
2003,4903,15,3,18,2,8,10,0,0,0,0,0,0
2003,4904,65,1,66,6,27,33,0,0,0,0,0,0
2003,4905,160,16,176,16,67,83,0,0,0,0,0,0
2003,4906,12,2,14,1,6,7,0,0,0,0,0,0
2003,4907,10,3,13,1,6,7,0,0,0,0,0,0
2003,4908,59,10,69,1,25,26,0,0,0,0,0,0
2003,4909,7,5,12,4,5,9,0,0,0,0,0,0
2003,4914,11,1,12,2,5,7,0,0,0,0,0,0
2003,5000,215,9,224,5,55,60,1,1,2,170,172,342
2003,5001,34,3,37,4,14,18,0,0,0,0,0,0
2003,5002,235,12,247,14,90,104,0,0,0,0,0,0
2003,5003,12,0,12,0,3,3,0,0,0,0,0,0
2003,5004,22,3,25,3,6,9,0,0,0,0,0,0
2003,5005,13,0,13,0,2,2,0,0,0,0,0,0
2003,5006,14,0,14,0,3,3,0,0,0,0,0,0
2003,5007,60,5,65,6,34,40,0,0,0,0,0,0
2003,5009,4,0,4,0,1,1,0,0,0,0,0,0
2003,5010,11,0,11,4,7,11,0,0,0,0,0,0
2003,5100,48,5,53,3,19,22,35,20,55,0,6,6
2003,5102,44,3,47,5,19,24,0,0,0,0,0,0
2003,5200,49,3,52,1,19,20,29,6,35,1,6,7
2003,5201,13,1,14,1,8,9,0,0,0,0,0,0
2003,5202,25,1,26,2,9,11,0,0,0,0,0,0
2003,5300,20,0,20,1,6,7,0,0,0,0,0,0
2003,5400,201,23,224,18,75,93,169,31,200,47,38,85
2003,5401,27,0,27,1,7,8,0,0,0,0,0,0
2003,5402,14,2,16,0,2,2,0,0,0,0,0,0
2003,5403,12,2,14,0,1,1,0,0,0,0,0,0
2003,5404,13,2,15,4,3,7,0,0,0,0,0,0
2003,5405,39,4,43,1,20,21,0,0,0,0,0,0
2003,5406,44,8,52,6,17,23,0,0,0,0,0,0
2003,5407,100,9,109,8,38,46,0,0,0,0,0,0
2003,5408,12,0,12,0,2,2,0,0,0,0,0,0
2003,5411,4,1,5,0,1,1,0,0,0,0,0,0
2003,5500,68,2,70,3,22,25,1,0,1,23,20,43
2003,5501,12,1,13,0,4,4,0,0,0,0,0,0
2003,5600,529,58,587,56,248,304,178,33,211,151,90,241
2003,5604,192,26,218,31,81,112,0,0,0,5,3,8
2003,5605,20,2,22,1,6,7,0,0,0,0,0,0
2003,5606,29,2,31,1,7,8,0,0,0,0,0,0
2003,5608,115,14,129,14,40,54,0,0,0,0,0,0
2003,5609,115,7,122,17,54,71,0,0,0,0,0,0
2003,5622,10,2,12,1,3,4,0,0,0,0,0,0
2003,5700,66,9,75,5,23,28,1,0,1,65,45,110
2003,5701,50,6,56,5,29,34,0,0,0,0,0,0
2003,5702,10,0,10,0,1,1,0,0,0,0,0,0
2003,5703,57,3,60,4,17,21,0,0,0,0,0,0
2003,5704,58,5,63,3,24,27,0,0,0,0,0,0
2003,5797,31,10,41,8,24,32,0,0,0,0,0,0
2003,5800,53,8,61,7,23,30,0,0,0,0,0,0
2003,5801,21,0,21,3,7,10,0,0,0,0,0,0
2003,5802,8,0,8,0,0,0,0,0,0,0,0,0
2003,190C,12,2,14,2,4,6,0,0,0,0,0,0
2003,190R,6,0,6,2,3,5,0,0,0,0,0,0
2004,100,430,58,488,102,212,314,374,60,434,88,132,220
2004,101,92,10,102,5,28,33,0,0,0,3,6,9
2004,102,27,0,27,0,10,10,0,0,0,0,0,0
2004,103,149,36,185,26,70,96,1,0,1,6,8,14
2004,104,33,2,35,3,10,13,0,0,0,0,0,0
2004,105,173,18,191,9,83,92,1,0,1,8,8,16
2004,106,163,20,183,26,65,91,0,0,0,11,7,18
2004,107,87,7,94,7,48,55,0,0,0,0,0,0
2004,108,51,3,54,7,19,26,0,0,0,0,0,0
2004,109,626,75,701,95,216,311,5,0,5,49,17,66
2004,110,17,2,19,2,6,8,0,0,0,0,0,0
2004,111,73,10,83,3,30,33,0,0,0,0,0,0
2004,112,86,4,90,6,29,35,0,0,0,4,4,8
2004,113,59,8,67,2,26,28,0,0,0,0,0,0
2004,114,53,7,60,4,20,24,0,0,0,0,0,0
2004,115,10,2,12,6,9,15,0,0,0,0,0,0
2004,122,2,0,2,4,3,7,0,0,0,0,0,0
2004,197,49,15,64,33,32,65,0,0,0,0,0,0
2004,200,13,0,13,0,4,4,0,0,0,0,0,0
2004,300,43,0,43,0,18,18,1,0,1,11,10,21
2004,302,6,0,6,0,1,1,0,0,0,0,0,0
2004,303,8,1,9,1,2,3,0,0,0,0,0,0
2004,305,7,0,7,0,0,0,0,0,0,0,0,0
2004,400,96,5,101,8,38,46,1,0,1,60,44,104
2004,402,76,8,84,9,43,52,0,0,0,0,0,0
2004,403,15,1,16,0,5,5,0,0,0,0,0,0
2004,404,23,1,24,1,8,9,0,0,0,0,0,0
2004,405,25,0,25,3,11,14,0,0,0,0,0,0
2004,497,10,4,14,0,8,8,0,0,0,0,0,0
2004,500,50,5,55,4,17,21,1,0,1,10,9,19
2004,501,8,0,8,0,1,1,0,0,0,0,0,0
2004,600,27,0,27,0,11,11,4,0,4,4,6,10
2004,601,8,1,9,0,1,1,0,0,0,0,0,0
2004,602,9,0,9,0,1,1,0,0,0,0,0,0
2004,700,340,44,384,66,176,242,258,53,311,50,65,115
2004,701,100,8,108,7,39,46,0,0,0,2,1,3
2004,702,38,7,45,1,13,14,0,0,0,0,0,0
2004,703,11,0,11,0,3,3,0,0,0,0,0,0
2004,704,131,26,157,18,44,62,0,0,0,4,0,4
2004,705,36,2,38,1,6,7,0,0,0,0,0,0
2004,706,22,2,24,1,2,3,0,0,0,0,0,0
2004,707,25,2,27,1,11,12,0,0,0,0,0,0
2004,708,64,5,69,2,20,22,0,0,0,1,5,6
2004,709,40,4,44,2,19,21,0,0,0,0,0,0
2004,710,138,17,155,9,49,58,0,0,0,0,4,4
2004,711,43,2,45,3,10,13,0,0,0,0,0,0
2004,712,69,9,78,4,33,37,0,0,0,0,0,0
2004,713,8,2,10,0,1,1,0,0,0,0,0,0
2004,714,38,1,39,4,12,16,0,0,0,0,0,0
2004,716,7,4,11,0,1,1,0,0,0,0,0,0
2004,718,168,21,189,53,37,90,0,0,0,0,0,0
2004,721,19,1,20,5,6,11,0,0,0,0,0,0
2004,800,25,2,27,3,5,8,3,0,3,9,9,18
2004,801,12,1,13,0,1,1,0,0,0,0,0,0
2004,900,160,6,166,7,82,89,2,0,2,66,53,119
2004,901,19,1,20,2,11,13,0,0,0,0,0,0
2004,902,37,5,42,6,15,21,0,0,0,0,0,0
2004,1000,421,46,467,48,175,223,5,2,7,240,143,383
2004,1001,77,12,89,9,34,43,0,0,0,2,1,3
2004,1002,11,2,13,1,4,5,0,0,0,0,0,0
2004,1003,9,2,11,0,4,4,0,0,0,0,0,0
2004,1004,6,0,6,0,1,1,0,0,0,0,0,0
2004,1005,677,92,769,116,255,371,0,0,0,0,0,0
2004,1006,11,0,11,2,2,4,0,0,0,0,0,0
2004,1007,15,1,16,1,2,3,0,0,0,0,0,0
2004,1008,15,0,15,1,5,6,0,0,0,0,0,0
2004,1011,12,2,14,1,2,3,0,0,0,0,0,0
2004,1012,25,2,27,2,9,11,0,0,0,0,0,0
2004,1013,25,0,25,3,7,10,0,0,0,0,0,0
2004,1015,23,3,26,2,10,12,0,0,0,0,0,0
2004,1017,10,1,11,1,3,4,0,0,0,0,0,0
2004,1097,9,2,11,0,9,9,0,0,0,0,0,0
2004,1100,23,2,25,4,11,15,2,0,2,14,11,25
2004,1101,9,1,10,0,1,1,0,0,0,0,0,0
2004,1102,9,2,11,1,2,3,0,0,0,0,0,0
2004,1200,73,5,78,5,28,33,65,31,96,5,7,12
2004,1201,22,1,23,3,7,10,0,0,0,0,0,0
2004,1202,4,2,6,0,0,0,0,0,0,0,0,0
2004,1203,37,7,44,5,20,25,0,0,0,0,0,0
2004,1204,4,1,5,0,0,0,0,0,0,0,0,0
2004,1205,14,1,15,2,6,8,0,0,0,0,0,0
2004,1206,1,0,1,0,0,0,0,0,0,0,0,0
2004,1207,6,0,6,0,0,0,0,0,0,0,0,0
2004,1208,8,3,11,1,8,9,0,0,0,0,0,0
2004,1300,81,5,86,8,40,48,57,17,74,12,18,30
2004,1301,30,2,32,0,13,13,0,0,0,0,0,0
2004,1302,37,3,40,3,15,18,0,0,0,0,0,0
2004,1303,5,0,5,0,1,1,0,0,0,0,0,0
2004,1304,48,1,49,5,17,22,0,0,0,0,0,0
2004,1305,7,0,7,0,1,1,0,0,0,0,0,0
2004,1306,14,0,14,1,1,2,0,0,0,0,0,0
2004,1307,5,0,5,0,0,0,0,0,0,0,0,0
2004,1400,26,0,26,3,12,15,18,7,25,1,3,4
2004,1401,13,0,13,0,4,4,0,0,0,0,0,0
2004,1500,329,23,352,49,167,216,96,13,109,217,153,370
2004,1501,9,2,11,3,4,7,0,0,0,0,0,0
2004,1502,275,17,292,24,109,133,0,0,0,0,0,0
2004,1503,41,3,44,2,10,12,0,0,0,4,0,4
2004,1506,27,3,30,1,9,10,0,0,0,0,0,0
2004,1507,19,1,20,2,5,7,0,0,0,0,0,0
2004,1508,13,0,13,2,6,8,0,0,0,0,0,0
2004,1511,11,2,13,2,3,5,0,0,0,0,0,0
2004,1514,3,0,3,0,0,0,0,0,0,0,0,0
2004,1515,7,0,7,3,2,5,0,0,0,0,0,0
2004,1597,8,3,11,0,3,3,0,0,0,0,0,0
2004,1600,77,3,80,7,33,40,0,0,0,40,39,79
2004,1601,15,1,16,1,7,8,0,0,0,0,0,0
2004,1602,43,3,46,1,17,18,0,0,0,0,0,0
2004,1603,21,5,26,2,3,5,0,0,0,0,0,0
2004,1700,56,3,59,5,14,19,3,0,3,35,33,68
2004,1701,13,0,13,0,2,2,0,0,0,0,0,0
2004,1702,25,0,25,2,8,10,0,0,0,0,0,0
2004,1800,26,1,27,7,1,8,21,16,37,3,10,13
2004,1801,18,1,19,0,3,3,0,0,0,0,0,0
2004,1900,5375,867,6242,1237,2100,3337,1583,390,1973,875,1427,2302
2004,1901,75,6,81,7,36,43,0,0,0,0,0,0
2004,1902,62,6,68,8,21,29,0,0,0,1,4,5
2004,1905,57,2,59,0,24,24,0,0,0,0,0,0
2004,1906,73,5,78,1,25,26,0,0,0,6,1,7
2004,1907,40,2,42,3,11,14,0,0,0,0,0,0
2004,1909,49,3,52,3,17,20,0,0,0,0,0,0
2004,1910,125,9,134,16,40,56,0,0,0,3,6,9
2004,1912,142,12,154,18,57,75,0,0,0,6,5,11
2004,1913,37,4,41,3,14,17,0,0,0,4,1,5
2004,1916,57,1,58,5,20,25,0,0,0,4,0,4
2004,1918,113,5,118,21,25,46,0,0,0,2,0,2
2004,1920,101,10,111,10,38,48,0,0,0,0,0,0
2004,1922,154,8,162,18,47,65,0,0,0,5,3,8
2004,1923,58,4,62,5,25,30,0,0,0,5,1,6
2004,1924,75,5,80,0,13,13,0,0,0,3,5,8
2004,1925,218,27,245,31,77,108,1,0,1,8,9,17
2004,1926,49,6,55,4,23,27,0,0,0,2,2,4
2004,1928,93,6,99,9,35,44,0,0,0,5,4,9
2004,1929,34,3,37,0,3,3,0,0,0,2,6,8
2004,1931,63,3,66,15,22,37,0,0,0,4,1,5
2004,1933,171,19,190,16,52,68,0,0,0,2,11,13
2004,1934,24,1,25,0,11,11,0,0,0,0,0,0
2004,1938,43,3,46,5,12,17,0,0,0,0,0,0
2004,1941,778,84,862,156,252,408,14,1,15,43,27,70
2004,1942,7353,1697,9050,815,1857,2672,15,5,20,228,117,345
2004,1944,53,6,59,10,15,25,0,0,0,4,0,4
2004,1945,40,0,40,3,8,11,0,0,0,2,2,4
2004,1946,50,8,58,3,17,20,0,0,0,2,2,4
2004,1947,72,7,79,6,32,38,0,0,0,5,2,7
2004,1948,67,9,76,4,25,29,0,0,0,3,2,5
2004,1951,21,3,24,2,4,6,0,0,0,2,2,4
2004,1953,190,36,226,38,73,111,1,0,1,12,9,21
2004,1955,165,11,176,25,95,120,1,0,1,11,10,21
2004,1956,92,5,97,3,36,39,0,0,0,2,6,8
2004,1961,33,2,35,1,8,9,0,0,0,4,2,6
2004,1962,51,4,55,4,10,14,0,0,0,0,0,0
2004,1963,21,5,26,2,4,6,0,0,0,0,0,0
2004,1965,177,19,196,68,96,164,2,1,3,7,5,12
2004,1966,17,1,18,0,5,5,0,0,0,0,0,0
2004,1967,25,4,29,7,8,15,0,0,0,0,0,0
2004,1969,80,2,82,6,29,35,0,0,0,5,1,6
2004,1970,33,1,34,4,8,12,0,0,0,0,0,0
2004,1972,218,10,228,22,51,73,1,0,1,7,6,13
2004,1973,56,3,59,0,18,18,0,0,0,7,0,7
2004,1975,112,7,119,10,33,43,0,0,0,5,2,7
2004,1976,118,10,128,18,35,53,0,0,0,0,0,0
2004,1978,15,2,17,4,6,10,0,0,0,0,0,0
2004,1981,14,2,16,3,2,5,0,0,0,0,0,0
2004,1982,20,4,24,4,3,7,0,0,0,0,0,0
2004,1983,15,3,18,4,11,15,0,0,0,0,0,0
2004,1984,23,3,26,6,6,12,0,0,0,0,0,0
2004,1997,51,5,56,4,21,25,0,0,0,0,0,0
2004,2000,66,5,71,6,25,31,0,0,0,0,0,0
2004,2001,16,1,17,0,4,4,0,0,0,0,0,0
2004,2002,45,3,48,2,16,18,0,0,0,0,0,0
2004,2100,114,16,130,25,56,81,65,16,81,10,13,23
2004,2101,7,0,7,0,1,1,0,0,0,0,0,0
2004,2103,9,2,11,1,3,4,0,0,0,0,0,0
2004,2104,28,1,29,0,8,8,0,0,0,0,0,0
2004,2105,19,3,22,1,4,5,0,0,0,0,0,0
2004,2106,47,9,56,1,20,21,0,0,0,0,0,0
2004,2107,6,1,7,1,0,1,0,0,0,0,0,0
2004,2108,17,1,18,0,6,6,0,0,0,0,0,0
2004,2109,64,8,72,4,20,24,0,0,0,0,0,0
2004,2110,15,2,17,1,4,5,0,0,0,0,0,0
2004,2111,13,2,15,0,3,3,0,0,0,0,0,0
2004,2113,7,0,7,1,1,2,0,0,0,0,0,0
2004,2200,31,5,36,2,9,11,8,7,15,0,0,0
2004,2300,75,1,76,4,28,32,39,11,50,1,6,7
2004,2301,12,2,14,0,5,5,0,0,0,0,0,0
2004,2303,26,0,26,1,8,9,0,0,0,0,0,0
2004,2304,12,0,12,2,5,7,0,0,0,0,0,0
2004,2400,96,2,98,4,23,27,59,20,79,14,11,25
2004,2401,27,0,27,3,6,9,0,0,0,0,0,0
2004,2402,4,1,5,0,0,0,0,0,0,0,0,0
2004,2403,8,1,9,0,2,2,0,0,0,0,0,0
2004,2404,16,1,17,1,5,6,0,0,0,0,0,0
2004,2405,34,4,38,6,13,19,0,0,0,0,0,0
2004,2406,81,0,81,2,36,38,0,0,0,0,0,0
2004,2500,12,1,13,1,3,4,5,4,9,0,0,0
2004,2501,9,0,9,0,1,1,0,0,0,0,0,0
2004,2600,25,1,26,0,2,2,0,0,0,7,8,15
2004,2601,18,1,19,2,3,5,0,0,0,0,0,0
2004,2700,150,11,161,9,62,71,121,40,161,17,23,40
2004,2701,10,1,11,2,6,8,0,0,0,0,0,0
2004,2702,6,0,6,0,0,0,0,0,0,0,0,0
2004,2703,11,1,12,0,1,1,0,0,0,0,0,0
2004,2704,14,0,14,0,1,1,0,0,0,0,0,0
2004,2706,42,7,49,1,9,10,0,0,0,5,6,11
2004,2707,19,6,25,3,2,5,0,0,0,0,0,0
2004,2708,151,16,167,13,37,50,0,0,0,0,0,0
2004,2709,8,1,9,0,1,1,0,0,0,0,0,0
2004,2710,36,4,40,2,10,12,0,0,0,0,0,0
2004,2711,14,2,16,0,2,2,0,0,0,0,0,0
2004,2712,28,2,30,5,2,7,0,0,0,0,0,0
2004,2714,6,0,6,0,1,1,0,0,0,0,0,0
2004,2800,83,4,87,9,21,30,0,0,0,0,0,0
2004,2801,9,2,11,0,4,4,0,0,0,0,0,0
2004,2802,64,8,72,7,36,43,0,0,0,0,0,0
2004,2803,12,1,13,0,4,4,0,0,0,0,0,0
2004,2808,79,11,90,3,4,7,0,0,0,0,0,0
2004,2810,0,0,0,9,6,15,0,0,0,38,22,60
2004,2900,59,4,63,5,29,34,4,0,4,33,42,75
2004,2901,26,0,26,2,8,10,0,0,0,0,0,0
2004,2902,11,0,11,0,1,1,0,0,0,0,0,0
2004,2908,22,2,24,1,4,5,0,0,0,0,0,0
2004,3000,870,104,974,581,626,1207,775,123,898,224,157,381
2004,3001,345,30,375,31,152,183,14,8,22,0,6,6
2004,3002,92,11,103,2,22,24,0,0,0,0,0,0
2004,3003,86,7,93,3,41,44,4,1,5,0,0,0
2004,3004,143,12,155,17,51,68,0,0,0,7,2,9
2004,3005,52,4,56,2,10,12,0,0,0,4,2,6
2004,3006,22,3,25,0,6,6,0,0,0,0,0,0
2004,3007,50,7,57,1,22,23,0,0,0,0,0,0
2004,3008,134,14,148,12,57,69,0,0,0,4,1,5
2004,3009,154,8,162,20,51,71,0,0,0,0,0,0
2004,3010,187,13,200,25,92,117,0,0,0,10,6,16
2004,3011,43,6,49,4,32,36,0,0,0,0,0,0
2004,3012,66,3,69,9,27,36,0,0,0,0,0,0
2004,3013,19,5,24,0,4,4,0,0,0,0,0,0
2004,3014,140,7,147,25,52,77,0,0,0,7,2,9
2004,3015,134,15,149,13,53,66,0,0,0,0,0,0
2004,3016,50,3,53,1,16,17,0,0,0,0,0,0
2004,3019,322,21,343,42,139,181,0,0,0,54,63,117
2004,3020,26,3,29,1,7,8,0,0,0,0,0,0
2004,3022,87,7,94,6,40,46,0,0,0,0,0,0
2004,3024,89,3,92,5,36,41,0,0,0,2,0,2
2004,3026,133,25,158,15,58,73,0,0,0,0,0,0
2004,3027,17,3,20,1,7,8,0,0,0,0,0,0
2004,3097,21,2,23,3,10,13,0,0,0,0,0,0
2004,3100,153,17,170,13,113,126,41,4,45,47,21,68
2004,3101,22,2,24,1,10,11,0,0,0,0,0,0
2004,3103,24,1,25,3,4,7,0,0,0,0,0,0
2004,3104,44,2,46,3,15,18,0,0,0,0,0,0
2004,3105,100,7,107,17,43,60,0,0,0,4,6,10
2004,3200,40,0,40,0,17,17,0,0,0,8,8,16
2004,3300,1151,118,1269,147,546,693,213,34,247,435,234,669
2004,3301,34,1,35,0,12,12,0,0,0,0,0,0
2004,3302,28,1,29,0,6,6,0,0,0,0,0,0
2004,3303,22,0,22,6,8,14,0,0,0,0,0,0
2004,3306,22,1,23,2,5,7,0,0,0,0,0,0
2004,3308,68,3,71,7,22,29,0,0,0,0,0,0
2004,3309,56,2,58,8,22,30,0,0,0,0,0,0
2004,3311,80,7,87,22,31,53,0,0,0,6,3,9
2004,3313,330,33,363,39,147,186,0,0,0,0,0,0
2004,3314,28,1,29,0,5,5,0,0,0,0,0,0
2004,3315,146,17,163,15,70,85,0,0,0,4,0,4
2004,3325,45,5,50,8,17,25,0,0,0,0,0,0
2004,3342,54,4,58,8,23,31,0,0,0,0,0,0
2004,3344,16,3,19,1,4,5,0,0,0,0,0,0
2004,3397,22,2,24,3,7,10,0,0,0,0,0,0
2004,3400,886,176,1062,149,272,421,309,111,420,112,211,323
2004,3401,70,8,78,1,27,28,0,0,0,0,0,0
2004,3402,24,2,26,0,10,10,0,0,0,0,0,0
2004,3403,4,0,4,0,0,0,0,0,0,0,0,0
2004,3404,586,96,682,101,260,361,0,0,0,0,0,0
2004,3408,16,2,18,1,4,5,0,0,0,0,0,0
2004,3414,16,2,18,2,3,5,0,0,0,0,0,0
2004,3420,5,0,5,4,1,5,0,0,0,0,0,0
2004,3422,552,151,703,34,60,94,0,0,0,0,0,0
2004,3477,105,15,120,65,18,83,0,0,0,0,0,0
2004,3499,6393,672,7065,1290,1727,3017,0,0,0,0,0,0
2004,3500,22,2,24,0,7,7,0,0,0,17,7,24
2004,3501,25,5,30,1,5,6,0,0,0,0,0,0
2004,3600,994,127,1121,189,510,699,304,83,387,152,360,512
2004,3601,30,2,32,2,15,17,0,0,0,0,0,0
2004,3602,84,9,93,0,33,33,0,0,0,0,0,0
2004,3603,63,3,66,1,24,25,0,0,0,0,0,0
2004,3604,132,17,149,5,51,56,0,0,0,0,0,0
2004,3605,50,5,55,2,23,25,0,0,0,0,0,0
2004,3607,206,12,218,12,79,91,0,0,0,0,0,0
2004,3608,77,13,90,29,48,77,0,0,0,0,0,0
2004,3609,92,17,109,9,38,47,0,0,0,0,0,0
2004,3610,269,20,289,27,122,149,0,0,0,4,4,8
2004,3611,73,4,77,8,34,42,0,0,0,0,0,0
2004,3614,14,0,14,2,7,9,0,0,0,0,0,0
2004,3623,23,3,26,39,21,60,0,0,0,0,0,0
2004,3639,7,3,10,0,3,3,0,0,0,0,0,0
2004,3650,11,3,14,1,6,7,0,0,0,0,0,0
2004,3700,1128,200,1328,262,465,727,688,203,891,278,432,710
2004,3701,95,11,106,7,33,40,0,0,0,0,0,0
2004,3702,191,24,215,40,83,123,0,0,0,0,0,0
2004,3703,37,4,41,3,15,18,0,0,0,0,0,0
2004,3705,129,6,135,18,65,83,0,0,0,0,0,0
2004,3706,146,22,168,12,49,61,0,0,0,0,0,0
2004,3708,56,3,59,4,21,25,0,0,0,0,0,0
2004,3709,81,4,85,4,28,32,0,0,0,0,0,0
2004,3710,160,17,177,16,45,61,0,0,0,0,0,0
2004,3711,1730,301,2031,264,470,734,0,0,0,0,0,0
2004,3714,31,2,33,7,13,20,0,0,0,0,0,0
2004,3715,104,19,123,19,21,40,0,0,0,0,0,0
2004,3732,10,3,13,2,4,6,0,0,0,0,0,0
2004,3797,25,5,30,13,10,23,0,0,0,0,0,0
2004,3800,227,54,281,40,55,95,416,105,521,17,6,23
2004,3801,1804,357,2161,148,219,367,0,0,0,0,0,0
2004,3803,15,5,20,9,10,19,0,0,0,0,0,0
2004,3816,11,1,12,0,0,0,0,0,0,0,0,0
2004,3897,28,7,35,6,13,19,0,0,0,0,0,0
2004,3900,223,29,252,23,102,125,28,1,29,157,129,286
2004,3901,10,0,10,0,3,3,0,0,0,0,0,0
2004,3902,72,6,78,4,35,39,0,0,0,0,0,0
2004,3903,61,4,65,3,18,21,0,0,0,0,0,0
2004,3904,21,2,23,1,9,10,0,0,0,0,0,0
2004,3905,345,36,381,59,139,198,0,0,0,0,0,0
2004,3906,66,6,72,9,30,39,0,0,0,0,0,0
2004,3915,14,1,15,1,4,5,0,0,0,0,0,0
2004,4000,141,4,145,9,49,58,1,0,1,96,52,148
2004,4001,24,3,27,3,6,9,0,0,0,0,0,0
2004,4002,16,2,18,2,8,10,0,0,0,0,0,0
2004,4003,18,2,20,2,5,7,0,0,0,0,0,0
2004,4004,35,2,37,0,11,11,0,0,0,0,0,0
2004,4005,21,2,23,0,9,9,0,0,0,0,0,0
2004,4006,48,9,57,4,21,25,0,0,0,0,0,0
2004,4007,13,3,16,2,16,18,0,0,0,0,0,0
2004,4008,24,6,30,1,8,9,0,0,0,0,0,0
2004,4016,77,35,112,2,10,12,0,0,0,0,0,0
2004,4019,5,0,5,0,1,1,0,0,0,0,0,0
2004,4100,184,27,211,31,65,96,160,36,196,12,38,50
2004,4101,19,2,21,1,5,6,0,0,0,0,0,0
2004,4102,27,3,30,5,7,12,0,0,0,0,0,0
2004,4103,12,5,17,0,3,3,0,0,0,0,0,0
2004,4104,33,5,38,2,17,19,0,0,0,0,0,0
2004,4105,16,2,18,1,5,6,0,0,0,0,0,0
2004,4106,103,12,115,12,25,37,0,0,0,0,0,0
2004,4107,16,0,16,1,4,5,0,0,0,0,0,0
2004,4108,21,3,24,1,8,9,0,0,0,0,0,0
2004,4109,40,8,48,6,11,17,0,0,0,0,0,0
2004,4110,20,1,21,2,9,11,0,0,0,0,0,0
2004,4111,36,1,37,3,12,15,0,0,0,0,0,0
2004,4113,80,11,91,7,33,40,0,0,0,0,0,0
2004,4114,42,3,45,2,19,21,0,0,0,0,0,0
2004,4115,23,9,32,2,12,14,0,0,0,0,0,0
2004,4116,94,12,106,6,33,39,0,0,0,0,0,0
2004,4117,67,8,75,8,23,31,0,0,0,0,0,0
2004,4119,10,0,10,0,1,1,0,0,0,0,0,0
2004,4120,31,6,37,6,11,17,0,0,0,0,0,0
2004,4127,35,2,37,1,10,11,0,0,0,0,0,0
2004,4200,262,14,276,25,82,107,2,0,2,152,82,234
2004,4201,11,1,12,0,3,3,0,0,0,0,0,0
2004,4202,43,5,48,1,7,8,0,0,0,5,7,12
2004,4203,131,10,141,17,53,70,0,0,0,0,0,0
2004,4204,94,8,102,2,38,40,0,0,0,0,0,0
2004,4211,4,1,5,10,4,14,0,0,0,0,0,0
2004,4297,23,3,26,6,9,15,0,0,0,0,0,0
2004,4300,416,59,475,41,112,153,35,8,43,0,0,0
2004,4302,41,3,44,2,16,18,0,0,0,0,0,0
2004,4304,54,6,60,7,27,34,0,0,0,2,3,5
2004,4305,29,2,31,5,9,14,0,0,0,0,0,0
2004,4307,40,4,44,2,13,15,0,0,0,0,0,0
2004,4308,83,8,91,4,23,27,0,0,0,0,0,0
2004,4310,27,3,30,3,13,16,0,0,0,0,0,0
2004,4311,85,10,95,14,32,46,0,0,0,0,0,0
2004,4312,65,22,87,25,52,77,0,0,0,0,0,0
2004,4313,1216,129,1345,76,300,376,0,0,0,0,0,0
2004,4314,127,11,138,6,35,41,0,0,0,3,3,6
2004,4316,203,16,219,21,43,64,0,0,0,0,0,0
2004,4317,25,3,28,21,13,34,0,0,0,0,0,0
2004,4320,5,1,6,2,2,4,0,0,0,0,0,0
2004,4321,7,2,9,2,2,4,0,0,0,0,0,0
2004,4327,9,1,10,5,3,8,0,0,0,0,0,0
2004,4400,119,20,139,1,36,37,4,1,5,84,30,114
2004,4401,20,1,21,5,7,12,0,0,0,0,0,0
2004,4402,83,11,94,6,22,28,0,0,0,0,0,0
2004,4403,59,5,64,5,16,21,0,0,0,0,0,0
2004,4404,19,1,20,2,7,9,0,0,0,0,0,0
2004,4497,14,4,18,9,16,25,0,0,0,0,0,0
2004,4500,81,11,92,4,46,50,24,8,32,38,22,60
2004,4501,16,1,17,0,11,11,0,0,0,0,0,0
2004,4502,106,6,112,13,37,50,0,0,0,0,0,0
2004,4600,10,0,10,0,1,1,0,0,0,2,3,5
2004,4700,53,1,54,5,17,22,30,8,38,0,7,7
2004,4703,2,0,2,0,1,1,0,0,0,0,0,0
2004,4706,9,0,9,2,6,8,0,0,0,0,0,0
2004,4707,2,1,3,0,0,0,0,0,0,0,0,0
2004,4708,9,1,10,4,3,7,0,0,0,0,0,0
2004,4709,13,0,13,5,3,8,0,0,0,0,0,0
2004,4710,4,0,4,0,1,1,0,0,0,0,0,0
2004,4800,98,6,104,11,60,71,1,0,1,169,84,253
2004,4801,33,2,35,2,12,14,0,0,0,0,0,0
2004,4802,21,2,23,0,4,4,0,0,0,0,0,0
2004,4803,105,7,112,10,44,54,0,0,0,0,0,0
2004,4804,12,1,13,0,2,2,0,0,0,0,0,0
2004,4805,21,2,23,2,9,11,0,0,0,0,0,0
2004,4806,91,10,101,9,50,59,0,0,0,0,0,0
2004,4807,135,10,145,11,46,57,0,0,0,0,0,0
2004,4813,6,0,6,0,1,1,0,0,0,0,0,0
2004,4900,222,14,236,16,77,93,26,8,34,190,103,293
2004,4901,11,1,12,1,6,7,0,0,0,0,0,0
2004,4902,9,0,9,1,5,6,0,0,0,0,0,0
2004,4903,15,2,17,2,8,10,0,0,0,0,0,0
2004,4904,68,2,70,5,26,31,0,0,0,0,0,0
2004,4905,140,16,156,15,65,80,0,0,0,0,0,0
2004,4906,12,2,14,1,6,7,0,0,0,0,0,0
2004,4908,56,8,64,1,25,26,0,0,0,0,0,0
2004,4909,10,3,13,4,5,9,0,0,0,0,0,0
2004,4914,11,1,12,2,4,6,0,0,0,0,0,0
2004,5000,203,11,214,20,85,105,2,1,3,205,95,300
2004,5001,39,3,42,4,15,19,0,0,0,0,0,0
2004,5002,249,13,262,15,94,109,0,0,0,0,0,0
2004,5003,11,0,11,0,2,2,0,0,0,0,0,0
2004,5004,23,3,26,3,8,11,0,0,0,0,0,0
2004,5005,13,0,13,0,2,2,0,0,0,0,0,0
2004,5006,14,1,15,0,3,3,0,0,0,0,0,0
2004,5007,56,3,59,4,37,41,0,0,0,0,0,0
2004,5009,5,0,5,0,1,1,0,0,0,0,0,0
2004,5010,10,1,11,4,5,9,0,0,0,0,0,0
2004,5100,47,5,52,3,20,23,35,20,55,0,5,5
2004,5102,43,4,47,6,20,26,0,0,0,0,0,0
2004,5200,36,2,38,1,17,18,21,6,27,1,5,6
2004,5201,13,1,14,1,8,9,0,0,0,0,0,0
2004,5202,23,0,23,2,9,11,0,0,0,0,0,0
2004,5300,18,0,18,1,5,6,1,0,1,3,6,9
2004,5400,229,23,252,14,79,93,176,39,215,48,49,97
2004,5401,27,0,27,1,7,8,0,0,0,0,0,0
2004,5403,11,1,12,0,1,1,0,0,0,0,0,0
2004,5404,14,2,16,4,3,7,0,0,0,0,0,0
2004,5405,41,3,44,4,17,21,0,0,0,0,0,0
2004,5406,44,8,52,7,16,23,0,0,0,0,0,0
2004,5407,97,11,108,9,37,46,0,0,0,0,0,0
2004,5408,12,0,12,0,2,2,0,0,0,0,0,0
2004,5411,4,1,5,0,1,1,0,0,0,0,0,0
2004,5500,68,3,71,3,22,25,0,0,0,26,18,44
2004,5501,13,1,14,0,4,4,0,0,0,0,0,0
2004,5600,396,34,430,68,175,243,238,46,284,47,134,181
2004,5604,197,27,224,35,88,123,0,0,0,5,5,10
2004,5605,22,1,23,1,7,8,0,0,0,0,0,0
2004,5606,30,0,30,1,8,9,0,0,0,0,0,0
2004,5608,124,7,131,11,40,51,0,0,0,0,0,0
2004,5609,114,8,122,17,50,67,0,0,0,0,0,0
2004,5622,10,2,12,1,5,6,0,0,0,0,0,0
2004,5700,72,6,78,15,29,44,1,0,1,69,41,110
2004,5701,51,6,57,7,27,34,0,0,0,0,0,0
2004,5702,10,0,10,0,1,1,0,0,0,0,0,0
2004,5703,59,3,62,3,20,23,0,0,0,0,0,0
2004,5704,55,5,60,2,30,32,0,0,0,0,0,0
2004,5797,32,10,42,8,19,27,0,0,0,0,0,0
2004,5800,50,6,56,2,18,20,45,22,67,6,6,12
2004,5801,22,0,22,2,9,11,0,0,0,0,0,0
2004,5802,7,0,7,0,0,0,0,0,0,0,0,0
2004,190C,13,2,15,2,4,6,0,0,0,0,0,0
2004,190R,8,0,8,4,3,7,0,0,0,0,0,0
2005,100,453,55,508,103,200,303,388,66,454,96,158,254
2005,101,90,9,99,4,32,36,0,0,0,3,6,9
2005,102,27,0,27,2,8,10,0,0,0,0,0,0
2005,103,143,37,180,27,71,98,1,0,1,7,8,15
2005,104,32,2,34,3,12,15,0,0,0,0,0,0
2005,105,163,17,180,12,79,91,1,0,1,8,8,16
2005,106,167,23,190,26,70,96,0,0,0,11,6,17
2005,107,79,7,86,6,41,47,0,0,0,0,0,0
2005,108,50,4,54,7,19,26,0,0,0,0,0,0
2005,109,622,108,730,67,222,289,0,0,0,0,0,0
2005,110,17,2,19,1,6,7,0,0,0,0,0,0
2005,111,72,11,83,2,31,33,0,0,0,0,0,0
2005,112,85,4,89,6,26,32,0,0,0,4,4,8
2005,113,68,9,77,2,26,28,0,0,0,0,0,0
2005,114,50,8,58,4,18,22,0,0,0,0,0,0
2005,115,11,4,15,9,7,16,0,0,0,0,0,0
2005,122,2,0,2,4,3,7,0,0,0,0,0,0
2005,197,50,16,66,31,31,62,0,0,0,0,0,0
2005,200,12,0,12,0,3,3,0,0,0,0,0,0
2005,300,43,0,43,0,18,18,1,0,1,11,10,21
2005,302,6,0,6,0,1,1,0,0,0,0,0,0
2005,303,9,1,10,1,2,3,0,0,0,0,0,0
2005,305,6,0,6,0,0,0,0,0,0,0,0,0
2005,400,87,6,93,6,31,37,1,0,1,58,45,103
2005,402,81,7,88,9,43,52,0,0,0,0,0,0
2005,403,16,1,17,0,5,5,0,0,0,0,0,0
2005,404,23,1,24,2,9,11,0,0,0,0,0,0
2005,405,26,0,26,3,12,15,0,0,0,0,0,0
2005,497,13,3,16,1,7,8,0,0,0,0,0,0
2005,500,53,4,57,4,23,27,1,0,1,10,9,19
2005,501,9,0,9,0,1,1,0,0,0,0,0,0
2005,600,29,0,29,0,17,17,3,0,3,4,6,10
2005,601,7,2,9,0,1,1,0,0,0,0,0,0
2005,602,8,0,8,0,1,1,0,0,0,0,0,0
2005,700,337,46,383,48,163,211,248,53,301,46,70,116
2005,701,104,7,111,8,46,54,0,0,0,2,2,4
2005,702,44,6,50,2,13,15,0,0,0,0,0,0
2005,703,10,1,11,0,3,3,0,0,0,0,0,0
2005,704,131,24,155,13,42,55,0,0,0,5,0,5
2005,705,35,2,37,4,7,11,0,0,0,0,0,0
2005,706,23,1,24,1,2,3,0,0,0,0,0,0
2005,707,24,2,26,2,10,12,0,0,0,0,0,0
2005,708,63,7,70,2,20,22,0,0,0,1,5,6
2005,709,38,4,42,2,18,20,0,0,0,0,0,0
2005,710,141,15,156,9,49,58,0,0,0,1,4,5
2005,711,46,3,49,4,10,14,0,0,0,0,0,0
2005,712,69,9,78,4,33,37,0,0,0,0,0,0
2005,713,8,1,9,0,1,1,0,0,0,0,0,0
2005,714,38,1,39,4,12,16,0,0,0,0,0,0
2005,716,8,3,11,0,1,1,0,0,0,0,0,0
2005,718,162,24,186,53,38,91,0,0,0,0,0,0
2005,721,18,1,19,4,6,10,0,0,0,0,0,0
2005,800,25,2,27,3,6,9,3,0,3,14,7,21
2005,801,10,1,11,0,1,1,0,0,0,0,0,0
2005,900,160,9,169,9,70,79,23,1,24,69,52,121
2005,901,17,1,18,2,9,11,0,0,0,0,0,0
2005,902,35,5,40,6,14,20,0,0,0,0,0,0
2005,1000,422,42,464,49,176,225,8,3,11,306,121,427
2005,1001,85,14,99,8,36,44,0,0,0,1,1,2
2005,1002,15,1,16,4,4,8,0,0,0,0,0,0
2005,1003,9,2,11,0,4,4,0,0,0,0,0,0
2005,1004,8,0,8,0,1,1,0,0,0,0,0,0
2005,1005,706,92,798,105,274,379,0,0,0,0,0,0
2005,1006,10,0,10,3,2,5,0,0,0,0,0,0
2005,1007,15,1,16,1,2,3,0,0,0,0,0,0
2005,1008,14,1,15,1,4,5,0,0,0,0,0,0
2005,1011,12,2,14,1,2,3,0,0,0,0,0,0
2005,1012,25,2,27,2,9,11,0,0,0,0,0,0
2005,1013,27,0,27,2,6,8,0,0,0,0,0,0
2005,1015,27,2,29,4,11,15,0,0,0,0,0,0
2005,1017,12,1,13,1,3,4,0,0,0,0,0,0
2005,1097,12,3,15,1,5,6,0,0,0,0,0,0
2005,1100,25,2,27,4,11,15,1,0,1,9,9,18
2005,1101,9,1,10,0,1,1,0,0,0,0,0,0
2005,1102,8,2,10,0,2,2,0,0,0,0,0,0
2005,1200,70,7,77,5,32,37,70,29,99,5,7,12
2005,1201,19,2,21,3,7,10,0,0,0,0,0,0
2005,1202,3,2,5,0,0,0,0,0,0,0,0,0
2005,1203,36,5,41,6,20,26,0,0,0,0,0,0
2005,1204,4,0,4,0,0,0,0,0,0,0,0,0
2005,1205,14,1,15,2,6,8,0,0,0,0,0,0
2005,1206,3,0,3,0,0,0,0,0,0,0,0,0
2005,1207,6,0,6,0,0,0,0,0,0,0,0,0
2005,1208,7,4,11,1,8,9,0,0,0,0,0,0
2005,1300,86,4,90,12,40,52,57,16,73,13,19,32
2005,1301,27,1,28,0,12,12,0,0,0,0,0,0
2005,1302,39,3,42,3,16,19,0,0,0,0,0,0
2005,1303,6,0,6,0,0,0,0,0,0,0,0,0
2005,1304,48,1,49,4,17,21,0,0,0,0,0,0
2005,1305,6,0,6,0,2,2,0,0,0,0,0,0
2005,1306,14,0,14,1,1,2,0,0,0,0,0,0
2005,1307,5,0,5,0,0,0,0,0,0,0,0,0
2005,1400,26,0,26,3,12,15,18,7,25,1,3,4
2005,1401,10,1,11,2,4,6,0,0,0,0,0,0
2005,1500,360,25,385,45,164,209,83,11,94,224,151,375
2005,1501,9,2,11,1,5,6,0,0,0,0,0,0
2005,1502,297,18,315,31,115,146,0,0,0,0,0,0
2005,1503,38,1,39,3,9,12,0,0,0,4,0,4
2005,1506,27,3,30,1,10,11,0,0,0,0,0,0
2005,1507,20,1,21,1,5,6,0,0,0,0,0,0
2005,1508,9,0,9,1,9,10,0,0,0,0,0,0
2005,1511,12,2,14,2,3,5,0,0,0,0,0,0
2005,1514,4,0,4,0,0,0,0,0,0,0,0,0
2005,1515,8,0,8,2,6,8,0,0,0,0,0,0
2005,1597,8,2,10,0,3,3,0,0,0,0,0,0
2005,1600,77,3,80,2,36,38,0,0,0,39,39,78
2005,1601,16,0,16,2,8,10,0,0,0,0,0,0
2005,1602,43,6,49,1,16,17,0,0,0,0,0,0
2005,1603,24,4,28,3,3,6,0,0,0,0,0,0
2005,1700,57,3,60,3,15,18,2,0,2,34,32,66
2005,1701,12,0,12,0,2,2,0,0,0,0,0,0
2005,1702,24,1,25,0,8,8,0,0,0,0,0,0
2005,1800,30,1,31,1,8,9,17,18,35,2,10,12
2005,1801,17,1,18,0,2,2,0,0,0,0,0,0
2005,1900,5078,814,5892,1241,2123,3364,1833,463,2296,894,1493,2387
2005,1901,74,7,81,7,38,45,0,0,0,0,0,0
2005,1902,60,5,65,4,24,28,0,0,0,1,4,5
2005,1905,57,2,59,0,22,22,0,0,0,0,0,0
2005,1906,71,5,76,1,19,20,0,0,0,5,1,6
2005,1907,36,2,38,1,10,11,0,0,0,0,0,0
2005,1909,51,3,54,3,17,20,0,0,0,0,0,0
2005,1910,124,10,134,13,41,54,0,0,0,2,5,7
2005,1912,143,12,155,16,62,78,0,0,0,6,4,10
2005,1913,35,4,39,2,16,18,0,0,0,5,1,6
2005,1916,55,2,57,5,23,28,0,0,0,3,1,4
2005,1918,116,3,119,27,19,46,0,0,0,2,0,2
2005,1920,95,9,104,14,31,45,0,0,0,0,0,0
2005,1922,151,10,161,21,36,57,0,0,0,6,3,9
2005,1923,58,5,63,3,20,23,0,0,0,5,2,7
2005,1924,70,6,76,0,13,13,0,0,0,4,3,7
2005,1925,240,29,269,19,76,95,1,0,1,11,7,18
2005,1926,46,7,53,4,26,30,0,0,0,2,2,4
2005,1928,93,6,99,8,39,47,0,0,0,5,4,9
2005,1929,35,3,38,0,2,2,0,0,0,2,7,9
2005,1931,60,4,64,15,21,36,0,0,0,4,1,5
2005,1933,178,24,202,13,54,67,0,0,0,2,10,12
2005,1934,25,1,26,0,8,8,0,0,0,0,0,0
2005,1938,43,2,45,4,13,17,0,0,0,1,0,1
2005,1941,797,89,886,142,235,377,10,0,10,46,25,71
2005,1942,7566,1764,9330,851,1889,2740,21,4,25,212,113,325
2005,1944,54,7,61,8,12,20,0,0,0,4,2,6
2005,1945,37,0,37,3,11,14,0,0,0,3,1,4
2005,1946,47,7,54,3,16,19,0,0,0,2,2,4
2005,1947,70,7,77,5,26,31,0,0,0,4,1,5
2005,1948,64,12,76,3,25,28,0,0,0,3,2,5
2005,1951,21,3,24,2,4,6,0,0,0,2,2,4
2005,1953,201,37,238,41,65,106,1,0,1,13,7,20
2005,1955,168,11,179,24,93,117,1,0,1,10,10,20
2005,1956,101,4,105,2,44,46,0,0,0,3,6,9
2005,1961,33,2,35,1,8,9,0,0,0,5,2,7
2005,1962,51,3,54,4,11,15,0,0,0,0,0,0
2005,1963,20,4,24,5,1,6,0,0,0,0,0,0
2005,1965,175,20,195,69,100,169,2,1,3,7,6,13
2005,1966,16,1,17,0,4,4,0,0,0,0,0,0
2005,1967,28,4,32,4,8,12,0,0,0,0,0,0
2005,1969,83,4,87,6,30,36,0,0,0,4,2,6
2005,1970,34,2,36,4,7,11,0,0,0,0,0,0
2005,1972,218,11,229,21,51,72,1,0,1,8,8,16
2005,1973,53,3,56,0,15,15,0,0,0,4,0,4
2005,1975,111,7,118,11,26,37,0,0,0,5,2,7
2005,1976,115,10,125,18,35,53,0,0,0,0,0,0
2005,1978,14,2,16,4,6,10,0,0,0,0,0,0
2005,1981,14,2,16,2,3,5,0,0,0,0,0,0
2005,1982,23,3,26,4,2,6,0,0,0,0,0,0
2005,1983,15,3,18,4,11,15,0,0,0,0,0,0
2005,1984,17,3,20,5,8,13,0,0,0,0,0,0
2005,1997,47,5,52,7,18,25,0,0,0,0,0,0
2005,2000,63,3,66,6,28,34,0,0,0,0,0,0
2005,2001,16,1,17,0,6,6,0,0,0,0,0,0
2005,2002,56,4,60,2,15,17,0,0,0,0,0,0
2005,2100,116,16,132,25,56,81,61,16,77,10,16,26
2005,2101,7,0,7,0,1,1,0,0,0,0,0,0
2005,2103,8,2,10,3,2,5,0,0,0,0,0,0
2005,2104,32,1,33,0,10,10,0,0,0,0,0,0
2005,2105,19,3,22,1,4,5,0,0,0,0,0,0
2005,2106,43,9,52,1,19,20,0,0,0,0,0,0
2005,2107,8,0,8,0,0,0,0,0,0,0,0,0
2005,2108,16,2,18,0,6,6,0,0,0,0,0,0
2005,2109,65,7,72,4,22,26,0,0,0,0,0,0
2005,2110,15,2,17,1,4,5,0,0,0,0,0,0
2005,2111,13,1,14,0,3,3,0,0,0,0,0,0
2005,2113,6,0,6,1,1,2,0,0,0,0,0,0
2005,2200,33,5,38,3,11,14,8,8,16,0,0,0
2005,2300,71,2,73,4,24,28,34,13,47,1,6,7
2005,2301,14,2,16,1,4,5,0,0,0,0,0,0
2005,2303,26,0,26,1,8,9,0,0,0,0,0,0
2005,2304,12,0,12,2,4,6,0,0,0,0,0,0
2005,2400,103,3,106,4,25,29,59,22,81,13,8,21
2005,2401,28,0,28,4,5,9,0,0,0,0,0,0
2005,2402,4,1,5,0,0,0,0,0,0,0,0,0
2005,2403,8,1,9,0,2,2,0,0,0,0,0,0
2005,2404,17,2,19,1,5,6,0,0,0,0,0,0
2005,2405,33,4,37,9,13,22,0,0,0,0,0,0
2005,2406,86,1,87,2,36,38,0,0,0,0,0,0
2005,2500,10,1,11,1,3,4,5,3,8,0,0,0
2005,2501,9,0,9,0,1,1,0,0,0,0,0,0
2005,2600,26,0,26,0,2,2,0,0,0,8,7,15
2005,2601,19,1,20,1,4,5,0,0,0,0,0,0
2005,2700,145,13,158,8,60,68,134,33,167,17,20,37
2005,2701,9,2,11,1,6,7,0,0,0,0,0,0
2005,2702,6,0,6,0,0,0,0,0,0,0,0,0
2005,2703,11,2,13,0,1,1,0,0,0,0,0,0
2005,2704,14,0,14,1,2,3,0,0,0,0,0,0
2005,2705,12,1,13,1,2,3,0,0,0,0,0,0
2005,2706,46,7,53,7,7,14,0,0,0,7,5,12
2005,2707,18,6,24,3,4,7,0,0,0,0,0,0
2005,2708,150,14,164,13,40,53,0,0,0,0,0,0
2005,2709,9,1,10,0,1,1,0,0,0,0,0,0
2005,2710,37,4,41,2,11,13,0,0,0,0,0,0
2005,2711,13,1,14,0,2,2,0,0,0,0,0,0
2005,2712,28,2,30,2,6,8,0,0,0,0,0,0
2005,2714,6,1,7,0,1,1,0,0,0,0,0,0
2005,2719,13,1,14,1,1,2,0,0,0,0,0,0
2005,2800,81,4,85,8,20,28,0,0,0,0,0,0
2005,2801,9,2,11,0,4,4,0,0,0,0,0,0
2005,2802,63,5,68,9,39,48,0,0,0,0,0,0
2005,2803,12,1,13,0,4,4,0,0,0,0,0,0
2005,2808,83,11,94,3,3,6,0,0,0,0,0,0
2005,2900,63,4,67,5,35,40,2,0,2,34,43,77
2005,2901,25,0,25,3,9,12,0,0,0,0,0,0
2005,2902,11,0,11,0,1,1,0,0,0,0,0,0
2005,2908,20,1,21,1,4,5,0,0,0,0,0,0
2005,3000,909,107,1016,585,610,1195,591,93,684,217,146,363
2005,3001,343,29,372,31,126,157,15,9,24,0,6,6
2005,3002,94,9,103,3,23,26,0,0,0,1,0,1
2005,3003,83,8,91,2,42,44,0,0,0,4,0,4
2005,3004,145,13,158,10,51,61,0,0,0,7,2,9
2005,3005,52,5,57,2,11,13,0,0,0,3,2,5
2005,3006,23,2,25,0,6,6,0,0,0,0,0,0
2005,3007,50,7,57,1,17,18,0,0,0,0,0,0
2005,3008,137,16,153,4,55,59,0,0,0,5,1,6
2005,3009,152,9,161,22,49,71,0,0,0,0,0,0
2005,3010,200,11,211,30,86,116,0,0,0,11,7,18
2005,3011,42,7,49,6,30,36,0,0,0,0,0,0
2005,3012,66,2,68,9,27,36,0,0,0,0,0,0
2005,3013,20,4,24,0,4,4,0,0,0,0,0,0
2005,3014,140,7,147,25,52,77,0,0,0,7,2,9
2005,3015,134,16,150,12,54,66,0,0,0,0,0,0
2005,3016,50,4,54,2,15,17,0,0,0,0,0,0
2005,3019,331,24,355,46,134,180,0,0,0,54,63,117
2005,3020,26,3,29,3,7,10,0,0,0,0,0,0
2005,3022,85,7,92,8,35,43,0,0,0,0,0,0
2005,3024,90,5,95,7,34,41,0,0,0,2,0,2
2005,3026,131,26,157,17,50,67,0,0,0,0,0,0
2005,3027,19,3,22,1,7,8,0,0,0,0,0,0
2005,3097,23,4,27,3,8,11,0,0,0,0,0,0
2005,3100,141,15,156,13,98,111,42,12,54,44,21,65
2005,3101,22,1,23,2,9,11,0,0,0,0,0,0
2005,3103,26,1,27,2,3,5,0,0,0,0,0,0
2005,3104,45,3,48,3,24,27,0,0,0,0,0,0
2005,3105,117,7,124,12,44,56,0,0,0,4,6,10
2005,3200,35,0,35,0,17,17,0,0,0,9,9,18
2005,3300,1214,120,1334,142,561,703,272,35,307,452,237,689
2005,3301,36,0,36,0,15,15,0,0,0,0,0,0
2005,3302,26,1,27,1,9,10,0,0,0,0,0,0
2005,3303,25,0,25,5,8,13,0,0,0,0,0,0
2005,3306,24,1,25,2,5,7,0,0,0,0,0,0
2005,3308,80,3,83,6,26,32,0,0,0,0,0,0
2005,3309,59,2,61,10,27,37,0,0,0,0,0,0
2005,3311,77,9,86,19,33,52,0,0,0,6,3,9
2005,3313,338,33,371,27,143,170,0,0,0,0,0,0
2005,3314,28,3,31,0,5,5,0,0,0,0,0,0
2005,3315,145,17,162,16,68,84,0,0,0,2,2,4
2005,3325,46,4,50,8,16,24,0,0,0,0,0,0
2005,3342,64,4,68,5,24,29,0,0,0,0,0,0
2005,3344,16,3,19,1,4,5,0,0,0,0,0,0
2005,3397,22,2,24,3,7,10,0,0,0,0,0,0
2005,3400,822,170,992,129,294,423,380,110,490,108,152,260
2005,3401,72,9,81,1,30,31,0,0,0,0,0,0
2005,3402,25,2,27,0,11,11,0,0,0,0,0,0
2005,3403,5,0,5,0,0,0,0,0,0,0,0,0
2005,3404,572,96,668,94,251,345,0,0,0,0,0,0
2005,3408,16,2,18,2,3,5,0,0,0,0,0,0
2005,3414,16,2,18,2,3,5,0,0,0,0,0,0
2005,3420,5,0,5,2,1,3,0,0,0,0,0,0
2005,3422,552,151,703,34,60,94,0,0,0,0,0,0
2005,3477,110,15,125,47,15,62,0,0,0,0,0,0
2005,3499,6296,657,6953,1304,1721,3025,0,0,0,0,0,0
2005,3500,25,2,27,0,7,7,0,0,0,17,9,26
2005,3501,24,5,29,0,5,5,0,0,0,0,0,0
2005,3600,1011,137,1148,295,560,855,338,87,425,150,352,502
2005,3601,32,2,34,2,17,19,0,0,0,0,0,0
2005,3602,91,9,100,2,43,45,0,0,0,0,0,0
2005,3603,71,2,73,1,25,26,0,0,0,0,0,0
2005,3604,137,16,153,11,55,66,0,0,0,0,0,0
2005,3605,51,5,56,1,23,24,0,0,0,0,0,0
2005,3607,207,11,218,10,86,96,0,0,0,0,0,0
2005,3608,83,14,97,25,48,73,0,0,0,0,0,0
2005,3609,95,16,111,7,33,40,0,0,0,0,0,0
2005,3610,278,24,302,27,125,152,0,0,0,3,5,8
2005,3611,74,2,76,6,35,41,0,0,0,0,0,0
2005,3614,11,1,12,23,6,29,0,0,0,0,0,0
2005,3623,21,3,24,39,22,61,0,0,0,0,0,0
2005,3639,6,2,8,2,5,7,0,0,0,0,0,0
2005,3650,15,3,18,1,6,7,0,0,0,0,0,0
2005,3700,1126,193,1319,292,498,790,606,197,803,281,427,708
2005,3701,96,9,105,5,35,40,0,0,0,0,0,0
2005,3702,196,24,220,32,69,101,1,0,1,7,7,14
2005,3703,38,4,42,4,15,19,0,0,0,0,0,0
2005,3705,130,6,136,12,55,67,0,0,0,0,0,0
2005,3706,144,19,163,11,48,59,0,0,0,0,0,0
2005,3708,52,7,59,4,19,23,0,0,0,0,0,0
2005,3709,82,5,87,7,32,39,0,0,0,0,0,0
2005,3710,168,19,187,20,70,90,0,0,0,0,0,0
2005,3711,1766,304,2070,278,475,753,0,0,0,0,0,0
2005,3714,31,2,33,7,13,20,0,0,0,0,0,0
2005,3715,111,22,133,8,19,27,0,0,0,0,0,0
2005,3732,10,2,12,1,5,6,0,0,0,0,0,0
2005,3797,23,6,29,14,10,24,0,0,0,0,0,0
2005,3800,246,54,300,52,62,114,392,104,496,13,6,19
2005,3801,1829,364,2193,146,214,360,0,0,0,0,0,0
2005,3803,23,6,29,11,8,19,0,0,0,0,0,0
2005,3816,11,1,12,0,0,0,0,0,0,0,0,0
2005,3897,32,6,38,45,20,65,0,0,0,0,0,0
2005,3900,225,30,255,22,106,128,25,2,27,164,124,288
2005,3901,11,0,11,1,2,3,0,0,0,0,0,0
2005,3902,70,6,76,4,33,37,0,0,0,0,0,0
2005,3903,62,4,66,6,17,23,0,0,0,0,0,0
2005,3904,21,3,24,1,8,9,0,0,0,0,0,0
2005,3905,352,36,388,64,146,210,0,0,0,0,0,0
2005,3906,71,6,77,9,30,39,0,0,0,0,0,0
2005,3915,15,1,16,0,4,4,0,0,0,0,0,0
2005,4000,139,5,144,9,46,55,0,0,0,79,54,133
2005,4001,23,4,27,3,6,9,0,0,0,0,0,0
2005,4002,15,1,16,2,6,8,0,0,0,0,0,0
2005,4003,15,2,17,1,3,4,0,0,0,0,0,0
2005,4004,37,3,40,0,12,12,0,0,0,0,0,0
2005,4005,21,2,23,1,10,11,0,0,0,0,0,0
2005,4006,48,9,57,3,21,24,0,0,0,0,0,0
2005,4007,12,2,14,3,13,16,0,0,0,0,0,0
2005,4008,24,5,29,2,7,9,0,0,0,0,0,0
2005,4016,88,45,133,2,10,12,0,0,0,0,0,0
2005,4019,6,0,6,0,1,1,0,0,0,0,0,0
2005,4100,150,29,179,52,102,154,141,43,184,21,18,39
2005,4101,18,2,20,0,5,5,0,0,0,0,0,0
2005,4102,27,2,29,5,7,12,0,0,0,0,0,0
2005,4103,12,5,17,0,3,3,0,0,0,0,0,0
2005,4104,35,5,40,3,15,18,0,0,0,0,0,0
2005,4105,16,2,18,0,5,5,0,0,0,0,0,0
2005,4106,104,11,115,12,27,39,0,0,0,0,0,0
2005,4107,18,0,18,1,4,5,0,0,0,0,0,0
2005,4108,21,3,24,1,8,9,0,0,0,0,0,0
2005,4109,37,9,46,5,14,19,0,0,0,0,0,0
2005,4110,17,1,18,1,6,7,0,0,0,0,0,0
2005,4111,36,2,38,3,9,12,0,0,0,0,0,0
2005,4113,78,14,92,11,41,52,0,0,0,0,0,0
2005,4114,42,3,45,2,19,21,0,0,0,0,0,0
2005,4115,24,8,32,1,12,13,0,0,0,0,0,0
2005,4116,98,11,109,6,33,39,0,0,0,0,0,0
2005,4117,64,8,72,8,23,31,0,0,0,0,0,0
2005,4119,10,0,10,0,1,1,0,0,0,0,0,0
2005,4120,31,5,36,6,11,17,0,0,0,0,0,0
2005,4127,35,2,37,1,8,9,0,0,0,0,0,0
2005,4200,247,15,262,22,99,121,3,0,3,158,81,239
2005,4201,11,1,12,0,3,3,0,0,0,0,0,0
2005,4202,45,5,50,1,7,8,0,0,0,7,7,14
2005,4203,123,9,132,17,52,69,0,0,0,0,0,0
2005,4204,97,9,106,4,39,43,0,0,0,0,0,0
2005,4211,5,1,6,10,5,15,0,0,0,0,0,0
2005,4297,27,3,30,6,8,14,0,0,0,0,0,0
2005,4300,395,57,452,68,119,187,34,8,42,0,0,0
2005,4302,42,3,45,3,18,21,0,0,0,0,0,0
2005,4304,53,6,59,8,26,34,0,0,0,2,3,5
2005,4305,29,2,31,8,7,15,0,0,0,0,0,0
2005,4307,40,4,44,2,13,15,0,0,0,0,0,0
2005,4308,81,8,89,4,22,26,0,0,0,0,0,0
2005,4310,32,2,34,4,14,18,0,0,0,0,0,0
2005,4311,85,11,96,14,35,49,0,0,0,0,0,0
2005,4312,63,24,87,22,48,70,0,0,0,0,0,0
2005,4313,1216,133,1349,79,287,366,0,0,0,0,0,0
2005,4314,122,10,132,18,50,68,0,0,0,3,3,6
2005,4316,204,16,220,20,45,65,0,0,0,0,0,0
2005,4317,25,3,28,21,13,34,0,0,0,0,0,0
2005,4320,5,1,6,2,2,4,0,0,0,0,0,0
2005,4321,7,2,9,2,2,4,0,0,0,0,0,0
2005,4327,9,0,9,5,3,8,0,0,0,0,0,0
2005,4400,113,24,137,0,35,35,4,1,5,89,34,123
2005,4401,18,1,19,5,7,12,0,0,0,0,0,0
2005,4402,79,11,90,8,20,28,0,0,0,0,0,0
2005,4403,59,5,64,5,16,21,0,0,0,0,0,0
2005,4404,19,1,20,2,6,8,0,0,0,0,0,0
2005,4497,14,4,18,8,17,25,0,0,0,0,0,0
2005,4500,77,11,88,5,46,51,14,3,17,45,28,73
2005,4501,16,2,18,0,11,11,0,0,0,0,0,0
2005,4502,108,5,113,12,37,49,0,0,0,0,0,0
2005,4600,10,0,10,0,1,1,0,0,0,1,3,4
2005,4700,57,1,58,5,20,25,30,8,38,0,7,7
2005,4703,1,0,1,0,1,1,0,0,0,0,0,0
2005,4706,8,1,9,2,6,8,0,0,0,0,0,0
2005,4707,2,1,3,0,0,0,0,0,0,0,0,0
2005,4708,9,1,10,4,3,7,0,0,0,0,0,0
2005,4709,15,0,15,4,2,6,0,0,0,0,0,0
2005,4710,4,0,4,0,1,1,0,0,0,0,0,0
2005,4800,98,8,106,17,64,81,1,0,1,169,81,250
2005,4801,33,1,34,1,12,13,0,0,0,0,0,0
2005,4802,21,3,24,1,4,5,0,0,0,0,0,0
2005,4803,106,8,114,11,52,63,0,0,0,0,0,0
2005,4804,9,1,10,0,3,3,0,0,0,0,0,0
2005,4805,20,2,22,3,7,10,0,0,0,0,0,0
2005,4806,92,10,102,7,51,58,0,0,0,0,0,0
2005,4807,131,10,141,11,46,57,0,0,0,0,0,0
2005,4813,5,1,6,0,1,1,0,0,0,0,0,0
2005,4900,227,13,240,22,79,101,25,8,33,184,95,279
2005,4901,13,1,14,1,6,7,0,0,0,0,0,0
2005,4902,13,0,13,1,6,7,0,0,0,0,0,0
2005,4903,16,2,18,9,2,11,0,0,0,0,0,0
2005,4904,72,2,74,5,30,35,0,0,0,0,0,0
2005,4905,135,18,153,16,75,91,0,0,0,0,0,0
2005,4906,11,3,14,1,6,7,0,0,0,0,0,0
2005,4908,59,10,69,1,26,27,0,0,0,0,0,0
2005,4909,7,3,10,6,5,11,0,0,0,0,0,0
2005,4914,11,1,12,4,5,9,0,0,0,0,0,0
2005,5000,195,10,205,9,86,95,28,0,28,175,87,262
2005,5001,39,3,42,4,17,21,0,0,0,0,0,0
2005,5002,247,13,260,12,96,108,0,0,0,0,0,0
2005,5003,12,0,12,0,2,2,0,0,0,0,0,0
2005,5004,25,2,27,3,6,9,0,0,0,0,0,0
2005,5005,14,0,14,0,2,2,0,0,0,0,0,0
2005,5006,16,1,17,1,2,3,0,0,0,0,0,0
2005,5007,59,4,63,2,30,32,0,0,0,0,0,0
2005,5009,5,1,6,0,1,1,0,0,0,0,0,0
2005,5010,10,1,11,3,6,9,0,0,0,0,0,0
2005,5100,44,5,49,3,19,22,33,17,50,0,3,3
2005,5102,43,7,50,5,18,23,0,0,0,0,0,0
2005,5200,43,2,45,2,19,21,28,5,33,1,6,7
2005,5201,13,0,13,1,6,7,0,0,0,0,0,0
2005,5202,21,3,24,3,11,14,0,0,0,0,0,0
2005,5300,20,0,20,1,5,6,0,0,0,5,8,13
2005,5400,230,25,255,9,87,96,163,33,196,39,54,93
2005,5401,27,0,27,2,7,9,0,0,0,0,0,0
2005,5402,12,3,15,0,2,2,0,0,0,0,0,0
2005,5403,14,0,14,0,1,1,0,0,0,0,0,0
2005,5404,12,1,13,4,3,7,0,0,0,0,0,0
2005,5405,43,4,47,3,19,22,0,0,0,0,0,0
2005,5406,47,12,59,6,17,23,0,0,0,0,0,0
2005,5407,108,8,116,13,41,54,0,0,0,0,0,0
2005,5408,13,0,13,0,2,2,0,0,0,0,0,0
2005,5411,4,1,5,0,1,1,0,0,0,0,0,0
2005,5500,67,2,69,2,23,25,0,0,0,17,20,37
2005,5501,13,2,15,0,4,4,0,0,0,0,0,0
2005,5600,371,35,406,80,160,240,234,41,275,97,77,174
2005,5604,198,28,226,35,76,111,0,0,0,5,4,9
2005,5605,23,1,24,1,7,8,0,0,0,0,0,0
2005,5606,32,1,33,2,7,9,0,0,0,0,0,0
2005,5608,117,10,127,16,36,52,0,0,0,0,0,0
2005,5609,114,9,123,17,50,67,0,0,0,0,0,0
2005,5622,12,2,14,1,4,5,0,0,0,0,0,0
2005,5700,71,9,80,6,27,33,2,0,2,71,46,117
2005,5701,50,6,56,8,29,37,0,0,0,0,0,0
2005,5702,11,0,11,0,2,2,0,0,0,0,0,0
2005,5703,56,4,60,1,26,27,0,0,0,0,0,0
2005,5704,63,6,69,2,33,35,0,0,0,0,0,0
2005,5797,31,9,40,8,21,29,0,0,0,0,0,0
2005,5800,50,5,55,6,23,29,47,21,68,6,4,10
2005,5801,22,1,23,1,10,11,0,0,0,0,0,0
2005,5802,5,1,6,0,0,0,0,0,0,0,0,0
2005,190C,13,2,15,2,4,6,0,0,0,0,0,0
2005,190R,7,1,8,4,2,6,0,0,0,0,0,0
2006,100,471,62,533,143,215,358,347,55,402,98,144,242
2006,101,89,9,98,4,31,35,0,0,0,4,5,9
2006,102,27,0,27,2,8,10,0,0,0,0,0,0
2006,103,146,37,183,23,68,91,1,0,1,7,7,14
2006,104,29,2,31,3,14,17,0,0,0,0,0,0
2006,105,172,15,187,14,73,87,1,0,1,8,8,16
2006,106,168,23,191,25,77,102,0,0,0,12,7,19
2006,107,86,9,95,6,44,50,0,0,0,0,0,0
2006,108,51,6,57,5,20,25,0,0,0,0,0,0
2006,109,583,105,688,71,250,321,0,0,0,0,0,0
2006,110,16,2,18,2,6,8,0,0,0,0,0,0
2006,111,72,11,83,5,30,35,0,0,0,0,0,0
2006,112,87,6,93,5,31,36,0,0,0,3,4,7
2006,113,69,9,78,8,26,34,0,0,0,0,0,0
2006,114,50,7,57,4,18,22,0,0,0,0,0,0
2006,115,9,5,14,5,9,14,0,0,0,0,0,0
2006,122,1,0,1,4,4,8,0,0,0,0,0,0
2006,197,58,15,73,26,33,59,0,0,0,0,0,0
2006,200,12,0,12,1,3,4,0,0,0,0,0,0
2006,300,44,0,44,1,19,20,1,0,1,12,14,26
2006,302,6,0,6,0,1,1,0,0,0,0,0,0
2006,303,10,1,11,0,2,2,0,0,0,0,0,0
2006,305,7,0,7,0,0,0,0,0,0,0,0,0
2006,400,100,7,107,6,45,51,1,0,1,67,43,110
2006,402,95,7,102,10,45,55,0,0,0,0,0,0
2006,403,16,1,17,0,3,3,0,0,0,0,0,0
2006,404,24,1,25,2,10,12,0,0,0,0,0,0
2006,405,26,0,26,2,12,14,0,0,0,0,0,0
2006,497,14,3,17,3,8,11,0,0,0,0,0,0
2006,500,51,4,55,7,20,27,1,0,1,9,9,18
2006,501,9,0,9,0,1,1,0,0,0,0,0,0
2006,600,26,1,27,0,17,17,2,0,2,5,6,11
2006,601,6,2,8,0,1,1,0,0,0,0,0,0
2006,602,8,0,8,0,2,2,0,0,0,0,0,0
2006,700,398,61,459,58,170,228,213,39,252,36,57,93
2006,701,97,8,105,7,38,45,0,0,0,2,2,4
2006,702,48,6,54,2,12,14,0,0,0,0,0,0
2006,703,10,1,11,0,2,2,0,0,0,0,0,0
2006,704,129,25,154,13,40,53,0,0,0,5,0,5
2006,705,37,1,38,1,8,9,0,0,0,0,0,0
2006,706,25,2,27,1,2,3,0,0,0,0,0,0
2006,707,26,2,28,3,13,16,0,0,0,0,0,0
2006,708,65,7,72,1,20,21,0,0,0,0,6,6
2006,709,38,4,42,3,18,21,0,0,0,0,0,0
2006,710,138,15,153,11,52,63,0,0,0,1,4,5
2006,711,49,4,53,4,13,17,0,0,0,0,0,0
2006,712,66,12,78,4,33,37,0,0,0,0,0,0
2006,713,9,1,10,0,1,1,0,0,0,0,0,0
2006,714,38,1,39,3,12,15,0,0,0,0,0,0
2006,716,8,3,11,0,1,1,0,0,0,0,0,0
2006,718,155,21,176,54,39,93,0,0,0,0,0,0
2006,721,19,2,21,4,6,10,0,0,0,0,0,0
2006,800,24,2,26,3,5,8,3,0,3,12,9,21
2006,801,10,1,11,0,1,1,0,0,0,0,0,0
2006,900,163,9,172,9,66,75,19,1,20,51,50,101
2006,901,17,1,18,2,9,11,0,0,0,0,0,0
2006,902,33,5,38,8,14,22,0,0,0,0,0,0
2006,1000,426,45,471,76,74,150,16,2,18,342,145,487
2006,1001,88,14,102,7,35,42,0,0,0,2,2,4
2006,1002,17,1,18,3,6,9,0,0,0,0,0,0
2006,1003,9,2,11,0,4,4,0,0,0,0,0,0
2006,1004,8,0,8,0,2,2,0,0,0,0,0,0
2006,1005,707,91,798,144,275,419,0,0,0,0,0,0
2006,1006,11,0,11,1,3,4,0,0,0,0,0,0
2006,1007,17,1,18,1,2,3,0,0,0,0,0,0
2006,1008,14,1,15,0,5,5,0,0,0,0,0,0
2006,1011,12,1,13,0,3,3,0,0,0,0,0,0
2006,1012,28,2,30,2,14,16,0,0,0,0,0,0
2006,1013,29,1,30,2,7,9,0,0,0,0,0,0
2006,1015,31,3,34,3,10,13,0,0,0,0,0,0
2006,1017,12,1,13,1,3,4,0,0,0,0,0,0
2006,1097,14,3,17,1,8,9,0,0,0,0,0,0
2006,1100,24,3,27,3,10,13,1,0,1,14,13,27
2006,1101,11,1,12,1,2,3,0,0,0,0,0,0
2006,1102,6,2,8,0,1,1,0,0,0,0,0,0
2006,1200,70,7,77,7,32,39,70,24,94,5,8,13
2006,1201,21,2,23,3,8,11,0,0,0,0,0,0
2006,1202,3,2,5,2,0,2,0,0,0,0,0,0
2006,1203,37,6,43,4,22,26,0,0,0,0,0,0
2006,1204,3,1,4,0,0,0,0,0,0,0,0,0
2006,1205,14,1,15,1,7,8,0,0,0,0,0,0
2006,1206,1,1,2,0,0,0,0,0,0,0,0,0
2006,1207,5,0,5,0,0,0,0,0,0,0,0,0
2006,1208,6,4,10,2,9,11,0,0,0,0,0,0
2006,1300,93,4,97,11,42,53,59,18,77,10,19,29
2006,1301,27,1,28,1,11,12,0,0,0,0,0,0
2006,1302,44,2,46,5,15,20,0,0,0,0,0,0
2006,1303,6,0,6,0,0,0,0,0,0,0,0,0
2006,1304,47,1,48,7,17,24,0,0,0,0,0,0
2006,1305,7,0,7,0,0,0,0,0,0,0,0,0
2006,1306,17,1,18,2,1,3,0,0,0,0,0,0
2006,1307,5,0,5,0,0,0,0,0,0,0,0,0
2006,1400,26,0,26,3,12,15,18,7,25,1,3,4
2006,1401,12,1,13,2,4,6,0,0,0,0,0,0
2006,1500,348,25,373,58,182,240,92,15,107,229,150,379
2006,1501,12,2,14,2,4,6,0,0,0,0,0,0
2006,1502,300,21,321,37,119,156,0,0,0,0,0,0
2006,1503,46,2,48,2,11,13,0,0,0,4,0,4
2006,1506,29,2,31,3,12,15,0,0,0,0,0,0
2006,1507,20,1,21,1,7,8,0,0,0,0,0,0
2006,1508,9,2,11,1,9,10,0,0,0,0,0,0
2006,1511,13,2,15,2,4,6,0,0,0,0,0,0
2006,1514,4,0,4,0,0,0,0,0,0,0,0,0
2006,1515,8,0,8,2,6,8,0,0,0,0,0,0
2006,1597,9,2,11,0,4,4,0,0,0,0,0,0
2006,1600,81,5,86,2,36,38,0,0,0,39,45,84
2006,1601,18,1,19,1,8,9,0,0,0,0,0,0
2006,1602,46,7,53,1,18,19,0,0,0,0,0,0
2006,1603,26,3,29,3,3,6,0,0,0,0,0,0
2006,1700,51,3,54,2,17,19,2,0,2,36,32,68
2006,1701,12,0,12,0,2,2,0,0,0,0,0,0
2006,1702,22,2,24,0,5,5,0,0,0,0,0,0
2006,1800,31,1,32,1,7,8,25,13,38,3,10,13
2006,1801,16,1,17,0,2,2,0,0,0,0,0,0
2006,1900,5089,829,5918,1239,2108,3347,2037,504,2541,959,1575,2534
2006,1901,72,10,82,8,36,44,0,0,0,0,0,0
2006,1902,54,5,59,9,23,32,0,0,0,1,4,5
2006,1905,53,1,54,5,20,25,0,0,0,0,0,0
2006,1906,65,5,70,1,23,24,0,0,0,5,0,5
2006,1907,38,2,40,1,11,12,0,0,0,0,0,0
2006,1909,48,3,51,4,14,18,0,0,0,0,0,0
2006,1910,123,8,131,14,43,57,0,0,0,1,5,6
2006,1912,144,11,155,19,65,84,0,0,0,7,4,11
2006,1913,38,4,42,1,14,15,0,0,0,5,1,6
2006,1916,52,2,54,5,21,26,0,0,0,3,1,4
2006,1918,114,3,117,13,22,35,0,0,0,2,0,2
2006,1920,99,11,110,12,38,50,0,0,0,0,0,0
2006,1922,149,10,159,18,42,60,0,0,0,6,3,9
2006,1923,57,5,62,4,22,26,0,0,0,5,2,7
2006,1924,67,7,74,0,14,14,0,0,0,4,4,8
2006,1925,231,25,256,26,77,103,1,0,1,13,7,20
2006,1926,50,7,57,10,29,39,0,0,0,2,3,5
2006,1928,87,6,93,6,29,35,0,0,0,7,6,13
2006,1929,34,3,37,12,4,16,0,0,0,2,8,10
2006,1931,60,2,62,14,21,35,0,0,0,4,1,5
2006,1933,169,23,192,13,52,65,0,0,0,2,10,12
2006,1934,27,0,27,0,8,8,0,0,0,0,0,0
2006,1938,44,4,48,4,14,18,0,0,0,2,0,2
2006,1941,809,84,893,157,239,396,8,0,8,41,25,66
2006,1942,7629,1743,9372,928,2014,2942,19,2,21,222,128,350
2006,1944,52,6,58,7,16,23,0,0,0,4,2,6
2006,1945,38,0,38,1,7,8,0,0,0,3,3,6
2006,1946,48,7,55,4,18,22,0,0,0,0,2,2
2006,1947,71,6,77,4,27,31,0,0,0,4,1,5
2006,1948,65,12,77,3,25,28,0,0,0,3,2,5
2006,1951,21,3,24,2,4,6,0,0,0,2,2,4
2006,1953,204,36,240,32,73,105,0,0,0,14,8,22
2006,1955,173,12,185,27,93,120,1,0,1,9,10,19
2006,1956,99,5,104,9,36,45,0,0,0,2,6,8
2006,1961,31,2,33,1,8,9,0,0,0,5,2,7
2006,1962,50,2,52,3,10,13,0,0,0,0,0,0
2006,1963,18,5,23,1,6,7,0,0,0,0,0,0
2006,1965,179,22,201,86,99,185,2,1,3,7,6,13
2006,1966,14,3,17,0,4,4,0,0,0,0,0,0
2006,1967,29,4,33,5,9,14,0,0,0,0,0,0
2006,1969,82,4,86,6,30,36,0,0,0,3,2,5
2006,1970,32,2,34,4,9,13,0,0,0,0,0,0
2006,1972,226,13,239,29,52,81,1,0,1,8,7,15
2006,1973,48,3,51,0,16,16,0,0,0,3,0,3
2006,1975,106,6,112,11,31,42,0,0,0,3,1,4
2006,1976,110,9,119,17,28,45,0,0,0,0,0,0
2006,1978,18,2,20,5,7,12,0,0,0,0,0,0
2006,1981,12,2,14,2,2,4,0,0,0,0,0,0
2006,1982,21,3,24,4,4,8,0,0,0,0,0,0
2006,1983,14,3,17,5,11,16,0,0,0,0,0,0
2006,1984,18,2,20,7,8,15,0,0,0,0,0,0
2006,1997,50,5,55,16,21,37,0,0,0,0,0,0
2006,2000,72,4,76,5,26,31,0,0,0,0,0,0
2006,2001,14,2,16,0,7,7,0,0,0,0,0,0
2006,2002,52,5,57,2,19,21,0,0,0,0,0,0
2006,2100,103,16,119,25,53,78,64,16,80,12,16,28
2006,2101,7,0,7,0,1,1,0,0,0,0,0,0
2006,2103,10,1,11,2,3,5,0,0,0,0,0,0
2006,2104,28,1,29,0,11,11,0,0,0,0,0,0
2006,2105,20,2,22,1,5,6,0,0,0,0,0,0
2006,2106,46,9,55,1,16,17,0,0,0,0,0,0
2006,2107,8,0,8,0,0,0,0,0,0,0,0,0
2006,2108,15,3,18,0,6,6,0,0,0,0,0,0
2006,2109,62,7,69,5,22,27,0,0,0,0,0,0
2006,2110,14,4,18,1,4,5,0,0,0,0,0,0
2006,2111,12,1,13,0,4,4,0,0,0,0,0,0
2006,2113,5,0,5,1,0,1,0,0,0,0,0,0
2006,2200,35,5,40,3,11,14,8,9,17,0,0,0
2006,2300,72,2,74,6,26,32,40,15,55,1,9,10
2006,2301,12,2,14,2,3,5,0,0,0,0,0,0
2006,2303,28,0,28,3,7,10,0,0,0,0,0,0
2006,2304,13,0,13,2,5,7,0,0,0,0,0,0
2006,2400,104,2,106,3,25,28,60,23,83,12,9,21
2006,2401,32,0,32,1,8,9,0,0,0,0,0,0
2006,2402,3,2,5,0,2,2,0,0,0,0,0,0
2006,2403,10,0,10,0,3,3,0,0,0,0,0,0
2006,2404,19,1,20,1,8,9,0,0,0,0,0,0
2006,2405,37,4,41,9,13,22,0,0,0,0,0,0
2006,2406,90,4,94,6,34,40,0,0,0,0,0,0
2006,2412,6,2,8,1,6,7,0,0,0,0,0,0
2006,2500,12,1,13,1,2,3,5,4,9,0,0,0
2006,2501,6,0,6,0,1,1,0,0,0,0,0,0
2006,2600,26,0,26,0,2,2,0,0,0,10,5,15
2006,2601,20,1,21,1,4,5,0,0,0,0,0,0
2006,2700,144,13,157,7,60,67,122,33,155,16,23,39
2006,2701,9,1,10,1,5,6,0,0,0,0,0,0
2006,2702,6,0,6,0,0,0,0,0,0,0,0,0
2006,2703,11,2,13,0,1,1,0,0,0,0,0,0
2006,2704,15,1,16,1,3,4,0,0,0,0,0,0
2006,2705,12,1,13,1,2,3,0,0,0,0,0,0
2006,2706,40,7,47,3,5,8,0,0,0,7,6,13
2006,2707,14,6,20,2,5,7,0,0,0,0,0,0
2006,2708,146,15,161,12,41,53,0,0,0,0,0,0
2006,2709,9,1,10,0,1,1,0,0,0,0,0,0
2006,2710,36,5,41,4,11,15,0,0,0,0,0,0
2006,2711,20,2,22,0,3,3,0,0,0,0,0,0
2006,2712,24,2,26,1,7,8,0,0,0,0,0,0
2006,2714,6,0,6,0,1,1,0,0,0,0,0,0
2006,2719,12,2,14,1,1,2,0,0,0,0,0,0
2006,2800,84,4,88,11,23,34,0,0,0,0,0,0
2006,2801,8,2,10,1,3,4,0,0,0,0,0,0
2006,2802,63,8,71,4,39,43,0,0,0,0,0,0
2006,2803,11,1,12,0,4,4,0,0,0,0,0,0
2006,2808,80,8,88,2,4,6,0,0,0,0,0,0
2006,2900,64,4,68,7,36,43,2,0,2,31,42,73
2006,2901,22,0,22,3,8,11,0,0,0,0,0,0
2006,2902,11,0,11,0,1,1,0,0,0,0,0,0
2006,2908,23,0,23,0,4,4,0,0,0,0,0,0
2006,3000,913,102,1015,566,645,1211,593,87,680,311,179,490
2006,3001,360,28,388,33,130,163,14,8,22,0,6,6
2006,3002,97,10,107,5,33,38,0,0,0,1,0,1
2006,3003,83,8,91,13,35,48,0,0,0,3,1,4
2006,3004,139,12,151,12,52,64,0,0,0,6,3,9
2006,3005,54,2,56,2,9,11,0,0,0,3,3,6
2006,3006,22,2,24,0,7,7,0,0,0,0,0,0
2006,3007,56,7,63,2,16,18,0,0,0,0,0,0
2006,3008,144,14,158,8,53,61,0,0,0,3,1,4
2006,3009,150,8,158,20,51,71,0,0,0,0,0,0
2006,3010,206,11,217,31,88,119,0,0,0,11,8,19
2006,3011,40,7,47,6,27,33,0,0,0,0,0,0
2006,3012,67,3,70,9,27,36,0,0,0,0,0,0
2006,3013,19,3,22,0,4,4,0,0,0,0,0,0
2006,3014,133,8,141,33,55,88,0,0,0,7,2,9
2006,3015,142,16,158,14,54,68,0,0,0,0,0,0
2006,3016,51,2,53,3,14,17,0,0,0,0,0,0
2006,3019,334,26,360,45,134,179,0,0,0,54,62,116
2006,3020,27,3,30,3,7,10,0,0,0,0,0,0
2006,3022,85,8,93,5,36,41,0,0,0,0,0,0
2006,3024,92,7,99,6,37,43,0,0,0,2,0,2
2006,3026,135,28,163,27,62,89,0,0,0,0,0,0
2006,3027,18,4,22,2,7,9,0,0,0,0,0,0
2006,3097,21,4,25,6,8,14,0,0,0,0,0,0
2006,3100,143,14,157,12,102,114,46,4,50,65,38,103
2006,3101,23,1,24,2,9,11,0,0,0,0,0,0
2006,3103,29,1,30,1,6,7,0,0,0,0,0,0
2006,3104,46,4,50,3,26,29,0,0,0,0,0,0
2006,3105,124,8,132,15,48,63,0,0,0,4,6,10
2006,3200,35,0,35,1,16,17,0,0,0,9,9,18
2006,3300,1440,135,1575,169,620,789,216,27,243,489,246,735
2006,3301,40,1,41,1,19,20,0,0,0,0,0,0
2006,3302,26,1,27,1,10,11,0,0,0,0,0,0
2006,3303,23,0,23,6,10,16,0,0,0,0,0,0
2006,3306,24,1,25,4,3,7,0,0,0,0,0,0
2006,3308,79,2,81,3,29,32,0,0,0,0,0,0
2006,3309,77,2,79,17,29,46,0,0,0,0,0,0
2006,3311,79,10,89,20,34,54,0,0,0,4,4,8
2006,3313,354,35,389,31,145,176,0,0,0,0,0,0
2006,3314,29,3,32,1,7,8,0,0,0,0,0,0
2006,3315,152,20,172,16,67,83,0,0,0,2,2,4
2006,3325,51,4,55,7,24,31,0,0,0,0,0,0
2006,3342,74,4,78,4,30,34,0,0,0,0,0,0
2006,3344,14,2,16,1,4,5,0,0,0,0,0,0
2006,3397,21,3,24,1,7,8,0,0,0,0,0,0
2006,3400,712,140,852,123,258,381,417,123,540,100,130,230
2006,3401,77,8,85,1,30,31,0,0,0,0,0,0
2006,3402,25,2,27,0,11,11,0,0,0,0,0,0
2006,3403,4,0,4,0,0,0,0,0,0,0,0,0
2006,3404,558,105,663,144,276,420,0,0,0,0,0,0
2006,3408,18,2,20,0,6,6,0,0,0,0,0,0
2006,3414,19,2,21,5,1,6,0,0,0,0,0,0
2006,3420,4,0,4,3,1,4,0,0,0,0,0,0
2006,3422,552,151,703,34,60,94,0,0,0,0,0,0
2006,3477,109,10,119,43,13,56,0,0,0,0,0,0
2006,3499,6170,637,6807,1388,1706,3094,0,0,0,0,0,0
2006,3500,28,2,30,0,6,6,0,0,0,17,12,29
2006,3501,25,4,29,0,5,5,0,0,0,0,0,0
2006,3600,1144,157,1301,274,628,902,371,89,460,169,414,583
2006,3601,32,2,34,3,13,16,0,0,0,0,0,0
2006,3602,85,10,95,3,45,48,0,0,0,0,0,0
2006,3603,68,2,70,4,26,30,0,0,0,0,0,0
2006,3604,157,17,174,8,62,70,0,0,0,0,0,0
2006,3605,48,7,55,1,21,22,0,0,0,0,0,0
2006,3607,215,10,225,10,92,102,0,0,0,0,0,0
2006,3608,79,16,95,23,48,71,0,0,0,0,0,0
2006,3609,76,12,88,9,27,36,0,0,0,0,0,0
2006,3610,282,26,308,28,119,147,0,0,0,2,9,11
2006,3611,77,3,80,5,37,42,0,0,0,0,0,0
2006,3614,13,2,15,3,6,9,0,0,0,0,0,0
2006,3623,22,2,24,35,18,53,0,0,0,0,0,0
2006,3639,12,2,14,2,2,4,0,0,0,0,0,0
2006,3650,11,3,14,2,6,8,0,0,0,0,0,0
2006,3700,1105,191,1296,327,523,850,623,193,816,288,429,717
2006,3701,99,13,112,7,36,43,0,0,0,0,0,0
2006,3702,217,23,240,32,69,101,1,0,1,7,7,14
2006,3703,36,5,41,3,17,20,0,0,0,0,0,0
2006,3705,134,7,141,16,65,81,0,0,0,0,0,0
2006,3706,143,20,163,12,52,64,0,0,0,0,0,0
2006,3708,60,7,67,4,21,25,0,0,0,0,0,0
2006,3709,74,6,80,6,26,32,0,0,0,0,0,0
2006,3710,180,19,199,16,71,87,0,0,0,0,0,0
2006,3711,1623,288,1911,307,483,790,0,0,0,0,0,0
2006,3714,23,1,24,7,12,19,0,0,0,0,0,0
2006,3715,116,20,136,13,15,28,0,0,0,0,0,0
2006,3732,12,1,13,4,4,8,0,0,0,0,0,0
2006,3797,24,6,30,13,13,26,0,0,0,0,0,0
2006,3800,241,50,291,66,57,123,396,103,499,9,8,17
2006,3801,1834,368,2202,132,207,339,0,0,0,0,0,0
2006,3803,23,5,28,10,12,22,0,0,0,0,0,0
2006,3816,11,1,12,0,0,0,0,0,0,0,0,0
2006,3897,29,6,35,43,20,63,0,0,0,0,0,0
2006,3900,232,29,261,23,108,131,26,2,28,179,118,297
2006,3901,11,0,11,0,3,3,0,0,0,0,0,0
2006,3902,69,7,76,2,28,30,0,0,0,0,0,0
2006,3903,66,4,70,6,20,26,0,0,0,0,0,0
2006,3904,23,3,26,1,11,12,0,0,0,0,0,0
2006,3905,366,38,404,61,141,202,0,0,0,0,0,0
2006,3906,72,5,77,12,32,44,0,0,0,0,0,0
2006,3915,15,0,15,2,4,6,0,0,0,0,0,0
2006,4000,145,5,150,10,48,58,0,0,0,94,52,146
2006,4001,23,4,27,3,6,9,0,0,0,0,0,0
2006,4002,17,1,18,3,6,9,0,0,0,0,0,0
2006,4003,15,2,17,1,5,6,0,0,0,0,0,0
2006,4004,35,3,38,2,11,13,0,0,0,0,0,0
2006,4005,19,3,22,0,11,11,0,0,0,0,0,0
2006,4006,48,9,57,3,23,26,0,0,0,0,0,0
2006,4007,13,2,15,3,12,15,0,0,0,0,0,0
2006,4008,23,5,28,6,9,15,0,0,0,0,0,0
2006,4016,81,41,122,2,11,13,0,0,0,0,0,0
2006,4019,6,0,6,1,0,1,0,0,0,0,0,0
2006,4100,215,27,242,56,93,149,159,41,200,14,35,49
2006,4101,19,2,21,1,5,6,0,0,0,0,0,0
2006,4102,29,2,31,3,8,11,0,0,0,0,0,0
2006,4103,12,5,17,0,3,3,0,0,0,0,0,0
2006,4104,36,6,42,3,15,18,0,0,0,0,0,0
2006,4105,17,2,19,0,7,7,0,0,0,0,0,0
2006,4106,94,11,105,14,27,41,0,0,0,0,0,0
2006,4107,18,0,18,1,4,5,0,0,0,0,0,0
2006,4108,22,3,25,1,8,9,0,0,0,0,0,0
2006,4109,36,11,47,6,13,19,0,0,0,0,0,0
2006,4110,17,1,18,2,6,8,0,0,0,0,0,0
2006,4111,37,2,39,2,12,14,0,0,0,0,0,0
2006,4113,78,14,92,4,31,35,0,0,0,0,0,0
2006,4114,41,7,48,1,16,17,0,0,0,0,0,0
2006,4115,22,8,30,1,10,11,0,0,0,0,0,0
2006,4116,101,12,113,5,35,40,0,0,0,0,0,0
2006,4117,66,8,74,8,23,31,0,0,0,0,0,0
2006,4119,10,0,10,0,1,1,0,0,0,0,0,0
2006,4120,31,5,36,6,11,17,0,0,0,0,0,0
2006,4127,32,2,34,1,7,8,0,0,0,0,0,0
2006,4200,295,16,311,21,94,115,3,0,3,167,71,238
2006,4201,11,1,12,0,3,3,0,0,0,0,0,0
2006,4202,44,5,49,1,7,8,0,0,0,7,7,14
2006,4203,124,14,138,17,49,66,0,0,0,0,0,0
2006,4204,96,10,106,2,38,40,0,0,0,0,0,0
2006,4211,5,1,6,8,6,14,0,0,0,0,0,0
2006,4297,23,3,26,8,9,17,0,0,0,0,0,0
2006,4300,387,59,446,86,110,196,33,8,41,0,0,0
2006,4302,40,3,43,3,18,21,0,0,0,0,0,0
2006,4304,52,7,59,8,27,35,0,0,0,2,3,5
2006,4305,29,1,30,3,11,14,0,0,0,0,0,0
2006,4307,38,4,42,2,13,15,0,0,0,0,0,0
2006,4308,78,8,86,5,20,25,0,0,0,0,0,0
2006,4310,30,2,32,4,13,17,0,0,0,0,0,0
2006,4311,83,10,93,15,31,46,0,0,0,0,0,0
2006,4312,61,23,84,21,44,65,0,0,0,0,0,0
2006,4313,1241,132,1373,78,298,376,0,0,0,0,0,0
2006,4314,118,11,129,18,50,68,0,0,0,3,3,6
2006,4316,202,17,219,20,51,71,0,0,0,0,0,0
2006,4317,26,3,29,27,17,44,0,0,0,0,0,0
2006,4320,5,1,6,4,3,7,0,0,0,0,0,0
2006,4321,7,2,9,2,2,4,0,0,0,0,0,0
2006,4327,11,0,11,6,3,9,0,0,0,0,0,0
2006,4400,107,22,129,13,33,46,4,1,5,82,36,118
2006,4401,19,2,21,5,7,12,0,0,0,0,0,0
2006,4402,77,11,88,7,20,27,0,0,0,0,0,0
2006,4403,61,4,65,5,17,22,0,0,0,0,0,0
2006,4404,17,0,17,2,5,7,0,0,0,0,0,0
2006,4497,12,4,16,9,18,27,0,0,0,0,0,0
2006,4500,75,11,86,7,49,56,18,2,20,15,17,32
2006,4501,17,3,20,0,10,10,0,0,0,0,0,0
2006,4502,112,5,117,11,41,52,0,0,0,0,0,0
2006,4600,11,0,11,0,1,1,0,0,0,1,2,3
2006,4700,59,2,61,5,20,25,30,8,38,0,7,7
2006,4703,2,0,2,0,1,1,0,0,0,0,0,0
2006,4706,8,1,9,1,5,6,0,0,0,0,0,0
2006,4707,3,0,3,0,0,0,0,0,0,0,0,0
2006,4708,8,0,8,3,4,7,0,0,0,0,0,0
2006,4709,14,0,14,2,4,6,0,0,0,0,0,0
2006,4710,4,0,4,0,1,1,0,0,0,0,0,0
2006,4800,101,8,109,14,66,80,1,0,1,177,83,260
2006,4801,31,1,32,0,14,14,0,0,0,0,0,0
2006,4802,20,5,25,1,5,6,0,0,0,0,0,0
2006,4803,115,7,122,11,55,66,0,0,0,0,0,0
2006,4804,12,2,14,1,4,5,0,0,0,0,0,0
2006,4805,22,1,23,3,9,12,0,0,0,0,0,0
2006,4806,92,9,101,8,57,65,0,0,0,0,0,0
2006,4807,126,10,136,9,44,53,0,0,0,0,0,0
2006,4813,6,0,6,0,1,1,0,0,0,0,0,0
2006,4900,239,16,255,16,73,89,27,7,34,196,98,294
2006,4901,13,1,14,1,7,8,0,0,0,0,0,0
2006,4902,13,0,13,0,7,7,0,0,0,0,0,0
2006,4903,16,2,18,2,9,11,0,0,0,0,0,0
2006,4904,70,3,73,5,28,33,0,0,0,0,0,0
2006,4905,143,19,162,13,74,87,0,0,0,0,0,0
2006,4906,11,3,14,1,6,7,0,0,0,0,0,0
2006,4908,66,8,74,2,24,26,0,0,0,0,0,0
2006,4909,10,3,13,3,5,8,0,0,0,0,0,0
2006,4914,11,1,12,5,7,12,0,0,0,0,0,0
2006,5000,195,10,205,9,86,95,175,87,262,28,2,30
2006,5001,43,3,46,7,15,22,0,0,0,0,0,0
2006,5002,254,12,266,16,94,110,0,0,0,0,0,0
2006,5003,10,1,11,0,2,2,0,0,0,0,0,0
2006,5004,25,1,26,3,7,10,0,0,0,0,0,0
2006,5005,16,0,16,0,2,2,0,0,0,0,0,0
2006,5006,17,1,18,0,4,4,0,0,0,0,0,0
2006,5007,59,5,64,2,32,34,0,0,0,0,0,0
2006,5009,5,1,6,0,1,1,0,0,0,0,0,0
2006,5010,10,1,11,3,8,11,0,0,0,0,0,0
2006,5100,43,4,47,3,19,22,33,18,51,0,5,5
2006,5102,54,9,63,5,26,31,0,0,0,0,0,0
2006,5200,43,2,45,2,19,21,24,6,30,1,7,8
2006,5201,14,0,14,1,7,8,0,0,0,0,0,0
2006,5202,21,3,24,3,11,14,0,0,0,0,0,0
2006,5300,18,0,18,1,5,6,0,0,0,8,6,14
2006,5400,246,29,275,16,82,98,185,39,224,49,48,97
2006,5401,28,2,30,1,8,9,0,0,0,0,0,0
2006,5402,14,2,16,0,2,2,0,0,0,0,0,0
2006,5403,14,0,14,0,1,1,0,0,0,0,0,0
2006,5404,11,1,12,4,3,7,0,0,0,0,0,0
2006,5405,43,3,46,4,17,21,0,0,0,0,0,0
2006,5406,48,11,59,4,18,22,0,0,0,0,0,0
2006,5407,109,13,122,12,38,50,0,0,0,0,0,0
2006,5408,13,0,13,0,2,2,0,0,0,0,0,0
2006,5411,4,1,5,0,1,1,0,0,0,0,0,0
2006,5500,63,2,65,2,21,23,0,0,0,25,19,44
2006,5501,13,1,14,0,4,4,0,0,0,0,0,0
2006,5600,466,52,518,85,204,289,182,33,215,103,91,194
2006,5604,206,26,232,33,76,109,0,0,0,5,4,9
2006,5605,23,2,25,1,6,7,0,0,0,0,0,0
2006,5606,28,2,30,4,7,11,0,0,0,0,0,0
2006,5608,115,10,125,7,42,49,0,0,0,0,0,0
2006,5609,113,8,121,18,43,61,0,0,0,0,0,0
2006,5622,13,1,14,2,3,5,0,0,0,0,0,0
2006,5680,16,1,17,0,0,0,0,0,0,0,0,0
2006,5700,76,13,89,7,29,36,2,0,2,75,50,125
2006,5701,51,4,55,11,25,36,0,0,0,0,0,0
2006,5702,10,0,10,0,2,2,0,0,0,0,0,0
2006,5703,54,9,63,2,25,27,0,0,0,0,0,0
2006,5704,63,7,70,9,29,38,0,0,0,0,0,0
2006,5797,32,9,41,5,21,26,0,0,0,0,0,0
2006,5800,56,5,61,4,25,29,48,20,68,7,5,12
2006,5801,22,2,24,0,11,11,0,0,0,0,0,0
2006,5802,5,1,6,0,0,0,0,0,0,0,0,0
2006,190C,13,2,15,2,4,6,0,0,0,0,0,0
2006,190R,5,1,6,4,2,6,0,0,0,0,0,0
2006,340H,104,10,114,18,49,67,0,0,0,0,0,0
2007,100,460,55,515,171,216,387,389,63,452,95,163,258
2007,101,87,12,99,6,30,36,0,0,0,3,4,7
2007,102,25,1,26,2,6,8,0,0,0,0,0,0
2007,103,132,35,167,34,66,100,1,0,1,6,7,13
2007,104,36,3,39,3,14,17,0,0,0,0,0,0
2007,105,173,16,189,18,68,86,1,0,1,8,8,16
2007,106,173,21,194,21,72,93,0,0,0,12,8,20
2007,107,81,8,89,8,49,57,0,0,0,0,0,0
2007,108,49,6,55,5,20,25,0,0,0,0,0,0
2007,109,640,82,722,80,276,356,0,0,0,0,0,0
2007,110,18,2,20,2,6,8,0,0,0,0,0,0
2007,111,73,11,84,3,27,30,0,0,0,0,0,0
2007,112,85,6,91,6,34,40,0,0,0,4,4,8
2007,113,71,9,80,2,26,28,0,0,0,0,0,0
2007,114,48,6,54,3,18,21,0,0,0,0,0,0
2007,115,9,4,13,6,9,15,0,0,0,0,0,0
2007,197,57,20,77,25,27,52,0,0,0,0,0,0
2007,200,15,0,15,0,5,5,0,0,0,0,0,0
2007,300,44,0,44,1,18,19,1,0,1,10,14,24
2007,302,5,0,5,0,1,1,0,0,0,0,0,0
2007,303,10,1,11,0,1,1,0,0,0,0,0,0
2007,305,8,0,8,0,0,0,0,0,0,0,0,0
2007,400,105,6,111,6,47,53,1,0,1,72,43,115
2007,402,90,7,97,12,39,51,0,0,0,0,0,0
2007,403,16,1,17,0,4,4,0,0,0,0,0,0
2007,404,20,1,21,6,9,15,0,0,0,0,0,0
2007,405,25,1,26,2,13,15,0,0,0,0,0,0
2007,497,17,2,19,2,8,10,0,0,0,0,0,0
2007,500,58,4,62,6,22,28,2,0,2,9,10,19
2007,501,9,0,9,0,1,1,0,0,0,0,0,0
2007,600,27,2,29,0,17,17,2,0,2,5,6,11
2007,601,7,1,8,0,1,1,0,0,0,0,0,0
2007,602,10,0,10,0,2,2,0,0,0,0,0,0
2007,700,382,56,438,63,180,243,198,38,236,35,53,88
2007,701,110,8,118,5,40,45,0,0,0,2,3,5
2007,702,53,8,61,3,11,14,0,0,0,0,0,0
2007,703,9,1,10,0,2,2,0,0,0,0,0,0
2007,704,129,25,154,10,46,56,0,0,0,4,0,4
2007,705,40,1,41,1,8,9,0,0,0,0,0,0
2007,706,24,2,26,0,3,3,0,0,0,0,0,0
2007,707,30,2,32,3,13,16,0,0,0,0,0,0
2007,708,64,6,70,1,19,20,0,0,0,0,5,5
2007,709,41,5,46,5,15,20,0,0,0,0,0,0
2007,710,146,15,161,15,50,65,0,0,0,1,5,6
2007,711,52,4,56,0,0,0,0,0,0,0,1,1
2007,712,56,14,70,6,28,34,0,0,0,0,0,0
2007,713,9,1,10,0,1,1,0,0,0,0,0,0
2007,714,37,2,39,3,10,13,0,0,0,0,0,0
2007,716,11,2,13,0,2,2,0,0,0,0,0,0
2007,718,175,21,196,52,33,85,0,0,0,0,0,0
2007,721,19,4,23,5,6,11,0,0,0,0,0,0
2007,724,53,3,56,4,15,19,0,0,0,0,0,0
2007,800,26,3,29,5,6,11,3,0,3,10,9,19
2007,801,10,3,13,0,0,0,0,0,0,0,0,0
2007,900,165,11,176,9,66,75,19,1,20,51,50,101
2007,901,16,1,17,3,10,13,0,0,0,0,0,0
2007,902,30,5,35,7,14,21,0,0,0,0,0,0
2007,1000,427,49,476,63,158,221,9,2,11,373,116,489
2007,1001,93,15,108,11,39,50,0,0,0,1,1,2
2007,1002,17,1,18,2,7,9,0,0,0,0,0,0
2007,1003,11,2,13,0,3,3,0,0,0,0,0,0
2007,1004,10,0,10,0,2,2,0,0,0,0,0,0
2007,1005,723,94,817,150,287,437,0,0,0,0,0,0
2007,1006,12,0,12,3,2,5,0,0,0,0,0,0
2007,1007,17,1,18,1,2,3,0,0,0,0,0,0
2007,1008,16,0,16,0,5,5,0,0,0,0,0,0
2007,1011,14,1,15,0,3,3,0,0,0,0,0,0
2007,1012,26,2,28,1,12,13,0,0,0,0,0,0
2007,1013,26,1,27,3,7,10,0,0,0,0,0,0
2007,1015,32,3,35,3,13,16,0,0,0,0,0,0
2007,1017,13,2,15,1,2,3,0,0,0,0,0,0
2007,1097,15,3,18,0,8,8,0,0,0,0,0,0
2007,1100,25,3,28,3,11,14,1,0,1,14,11,25
2007,1101,11,0,11,1,2,3,0,0,0,0,0,0
2007,1102,8,3,11,1,1,2,0,0,0,0,0,0
2007,1200,73,8,81,6,35,41,60,23,83,4,7,11
2007,1201,21,2,23,3,6,9,0,0,0,0,0,0
2007,1202,3,2,5,0,0,0,0,0,0,0,0,0
2007,1203,40,4,44,6,27,33,0,0,0,0,0,0
2007,1204,4,0,4,0,0,0,0,0,0,0,0,0
2007,1205,14,0,14,2,7,9,0,0,0,0,0,0
2007,1206,1,1,2,0,0,0,0,0,0,0,0,0
2007,1207,6,1,7,0,1,1,0,0,0,0,0,0
2007,1208,6,5,11,1,7,8,0,0,0,0,0,0
2007,1300,95,3,98,8,49,57,57,22,79,8,19,27
2007,1301,27,1,28,1,11,12,0,0,0,0,0,0
2007,1302,45,2,47,6,18,24,0,0,0,0,0,0
2007,1303,6,0,6,0,0,0,0,0,0,0,0,0
2007,1304,47,1,48,6,18,24,0,0,0,0,0,0
2007,1305,7,0,7,0,1,1,0,0,0,0,0,0
2007,1306,16,2,18,1,1,2,0,0,0,0,0,0
2007,1307,5,0,5,0,0,0,0,0,0,0,0,0
2007,1400,26,0,26,3,12,15,18,7,25,1,3,4
2007,1401,14,0,14,2,4,6,0,0,0,0,0,0
2007,1500,430,32,462,43,173,216,11,3,14,237,154,391
2007,1501,14,2,16,2,4,6,0,0,0,0,0,0
2007,1502,316,24,340,41,121,162,0,0,0,0,0,0
2007,1503,46,2,48,1,11,12,0,0,0,4,0,4
2007,1506,33,2,35,2,11,13,0,0,0,0,0,0
2007,1507,19,1,20,1,9,10,0,0,0,0,0,0
2007,1508,11,2,13,1,8,9,0,0,0,0,0,0
2007,1511,15,1,16,0,6,6,0,0,0,0,0,0
2007,1514,3,0,3,0,0,0,0,0,0,0,0,0
2007,1515,7,1,8,1,7,8,0,0,0,0,0,0
2007,1597,9,2,11,0,4,4,0,0,0,0,0,0
2007,1600,74,7,81,7,42,49,0,0,0,43,48,91
2007,1601,14,3,17,1,9,10,0,0,0,0,0,0
2007,1602,41,5,46,4,15,19,0,0,0,0,0,0
2007,1603,27,4,31,3,4,7,0,0,0,0,0,0
2007,1700,52,3,55,3,19,22,2,0,2,37,34,71
2007,1701,13,0,13,0,2,2,0,0,0,0,0,0
2007,1702,21,1,22,0,9,9,0,0,0,0,0,0
2007,1800,28,0,28,1,7,8,24,17,41,3,11,14
2007,1801,15,1,16,0,2,2,0,0,0,0,0,0
2007,1900,5338,919,6257,1263,2231,3494,2446,575,3021,1089,1790,2879
2007,1901,75,10,85,6,42,48,0,0,0,0,0,0
2007,1902,59,4,63,10,21,31,0,0,0,2,3,5
2007,1905,61,1,62,3,21,24,0,0,0,0,0,0
2007,1906,72,5,77,0,24,24,0,0,0,5,2,7
2007,1907,32,4,36,1,10,11,0,0,0,0,0,0
2007,1909,48,4,52,5,15,20,0,0,0,0,0,0
2007,1910,122,8,130,14,43,57,0,0,0,2,4,6
2007,1912,141,13,154,19,62,81,0,0,0,6,5,11
2007,1913,38,4,42,1,15,16,0,0,0,5,1,6
2007,1916,55,4,59,5,21,26,0,0,0,3,1,4
2007,1918,113,3,116,20,17,37,0,0,0,2,0,2
2007,1920,95,11,106,13,37,50,0,0,0,0,0,0
2007,1922,142,10,152,20,44,64,0,0,0,5,3,8
2007,1923,60,5,65,6,20,26,0,0,0,6,2,8
2007,1924,78,7,85,4,14,18,0,0,0,4,4,8
2007,1925,235,25,260,24,75,99,1,0,1,9,7,16
2007,1926,51,8,59,10,29,39,0,0,0,2,3,5
2007,1928,89,7,96,0,28,28,0,0,0,10,4,14
2007,1929,36,3,39,9,5,14,0,0,0,1,9,10
2007,1931,60,3,63,11,21,32,0,0,0,4,1,5
2007,1933,166,24,190,11,55,66,0,0,0,4,8,12
2007,1934,28,0,28,0,7,7,0,0,0,0,0,0
2007,1938,46,4,50,6,15,21,0,0,0,0,0,0
2007,1941,874,90,964,123,235,358,6,0,6,30,19,49
2007,1942,7732,1783,9515,956,2010,2966,21,2,23,232,133,365
2007,1944,51,7,58,9,19,28,0,0,0,4,2,6
2007,1945,38,0,38,1,6,7,0,0,0,3,3,6
2007,1946,46,8,54,4,17,21,0,0,0,0,3,3
2007,1947,73,5,78,4,30,34,0,0,0,5,2,7
2007,1948,64,12,76,6,26,32,0,0,0,3,2,5
2007,1951,22,2,24,3,3,6,0,0,0,2,2,4
2007,1953,209,37,246,25,76,101,0,0,0,13,8,21
2007,1955,180,13,193,21,90,111,1,0,1,9,11,20
2007,1956,93,6,99,7,38,45,0,0,0,2,7,9
2007,1961,33,2,35,2,7,9,0,0,0,3,3,6
2007,1962,53,2,55,3,11,14,0,0,0,0,0,0
2007,1963,20,5,25,0,5,5,0,0,0,0,0,0
2007,1965,188,18,206,79,91,170,2,1,3,5,6,11
2007,1966,12,3,15,0,5,5,0,0,0,0,0,0
2007,1967,29,3,32,5,11,16,0,0,0,0,0,0
2007,1969,85,6,91,8,31,39,0,0,0,3,3,6
2007,1970,35,1,36,1,13,14,0,0,0,0,0,0
2007,1972,219,14,233,27,48,75,1,0,1,7,8,15
2007,1973,48,3,51,0,16,16,0,0,0,2,0,2
2007,1975,105,8,113,18,33,51,0,0,0,4,3,7
2007,1976,119,9,128,19,32,51,0,0,0,0,0,0
2007,1978,18,2,20,4,8,12,0,0,0,0,0,0
2007,1981,14,2,16,4,2,6,0,0,0,0,0,0
2007,1982,22,2,24,11,10,21,0,0,0,0,0,0
2007,1983,17,3,20,5,11,16,0,0,0,0,0,0
2007,1984,23,2,25,5,9,14,0,0,0,0,0,0
2007,1997,49,6,55,15,22,37,0,0,0,0,0,0
2007,2000,72,4,76,6,28,34,0,0,0,0,0,0
2007,2001,17,2,19,0,8,8,0,0,0,0,0,0
2007,2002,52,6,58,2,18,20,0,0,0,0,0,0
2007,2100,116,16,132,25,56,81,61,16,77,10,16,26
2007,2101,7,0,7,0,1,1,0,0,0,0,0,0
2007,2103,10,1,11,3,2,5,0,0,0,0,0,0
2007,2104,33,1,34,0,11,11,0,0,0,0,0,0
2007,2105,21,2,23,0,5,5,0,0,0,0,0,0
2007,2106,48,9,57,1,21,22,0,0,0,0,0,0
2007,2107,8,0,8,0,0,0,0,0,0,0,0,0
2007,2108,13,5,18,0,6,6,0,0,0,0,0,0
2007,2109,68,5,73,5,24,29,0,0,0,0,0,0
2007,2110,15,3,18,1,4,5,0,0,0,0,0,0
2007,2111,12,1,13,0,4,4,0,0,0,0,0,0
2007,2113,6,0,6,1,0,1,0,0,0,0,0,0
2007,2200,38,5,43,3,12,15,9,8,17,0,0,0
2007,2300,68,2,70,6,22,28,42,15,57,1,7,8
2007,2301,12,2,14,1,8,9,0,0,0,0,0,0
2007,2303,28,0,28,0,11,11,0,0,0,0,0,0
2007,2304,10,1,11,2,4,6,0,0,0,0,0,0
2007,2400,109,4,113,6,28,34,62,24,86,11,11,22
2007,2401,33,1,34,2,8,10,0,0,0,0,0,0
2007,2402,5,2,7,0,2,2,0,0,0,0,0,0
2007,2403,8,0,8,0,2,2,0,0,0,0,0,0
2007,2404,18,1,19,1,9,10,0,0,0,0,0,0
2007,2405,43,4,47,9,13,22,0,0,0,0,0,0
2007,2406,99,8,107,8,33,41,0,0,0,0,0,0
2007,2412,6,3,9,1,6,7,0,0,0,0,0,0
2007,2500,12,1,13,2,2,4,5,4,9,0,0,0
2007,2501,5,1,6,0,1,1,0,0,0,0,0,0
2007,2600,26,0,26,0,2,2,0,0,0,9,6,15
2007,2601,21,1,22,1,3,4,0,0,0,0,0,0
2007,2700,140,12,152,10,62,72,128,37,165,18,24,42
2007,2701,12,1,13,1,7,8,0,0,0,0,0,0
2007,2702,6,0,6,0,0,0,0,0,0,0,0,0
2007,2703,13,1,14,0,1,1,0,0,0,0,0,0
2007,2704,12,4,16,1,2,3,0,0,0,0,0,0
2007,2705,18,1,19,0,3,3,0,0,0,0,0,0
2007,2706,47,4,51,3,4,7,0,0,0,5,5,10
2007,2707,16,6,22,2,5,7,0,0,0,0,0,0
2007,2708,159,15,174,13,44,57,0,0,0,0,0,0
2007,2709,9,0,9,0,1,1,0,0,0,0,0,0
2007,2710,39,4,43,6,8,14,0,0,0,0,3,3
2007,2711,20,2,22,0,5,5,0,0,0,0,0,0
2007,2712,27,4,31,2,7,9,0,0,0,0,0,0
2007,2714,6,0,6,0,1,1,0,0,0,0,0,0
2007,2719,13,1,14,1,1,2,0,0,0,0,0,0
2007,2800,88,5,93,9,21,30,0,0,0,0,0,0
2007,2801,9,2,11,1,3,4,0,0,0,0,0,0
2007,2802,60,9,69,3,39,42,0,0,0,0,0,0
2007,2803,12,1,13,0,4,4,0,0,0,0,0,0
2007,2808,89,9,98,1,3,4,0,0,0,0,0,0
2007,2900,63,5,68,6,35,41,3,0,3,36,43,79
2007,2901,27,1,28,1,9,10,0,0,0,0,0,0
2007,2902,11,0,11,0,1,1,0,0,0,0,0,0
2007,2908,24,0,24,0,4,4,0,0,0,0,0,0
2007,3000,947,104,1051,606,633,1239,614,88,702,359,204,563
2007,3001,361,29,390,31,130,161,14,8,22,0,9,9
2007,3002,96,10,106,3,35,38,0,0,0,1,0,1
2007,3003,86,7,93,3,38,41,0,0,0,4,1,5
2007,3004,148,15,163,17,58,75,0,0,0,7,4,11
2007,3005,55,2,57,4,12,16,0,0,0,3,3,6
2007,3006,23,1,24,0,7,7,0,0,0,0,0,0
2007,3007,56,6,62,3,15,18,0,0,0,0,0,0
2007,3008,140,19,159,7,55,62,0,0,0,4,1,5
2007,3009,156,9,165,23,56,79,0,0,0,0,0,0
2007,3010,208,11,219,25,90,115,0,0,0,12,7,19
2007,3011,39,8,47,6,28,34,0,0,0,0,0,0
2007,3012,63,5,68,11,26,37,0,0,0,0,0,0
2007,3013,20,2,22,0,4,4,0,0,0,0,0,0
2007,3014,136,9,145,26,54,80,0,0,0,7,2,9
2007,3015,144,18,162,17,55,72,0,0,0,0,0,0
2007,3016,53,2,55,3,14,17,0,0,0,0,0,0
2007,3019,336,27,363,44,143,187,0,0,0,54,62,116
2007,3020,27,3,30,5,6,11,0,0,0,0,0,0
2007,3022,86,8,94,6,46,52,0,0,0,0,0,0
2007,3024,91,7,98,5,37,42,0,0,0,2,0,2
2007,3026,143,30,173,25,67,92,0,0,0,0,0,0
2007,3027,21,3,24,1,7,8,0,0,0,0,0,0
2007,3097,27,3,30,4,9,13,0,0,0,0,0,0
2007,3100,174,16,190,14,63,77,58,11,69,61,44,105
2007,3101,20,1,21,4,9,13,0,0,0,0,0,0
2007,3103,35,1,36,1,9,10,0,0,0,0,0,0
2007,3104,49,6,55,3,26,29,0,0,0,0,0,0
2007,3105,122,6,128,11,48,59,0,0,0,5,6,11
2007,3200,37,1,38,0,16,16,0,0,0,10,9,19
2007,3300,1514,148,1662,171,650,821,266,37,303,541,313,854
2007,3301,37,3,40,0,16,16,0,0,0,0,0,0
2007,3302,44,1,45,3,12,15,0,0,0,0,0,0
2007,3303,24,1,25,5,10,15,0,0,0,0,0,0
2007,3306,23,2,25,3,3,6,0,0,0,0,0,0
2007,3308,80,4,84,3,24,27,0,0,0,0,0,0
2007,3309,83,2,85,18,33,51,0,0,0,0,0,0
2007,3311,77,12,89,20,36,56,0,0,0,3,5,8
2007,3313,361,41,402,28,146,174,0,0,0,0,0,0
2007,3315,159,22,181,20,72,92,0,0,0,3,0,3
2007,3325,52,4,56,10,21,31,0,0,0,0,0,0
2007,3342,75,7,82,4,31,35,0,0,0,0,0,0
2007,3344,14,2,16,2,4,6,0,0,0,0,0,0
2007,3397,24,2,26,1,9,10,0,0,0,0,0,0
2007,3400,807,166,973,170,309,479,346,100,446,136,262,398
2007,3401,70,8,78,2,29,31,0,0,0,0,0,0
2007,3402,30,2,32,0,13,13,0,0,0,0,0,0
2007,3403,6,0,6,0,0,0,0,0,0,0,0,0
2007,3404,588,124,712,87,227,314,0,0,0,0,0,0
2007,3408,21,1,22,1,8,9,0,0,0,0,0,0
2007,3414,19,2,21,4,2,6,0,0,0,0,0,0
2007,3420,4,0,4,4,1,5,0,0,0,0,0,0
2007,3422,485,140,625,8,43,51,0,0,0,0,0,0
2007,3477,104,16,120,63,8,71,0,0,0,0,0,0
2007,3496,78,10,88,6,44,50,0,0,0,0,0,0
2007,3499,6854,615,7469,1571,1935,3506,0,0,0,0,0,0
2007,3500,28,4,32,1,7,8,0,0,0,14,13,27
2007,3501,23,5,28,1,5,6,0,0,0,0,0,0
2007,3600,1149,166,1315,292,667,959,380,88,468,189,447,636
2007,3601,30,2,32,4,16,20,0,0,0,0,0,0
2007,3602,89,10,99,3,44,47,0,0,0,0,0,0
2007,3603,69,2,71,3,26,29,0,0,0,0,0,0
2007,3604,170,19,189,15,71,86,0,0,0,0,0,0
2007,3605,48,9,57,2,25,27,0,0,0,0,0,0
2007,3607,221,10,231,13,92,105,0,0,0,0,0,0
2007,3608,76,16,92,16,45,61,0,0,0,0,0,0
2007,3609,91,14,105,6,34,40,0,0,0,0,0,0
2007,3610,302,28,330,29,129,158,0,0,0,6,5,11
2007,3611,76,3,79,6,35,41,0,0,0,0,0,0
2007,3614,10,1,11,3,6,9,0,0,0,0,0,0
2007,3623,24,2,26,37,17,54,0,0,0,0,0,0
2007,3639,8,2,10,4,1,5,0,0,0,0,0,0
2007,3650,9,3,12,2,6,8,0,0,0,0,0,0
2007,3700,1114,192,1306,341,514,855,696,189,885,299,446,745
2007,3701,102,10,112,7,38,45,0,0,0,0,0,0
2007,3702,229,25,254,16,67,83,1,0,1,6,8,14
2007,3703,37,4,41,3,17,20,0,0,0,0,0,0
2007,3705,132,7,139,18,64,82,0,0,0,0,0,0
2007,3706,148,16,164,11,54,65,0,0,0,0,0,0
2007,3708,55,7,62,5,25,30,0,0,0,0,0,0
2007,3709,83,8,91,4,30,34,0,0,0,0,0,0
2007,3710,181,19,200,16,81,97,0,0,0,0,0,0
2007,3711,1638,286,1924,247,504,751,0,0,0,0,0,0
2007,3714,22,4,26,9,12,21,0,0,0,0,0,0
2007,3715,119,19,138,10,18,28,0,0,0,0,0,0
2007,3732,13,1,14,3,5,8,0,0,0,0,0,0
2007,3797,30,6,36,14,14,28,0,0,0,0,0,0
2007,3800,261,60,321,75,82,157,418,92,510,9,8,17
2007,3801,1956,381,2337,141,201,342,0,0,0,0,0,0
2007,3803,24,3,27,8,15,23,0,0,0,0,0,0
2007,3816,10,2,12,0,0,0,0,0,0,0,0,0
2007,3897,27,7,34,56,17,73,0,0,0,0,0,0
2007,3900,242,30,272,32,101,133,22,2,24,182,126,308
2007,3901,11,0,11,0,4,4,0,0,0,0,0,0
2007,3902,69,7,76,3,27,30,0,0,0,0,0,0
2007,3903,73,4,77,6,18,24,0,0,0,0,0,0
2007,3904,19,5,24,3,9,12,0,0,0,0,0,0
2007,3905,350,37,387,87,156,243,0,0,0,0,0,0
2007,3906,81,6,87,9,31,40,0,0,0,0,0,0
2007,3915,18,1,19,2,4,6,0,0,0,0,0,0
2007,4000,156,6,162,13,64,77,0,0,0,95,49,144
2007,4001,23,4,27,3,6,9,0,0,0,0,0,0
2007,4002,17,2,19,2,8,10,0,0,0,0,0,0
2007,4003,14,2,16,1,5,6,0,0,0,0,0,0
2007,4004,37,4,41,2,10,12,0,0,0,0,0,0
2007,4005,19,2,21,0,11,11,0,0,0,0,0,0
2007,4006,50,12,62,4,25,29,0,0,0,0,0,0
2007,4007,15,2,17,5,13,18,0,0,0,0,0,0
2007,4008,23,6,29,4,9,13,0,0,0,0,0,0
2007,4016,77,34,111,2,11,13,0,0,0,0,0,0
2007,4019,6,0,6,1,0,1,0,0,0,0,0,0
2007,4100,215,27,242,59,93,152,154,37,191,11,37,48
2007,4101,19,2,21,1,4,5,0,0,0,0,0,0
2007,4102,27,2,29,7,8,15,0,0,0,0,0,0
2007,4103,14,4,18,0,3,3,0,0,0,0,0,0
2007,4104,35,7,42,4,15,19,0,0,0,0,0,0
2007,4105,18,1,19,0,7,7,0,0,0,0,0,0
2007,4106,99,11,110,13,26,39,0,0,0,0,0,0
2007,4107,18,0,18,1,4,5,0,0,0,0,0,0
2007,4108,20,3,23,3,8,11,0,0,0,0,0,0
2007,4109,40,11,51,7,14,21,0,0,0,0,0,0
2007,4110,18,2,20,1,4,5,0,0,0,0,0,0
2007,4111,39,0,39,1,12,13,0,0,0,0,0,0
2007,4113,80,16,96,5,30,35,0,0,0,0,0,0
2007,4114,40,5,45,0,16,16,0,0,0,0,0,0
2007,4115,21,7,28,0,7,7,0,0,0,0,0,0
2007,4116,98,16,114,6,32,38,0,0,0,0,0,0
2007,4117,66,9,75,6,28,34,0,0,0,0,0,0
2007,4119,10,0,10,0,1,1,0,0,0,0,0,0
2007,4120,32,6,38,6,11,17,0,0,0,0,0,0
2007,4127,30,1,31,1,8,9,0,0,0,0,0,0
2007,4200,286,20,306,24,102,126,3,0,3,175,78,253
2007,4201,11,1,12,0,3,3,0,0,0,0,0,0
2007,4202,46,3,49,1,7,8,0,0,0,5,9,14
2007,4203,119,13,132,21,49,70,0,0,0,0,0,0
2007,4204,93,8,101,13,40,53,0,0,0,0,0,0
2007,4211,5,0,5,12,3,15,0,0,0,0,0,0
2007,4297,29,2,31,6,7,13,0,0,0,0,0,0
2007,4300,417,59,476,62,113,175,34,7,41,0,0,0
2007,4302,40,3,43,3,18,21,0,0,0,0,0,0
2007,4304,53,7,60,8,25,33,0,0,0,2,3,5
2007,4305,29,1,30,3,13,16,0,0,0,0,0,0
2007,4307,38,4,42,4,15,19,0,0,0,0,0,0
2007,4308,79,9,88,5,20,25,0,0,0,0,0,0
2007,4310,33,2,35,4,13,17,0,0,0,0,0,0
2007,4311,90,8,98,15,32,47,0,0,0,0,0,0
2007,4312,59,23,82,27,44,71,0,0,0,0,0,0
2007,4313,1261,135,1396,86,302,388,0,0,0,0,0,0
2007,4314,123,14,137,18,51,69,0,0,0,3,2,5
2007,4316,207,16,223,14,50,64,0,0,0,0,0,0
2007,4317,25,3,28,18,9,27,0,0,0,0,0,0
2007,4320,5,1,6,5,3,8,0,0,0,0,0,0
2007,4321,6,2,8,2,2,4,0,0,0,0,0,0
2007,4327,11,0,11,7,3,10,0,0,0,0,0,0
2007,4400,111,21,132,9,40,49,4,1,5,88,38,126
2007,4401,20,2,22,6,6,12,0,0,0,0,0,0
2007,4402,77,8,85,9,18,27,0,0,0,0,0,0
2007,4403,56,4,60,5,15,20,0,0,0,0,0,0
2007,4404,19,0,19,2,4,6,0,0,0,0,0,0
2007,4497,14,5,19,8,19,27,0,0,0,0,0,0
2007,4500,79,10,89,13,40,53,42,16,58,20,17,37
2007,4501,18,2,20,0,11,11,0,0,0,0,0,0
2007,4502,111,6,117,14,39,53,0,0,0,0,0,0
2007,4600,11,0,11,0,0,0,0,0,0,1,3,4
2007,4700,59,2,61,5,20,25,30,8,38,0,7,7
2007,4703,2,0,2,0,1,1,0,0,0,0,0,0
2007,4706,8,1,9,1,4,5,0,0,0,0,0,0
2007,4707,3,0,3,0,0,0,0,0,0,0,0,0
2007,4708,10,0,10,3,3,6,0,0,0,0,0,0
2007,4709,16,0,16,2,4,6,0,0,0,0,0,0
2007,4710,4,0,4,0,1,1,0,0,0,0,0,0
2007,4800,106,11,117,17,60,77,1,0,1,192,93,285
2007,4801,31,2,33,3,15,18,0,0,0,0,0,0
2007,4802,19,5,24,2,5,7,0,0,0,0,0,0
2007,4803,120,7,127,11,59,70,0,0,0,0,0,0
2007,4804,12,2,14,1,3,4,0,0,0,0,0,0
2007,4805,23,0,23,1,10,11,0,0,0,0,0,0
2007,4806,102,9,111,7,58,65,0,0,0,0,0,0
2007,4807,135,10,145,9,44,53,0,0,0,0,0,0
2007,4813,3,1,4,0,2,2,0,0,0,0,0,0
2007,4900,249,18,267,21,87,108,215,52,267,35,52,87
2007,4901,11,2,13,1,8,9,0,0,0,0,0,0
2007,4902,12,1,13,0,7,7,0,0,0,0,0,0
2007,4903,16,2,18,3,9,12,0,0,0,0,0,0
2007,4904,71,3,74,5,22,27,0,0,0,0,0,0
2007,4905,153,18,171,11,73,84,0,0,0,0,0,0
2007,4906,12,3,15,1,6,7,0,0,0,0,0,0
2007,4908,61,7,68,6,24,30,0,0,0,0,0,0
2007,4909,8,2,10,4,3,7,0,0,0,0,0,0
2007,4914,12,1,13,4,9,13,0,0,0,0,0,0
2007,5000,222,11,233,5,88,93,0,0,0,159,131,290
2007,5001,42,4,46,5,15,20,0,0,0,0,0,0
2007,5002,257,14,271,10,94,104,0,0,0,0,0,0
2007,5003,12,1,13,1,2,3,0,0,0,0,0,0
2007,5004,26,1,27,3,10,13,0,0,0,0,0,0
2007,5005,19,0,19,0,3,3,0,0,0,0,0,0
2007,5006,18,1,19,0,4,4,0,0,0,0,0,0
2007,5007,64,4,68,3,36,39,0,0,0,0,0,0
2007,5009,5,1,6,0,1,1,0,0,0,0,0,0
2007,5010,9,2,11,3,8,11,0,0,0,0,0,0
2007,5100,47,4,51,3,21,24,32,17,49,0,5,5
2007,5102,59,8,67,5,30,35,0,0,0,0,0,0
2007,5200,42,3,45,4,22,26,18,9,27,1,6,7
2007,5201,13,0,13,2,7,9,0,0,0,0,0,0
2007,5202,20,4,24,3,10,13,0,0,0,0,0,0
2007,5300,19,1,20,1,6,7,0,0,0,7,7,14
2007,5400,225,26,251,32,90,122,155,44,199,72,67,139
2007,5401,33,4,37,1,8,9,0,0,0,0,0,0
2007,5402,12,4,16,0,2,2,0,0,0,0,0,0
2007,5403,15,0,15,1,1,2,0,0,0,0,0,0
2007,5404,13,1,14,1,3,4,0,0,0,0,0,0
2007,5405,53,5,58,3,18,21,0,0,0,0,0,0
2007,5406,58,10,68,8,22,30,0,0,0,0,0,0
2007,5407,111,17,128,14,41,55,0,0,0,0,0,0
2007,5408,14,0,14,0,2,2,0,0,0,0,0,0
2007,5411,3,1,4,0,1,1,0,0,0,0,0,0
2007,5500,58,2,60,2,24,26,0,0,0,23,19,42
2007,5501,16,1,17,0,4,4,0,0,0,0,0,0
2007,5600,482,58,540,90,190,280,180,28,208,104,92,196
2007,5604,202,27,229,39,79,118,0,0,0,5,4,9
2007,5605,21,3,24,2,6,8,0,0,0,0,0,0
2007,5606,33,1,34,4,7,11,0,0,0,0,0,0
2007,5608,125,9,134,7,41,48,0,0,0,0,0,0
2007,5609,115,10,125,17,47,64,0,0,0,0,0,0
2007,5622,13,1,14,2,3,5,0,0,0,0,0,0
2007,5680,12,1,13,8,8,16,0,0,0,0,0,0
2007,5700,71,14,85,9,35,44,2,0,2,73,56,129
2007,5701,51,6,57,11,24,35,0,0,0,0,0,0
2007,5702,11,0,11,0,2,2,0,0,0,0,0,0
2007,5703,54,11,65,2,24,26,0,0,0,0,0,0
2007,5704,65,6,71,7,28,35,0,0,0,0,0,0
2007,5797,33,8,41,9,21,30,0,0,0,0,0,0
2007,5800,63,4,67,2,23,25,47,23,70,7,5,12
2007,5801,20,2,22,1,10,11,0,0,0,0,0,0
2007,5802,5,1,6,0,0,0,0,0,0,0,0,0
2007,190C,14,1,15,2,4,6,0,0,0,0,0,0
2007,190R,5,1,6,2,3,5,0,0,0,0,0,0
2007,340H,110,13,123,15,49,64,0,0,0,0,0,0
2008,100,466,64,530,162,225,387,447,60,507,97,161,258
2008,101,83,11,94,5,31,36,0,0,0,4,4,8
2008,102,24,1,25,3,7,10,0,0,0,0,0,0
2008,103,105,81,186,22,65,87,1,0,1,7,8,15
2008,104,38,2,40,3,14,17,0,0,0,0,0,0
2008,105,165,14,179,12,73,85,0,0,0,8,9,17
2008,106,169,22,191,14,71,85,0,0,0,13,6,19
2008,107,84,9,93,8,47,55,0,0,0,0,0,0
2008,108,47,7,54,5,19,24,0,0,0,0,0,0
2008,109,682,84,766,60,230,290,0,0,0,0,0,0
2008,110,17,3,20,2,6,8,0,0,0,0,0,0
2008,111,73,7,80,4,28,32,0,0,0,0,0,0
2008,112,89,5,94,5,34,39,0,0,0,5,3,8
2008,113,67,10,77,3,24,27,0,0,0,0,0,0
2008,114,47,7,54,3,18,21,0,0,0,0,0,0
2008,115,8,4,12,3,7,10,0,0,0,0,0,0
2008,197,50,21,71,23,27,50,0,0,0,0,0,0
2008,200,15,0,15,0,3,3,0,0,0,0,0,0
2008,300,46,1,47,2,14,16,1,0,1,11,15,26
2008,302,5,1,6,0,1,1,0,0,0,0,0,0
2008,303,10,1,11,0,1,1,0,0,0,0,0,0
2008,305,7,0,7,0,0,0,0,0,0,0,0,0
2008,400,106,6,112,6,48,54,1,0,1,72,42,114
2008,402,83,7,90,11,38,49,0,0,0,0,0,0
2008,403,16,1,17,0,5,5,0,0,0,0,0,0
2008,404,21,2,23,6,8,14,0,0,0,0,0,0
2008,405,26,0,26,3,16,19,0,0,0,0,0,0
2008,497,15,2,17,2,8,10,0,0,0,0,0,0
2008,500,53,5,58,6,24,30,2,0,2,10,10,20
2008,501,9,0,9,0,1,1,0,0,0,0,0,0
2008,600,27,2,29,1,19,20,2,0,2,6,7,13
2008,601,6,2,8,0,1,1,0,0,0,0,0,0
2008,602,10,0,10,0,2,2,0,0,0,0,0,0
2008,700,310,50,360,50,154,204,278,43,321,56,63,119
2008,701,110,8,118,5,40,45,0,0,0,2,2,4
2008,702,51,6,57,3,13,16,0,0,0,0,0,0
2008,703,9,2,11,0,2,2,0,0,0,0,0,0
2008,704,138,27,165,17,45,62,0,0,0,4,2,6
2008,705,40,2,42,1,8,9,0,0,0,0,0,0
2008,706,25,2,27,0,3,3,0,0,0,0,0,0
2008,707,33,2,35,3,13,16,0,0,0,0,0,0
2008,708,67,8,75,1,21,22,0,0,0,1,5,6
2008,709,39,6,45,5,14,19,0,0,0,0,0,0
2008,710,152,15,167,15,55,70,0,0,0,1,5,6
2008,711,51,4,55,5,14,19,0,0,0,0,2,2
2008,712,59,16,75,7,28,35,0,0,0,0,0,0
2008,713,9,1,10,0,0,0,0,0,0,0,0,0
2008,714,35,2,37,3,10,13,0,0,0,0,0,0
2008,716,10,1,11,0,1,1,0,0,0,0,0,0
2008,718,182,20,202,46,36,82,0,0,0,0,0,0
2008,721,21,4,25,5,7,12,0,0,0,0,0,0
2008,724,53,3,56,4,15,19,0,0,0,0,0,0
2008,800,27,3,30,5,5,10,3,0,3,13,9,22
2008,801,10,3,13,0,1,1,0,0,0,0,0,0
2008,900,176,10,186,9,66,75,18,2,20,70,55,125
2008,901,17,1,18,1,8,9,0,0,0,0,0,0
2008,902,35,5,40,7,15,22,0,0,0,0,0,0
2008,1000,403,50,453,42,117,159,318,128,446,11,22,33
2008,1001,90,14,104,10,36,46,0,0,0,1,3,4
2008,1002,16,2,18,2,8,10,0,0,0,0,0,0
2008,1003,10,2,12,0,4,4,0,0,0,0,0,0
2008,1004,12,0,12,0,1,1,0,0,0,0,0,0
2008,1005,726,98,824,149,294,443,0,0,0,0,0,0
2008,1006,13,0,13,1,3,4,0,0,0,0,0,0
2008,1007,17,2,19,2,1,3,0,0,0,0,0,0
2008,1008,15,1,16,1,5,6,0,0,0,0,0,0
2008,1011,17,0,17,0,3,3,0,0,0,0,0,0
2008,1012,28,2,30,1,12,13,0,0,0,0,0,0
2008,1013,29,2,31,3,6,9,0,0,0,0,0,0
2008,1015,32,3,35,2,12,14,0,0,0,0,0,0
2008,1017,14,1,15,1,2,3,0,0,0,0,0,0
2008,1031,2,1,3,0,1,1,0,0,0,0,0,0
2008,1097,16,3,19,0,9,9,0,0,0,0,0,0
2008,1100,24,3,27,3,12,15,1,0,1,15,10,25
2008,1101,10,0,10,0,2,2,0,0,0,0,0,0
2008,1102,8,3,11,1,1,2,0,0,0,0,0,0
2008,1200,81,8,89,6,37,43,71,24,95,5,6,11
2008,1201,18,4,22,3,7,10,0,0,0,0,0,0
2008,1203,41,4,45,4,22,26,0,0,0,0,0,0
2008,1204,4,0,4,0,0,0,0,0,0,0,0,0
2008,1205,14,0,14,1,8,9,0,0,0,0,0,0
2008,1206,1,0,1,0,0,0,0,0,0,0,0,0
2008,1207,5,1,6,1,1,2,0,0,0,0,0,0
2008,1208,8,6,14,1,7,8,0,0,0,0,0,0
2008,1300,94,4,98,8,51,59,62,20,82,9,22,31
2008,1301,31,1,32,1,11,12,0,0,0,0,0,0
2008,1302,44,2,46,13,17,30,0,0,0,0,0,0
2008,1303,4,1,5,0,0,0,0,0,0,0,0,0
2008,1304,57,1,58,7,22,29,0,0,0,0,0,0
2008,1305,6,0,6,0,1,1,0,0,0,0,0,0
2008,1306,16,1,17,1,1,2,0,0,0,0,0,0
2008,1307,4,0,4,0,0,0,0,0,0,0,0,0
2008,1400,25,1,26,3,12,15,11,1,12,1,3,4
2008,1401,12,1,13,2,4,6,0,0,0,0,0,0
2008,1500,493,40,533,42,187,229,258,117,375,19,53,72
2008,1501,12,3,15,2,5,7,0,0,0,0,0,0
2008,1502,325,26,351,20,115,135,0,0,0,0,0,0
2008,1503,42,2,44,9,12,21,0,0,0,3,0,3
2008,1506,32,2,34,2,12,14,0,0,0,0,0,0
2008,1507,18,2,20,1,8,9,0,0,0,0,0,0
2008,1508,11,2,13,0,9,9,0,0,0,0,0,0
2008,1511,17,0,17,1,5,6,0,0,0,0,0,0
2008,1514,3,0,3,0,0,0,0,0,0,0,0,0
2008,1515,7,1,8,1,7,8,0,0,0,0,0,0
2008,1597,8,2,10,1,3,4,0,0,0,0,0,0
2008,1600,76,7,83,4,40,44,0,0,0,45,56,101
2008,1601,16,3,19,1,9,10,0,0,0,0,0,0
2008,1602,49,5,54,1,18,19,0,0,0,0,0,0
2008,1603,27,4,31,2,4,6,0,0,0,0,0,0
2008,1700,54,3,57,3,21,24,1,0,1,42,32,74
2008,1701,12,0,12,0,2,2,0,0,0,0,0,0
2008,1702,18,2,20,1,8,9,0,0,0,0,0,0
2008,1800,28,3,31,1,7,8,24,17,41,3,11,14
2008,1801,16,0,16,0,2,2,0,0,0,0,0,0
2008,1900,6623,1195,7818,2127,3590,5717,1336,359,1695,472,691,1163
2008,1901,74,10,84,6,40,46,0,0,0,0,0,0
2008,1902,63,3,66,7,24,31,0,0,0,3,2,5
2008,1905,61,1,62,3,24,27,0,0,0,0,0,0
2008,1906,67,6,73,0,23,23,0,0,0,6,1,7
2008,1907,35,3,38,3,14,17,0,0,0,0,0,0
2008,1909,49,5,54,7,12,19,0,0,0,0,0,0
2008,1910,129,8,137,14,39,53,0,0,0,1,4,5
2008,1912,143,12,155,21,64,85,0,0,0,6,5,11
2008,1913,38,4,42,1,16,17,0,0,0,5,1,6
2008,1916,57,2,59,5,23,28,0,0,0,3,1,4
2008,1918,110,4,114,14,21,35,0,0,0,4,0,4
2008,1920,96,11,107,20,37,57,0,0,0,0,0,0
2008,1922,135,11,146,20,40,60,0,0,0,5,3,8
2008,1923,61,6,67,3,23,26,0,0,0,5,3,8
2008,1924,81,9,90,2,15,17,0,0,0,6,2,8
2008,1925,231,27,258,41,82,123,0,0,0,11,9,20
2008,1926,51,8,59,10,29,39,0,0,0,2,3,5
2008,1928,89,6,95,0,22,22,0,0,0,7,5,12
2008,1929,33,1,34,10,5,15,0,0,0,1,9,10
2008,1931,59,3,62,13,24,37,0,0,0,5,1,6
2008,1933,169,23,192,11,62,73,0,0,0,3,7,10
2008,1934,30,0,30,0,9,9,0,0,0,0,0,0
2008,1938,42,4,46,6,16,22,0,0,0,2,0,2
2008,1941,867,90,957,102,246,348,6,0,6,34,16,50
2008,1942,7901,1819,9720,945,1964,2909,20,3,23,226,130,356
2008,1944,56,8,64,10,18,28,0,0,0,4,2,6
2008,1945,37,0,37,2,11,13,0,0,0,3,3,6
2008,1946,46,7,53,4,20,24,0,0,0,0,4,4
2008,1947,73,6,79,4,29,33,0,0,0,5,1,6
2008,1948,67,11,78,4,24,28,0,0,0,2,3,5
2008,1951,22,2,24,3,3,6,0,0,0,2,2,4
2008,1953,211,35,246,36,76,112,0,0,0,12,9,21
2008,1955,173,14,187,25,92,117,0,0,0,13,8,21
2008,1956,90,7,97,8,36,44,0,0,0,1,5,6
2008,1961,35,2,37,2,8,10,0,0,0,3,3,6
2008,1962,51,4,55,4,11,15,0,0,0,0,0,0
2008,1963,23,5,28,1,6,7,0,0,0,0,0,0
2008,1965,182,18,200,78,92,170,1,1,2,7,7,14
2008,1966,13,3,16,0,4,4,0,0,0,0,0,0
2008,1967,32,4,36,4,10,14,0,0,0,0,0,0
2008,1969,89,6,95,7,30,37,0,0,0,3,3,6
2008,1970,34,1,35,1,14,15,0,0,0,0,0,0
2008,1972,215,14,229,29,45,74,1,0,1,6,8,14
2008,1973,49,3,52,0,18,18,0,0,0,3,0,3
2008,1975,113,9,122,12,33,45,0,0,0,4,3,7
2008,1976,119,9,128,19,36,55,0,0,0,0,0,0
2008,1978,18,2,20,4,8,12,0,0,0,0,0,0
2008,1981,15,2,17,4,2,6,0,0,0,0,0,0
2008,1982,25,2,27,12,15,27,0,0,0,0,0,0
2008,1983,18,4,22,5,11,16,0,0,0,0,0,0
2008,1984,22,2,24,7,7,14,0,0,0,0,0,0
2008,1997,50,7,57,15,23,38,0,0,0,0,0,0
2008,2000,75,4,79,3,32,35,0,0,0,0,0,0
2008,2001,17,2,19,0,7,7,0,0,0,0,0,0
2008,2002,52,6,58,3,17,20,0,0,0,0,0,0
2008,2100,120,13,133,19,66,85,57,20,77,10,16,26
2008,2101,8,0,8,0,1,1,0,0,0,0,0,0
2008,2103,9,2,11,3,2,5,0,0,0,0,0,0
2008,2104,33,1,34,0,11,11,0,0,0,0,0,0
2008,2105,20,2,22,0,5,5,0,0,0,0,0,0
2008,2106,44,11,55,2,21,23,0,0,0,0,0,0
2008,2107,8,0,8,0,0,0,0,0,0,0,0,0
2008,2108,15,3,18,0,7,7,0,0,0,0,0,0
2008,2109,67,6,73,5,19,24,0,0,0,0,0,0
2008,2110,15,3,18,2,3,5,0,0,0,0,0,0
2008,2111,14,1,15,0,4,4,0,0,0,0,0,0
2008,2113,7,0,7,1,0,1,0,0,0,0,0,0
2008,2200,33,6,39,3,11,14,9,7,16,0,0,0
2008,2300,74,2,76,8,24,32,38,16,54,2,8,10
2008,2301,13,3,16,0,6,6,0,0,0,0,0,0
2008,2303,28,0,28,0,11,11,0,0,0,0,0,0
2008,2304,11,1,12,2,5,7,0,0,0,0,0,0
2008,2400,108,2,110,5,30,35,64,27,91,11,10,21
2008,2401,32,1,33,2,8,10,0,0,0,0,0,0
2008,2402,5,2,7,0,2,2,0,0,0,0,0,0
2008,2403,8,1,9,0,2,2,0,0,0,0,0,0
2008,2404,18,1,19,1,8,9,0,0,0,0,0,0
2008,2405,42,3,45,5,15,20,0,0,0,0,0,0
2008,2406,96,8,104,9,33,42,0,0,0,0,0,0
2008,2412,7,3,10,1,7,8,0,0,0,0,0,0
2008,2500,13,1,14,2,4,6,5,4,9,0,0,0
2008,2501,6,0,6,0,1,1,0,0,0,0,0,0
2008,2600,27,0,27,0,0,0,0,0,0,10,7,17
2008,2601,21,1,22,1,3,4,0,0,0,0,0,0
2008,2700,138,12,150,8,66,74,124,40,164,17,25,42
2008,2701,13,1,14,1,7,8,0,0,0,0,0,0
2008,2702,6,0,6,0,0,0,0,0,0,0,0,0
2008,2703,12,1,13,0,2,2,0,0,0,0,0,0
2008,2704,13,4,17,1,3,4,0,0,0,0,0,0
2008,2705,18,1,19,0,3,3,0,0,0,0,0,0
2008,2706,48,6,54,4,3,7,0,0,0,5,5,10
2008,2707,14,5,19,1,6,7,0,0,0,0,0,0
2008,2708,161,16,177,13,57,70,0,0,0,0,0,0
2008,2709,9,1,10,0,1,1,0,0,0,0,0,0
2008,2710,45,4,49,4,11,15,0,0,0,0,3,3
2008,2711,21,1,22,0,6,6,0,0,0,0,0,0
2008,2712,26,4,30,1,8,9,0,0,0,0,0,0
2008,2714,6,0,6,0,0,0,0,0,0,0,0,0
2008,2719,12,2,14,1,1,2,0,0,0,0,0,0
2008,2800,92,6,98,9,22,31,0,0,0,0,0,0
2008,2801,9,2,11,1,3,4,0,0,0,0,0,0
2008,2802,65,9,74,3,38,41,0,0,0,0,0,0
2008,2803,11,1,12,0,4,4,0,0,0,0,0,0
2008,2808,87,10,97,2,8,10,0,0,0,0,0,0
2008,2900,55,6,61,4,33,37,8,0,8,35,44,79
2008,2901,27,1,28,1,9,10,0,0,0,0,0,0
2008,2902,11,0,11,0,1,1,0,0,0,0,0,0
2008,2908,26,0,26,0,4,4,0,0,0,0,0,0
2008,3000,970,108,1078,606,660,1266,669,107,776,330,195,525
2008,3001,371,32,403,37,136,173,13,8,21,0,9,9
2008,3002,94,9,103,4,36,40,0,0,0,1,0,1
2008,3003,86,7,93,3,38,41,0,0,0,4,1,5
2008,3004,145,17,162,12,54,66,0,0,0,6,4,10
2008,3005,57,1,58,1,12,13,0,0,0,4,2,6
2008,3006,23,1,24,0,7,7,0,0,0,0,0,0
2008,3007,56,5,61,3,19,22,0,0,0,0,0,0
2008,3008,140,18,158,5,64,69,0,0,0,4,1,5
2008,3009,162,9,171,19,54,73,0,0,0,0,0,0
2008,3010,214,10,224,29,93,122,0,0,0,13,5,18
2008,3011,41,6,47,5,30,35,0,0,0,0,0,0
2008,3012,64,4,68,10,27,37,0,0,0,0,0,0
2008,3013,19,2,21,0,4,4,0,0,0,0,0,0
2008,3014,132,10,142,27,53,80,0,0,0,7,2,9
2008,3015,142,17,159,19,55,74,0,0,0,0,0,0
2008,3016,45,3,48,2,14,16,0,0,0,0,0,0
2008,3019,335,30,365,44,148,192,0,0,0,53,67,120
2008,3020,27,2,29,6,6,12,5,4,9,0,0,0
2008,3022,87,9,96,6,47,53,0,0,0,0,0,0
2008,3024,96,6,102,5,37,42,0,0,0,2,0,2
2008,3026,146,36,182,22,67,89,0,0,0,0,0,0
2008,3027,16,4,20,1,7,8,0,0,0,0,0,0
2008,3097,27,3,30,3,7,10,0,0,0,0,0,0
2008,3100,159,14,173,14,81,95,48,10,58,60,48,108
2008,3101,21,1,22,1,10,11,0,0,0,0,0,0
2008,3103,36,1,37,3,10,13,0,0,0,0,0,0
2008,3104,47,6,53,3,26,29,0,0,0,0,0,0
2008,3105,121,7,128,12,49,61,0,0,0,5,6,11
2008,3200,32,2,34,0,15,15,0,0,0,10,9,19
2008,3300,1639,171,1810,174,738,912,306,50,356,687,344,1031
2008,3301,35,3,38,2,15,17,0,0,0,0,0,0
2008,3302,52,4,56,1,19,20,0,0,0,0,0,0
2008,3303,24,1,25,4,8,12,0,0,0,0,0,0
2008,3306,20,3,23,2,3,5,0,0,0,0,0,0
2008,3308,75,3,78,4,26,30,0,0,0,0,0,0
2008,3309,72,4,76,15,39,54,0,0,0,0,0,0
2008,3311,82,12,94,14,38,52,0,0,0,5,4,9
2008,3313,349,36,385,30,139,169,0,0,0,0,0,0
2008,3315,157,21,178,11,59,70,0,0,0,4,0,4
2008,3325,52,5,57,15,22,37,0,0,0,0,0,0
2008,3342,80,9,89,5,37,42,0,0,0,0,0,0
2008,3344,18,2,20,1,8,9,0,0,0,0,0,0
2008,3397,26,3,29,2,10,12,0,0,0,0,0,0
2008,3400,835,169,1004,177,302,479,396,110,506,137,276,413
2008,3401,79,9,88,1,28,29,0,0,0,0,0,0
2008,3402,29,2,31,1,11,12,0,0,0,0,0,0
2008,3403,5,0,5,0,0,0,0,0,0,0,0,0
2008,3404,590,123,713,104,261,365,0,0,0,0,0,0
2008,3408,20,1,21,1,8,9,0,0,0,0,0,0
2008,3414,19,2,21,5,1,6,0,0,0,0,0,0
2008,3420,5,0,5,4,1,5,0,0,0,0,0,0
2008,3422,457,144,601,0,0,0,0,0,0,0,0,0
2008,3477,101,15,116,41,17,58,0,0,0,0,0,0
2008,3496,71,12,83,6,39,45,0,0,0,0,0,0
2008,3499,6516,629,7145,1603,1929,3532,0,0,0,0,0,0
2008,3500,28,3,31,0,6,6,17,11,28,1,3,4
2008,3501,25,5,30,0,4,4,0,0,0,0,0,0
2008,3600,1136,168,1304,259,715,974,374,86,460,193,468,661
2008,3601,31,3,34,1,16,17,0,0,0,0,0,0
2008,3602,87,10,97,3,46,49,0,0,0,0,0,0
2008,3603,70,2,72,6,28,34,0,0,0,0,0,0
2008,3604,181,18,199,11,78,89,0,0,0,0,0,0
2008,3605,45,12,57,2,23,25,0,0,0,0,0,0
2008,3607,217,11,228,16,89,105,0,0,0,0,0,0
2008,3608,73,12,85,13,46,59,0,0,0,0,0,0
2008,3609,93,14,107,7,39,46,0,0,0,0,0,0
2008,3610,314,29,343,25,120,145,0,0,0,0,0,0
2008,3611,75,3,78,7,31,38,0,0,0,0,0,0
2008,3614,12,1,13,3,6,9,0,0,0,0,0,0
2008,3623,25,1,26,36,21,57,0,0,0,0,0,0
2008,3639,10,0,10,4,1,5,0,0,0,0,0,0
2008,3650,12,3,15,36,23,59,0,0,0,0,0,0
2008,3657,33,6,39,0,11,11,0,0,0,0,0,0
2008,3700,1195,192,1387,343,540,883,742,199,941,293,449,742
2008,3701,105,11,116,7,37,44,0,0,0,0,0,0
2008,3702,222,22,244,11,64,75,1,0,1,5,8,13
2008,3703,36,4,40,3,18,21,0,0,0,0,0,0
2008,3705,115,6,121,16,52,68,0,0,0,0,0,0
2008,3706,143,16,159,10,54,64,0,0,0,0,0,0
2008,3708,58,7,65,4,25,29,0,0,0,0,0,0
2008,3709,83,7,90,8,34,42,0,0,0,0,0,0
2008,3710,183,23,206,18,78,96,0,0,0,0,0,0
2008,3711,1705,282,1987,273,515,788,0,0,0,0,0,0
2008,3714,23,5,28,8,15,23,0,0,0,0,0,0
2008,3715,124,19,143,9,18,27,0,0,0,0,0,0
2008,3732,15,1,16,7,13,20,0,0,0,0,0,0
2008,3797,30,5,35,17,14,31,0,0,0,0,0,0
2008,3800,274,56,330,73,95,168,456,97,553,8,7,15
2008,3801,2005,386,2391,159,223,382,0,0,0,0,0,0
2008,3803,22,2,24,8,14,22,0,0,0,0,0,0
2008,3816,12,2,14,0,0,0,0,0,0,0,0,0
2008,3897,33,6,39,63,19,82,0,0,0,0,0,0
2008,3900,288,36,324,57,126,183,27,3,30,223,109,332
2008,3901,11,0,11,0,4,4,0,0,0,0,0,0
2008,3902,69,7,76,2,36,38,0,0,0,0,0,0
2008,3903,74,4,78,6,22,28,0,0,0,0,0,0
2008,3904,22,5,27,3,9,12,0,0,0,0,0,0
2008,3905,376,37,413,81,158,239,0,0,0,0,0,0
2008,3906,80,7,87,9,39,48,0,0,0,0,0,0
2008,3915,15,3,18,1,5,6,0,0,0,0,0,0
2008,4000,151,6,157,11,54,65,0,0,0,103,57,160
2008,4001,20,3,23,2,6,8,0,0,0,0,0,0
2008,4002,19,0,19,2,8,10,0,0,0,0,0,0
2008,4003,14,3,17,1,5,6,0,0,0,0,0,0
2008,4004,36,4,40,2,10,12,0,0,0,0,0,0
2008,4005,20,3,23,0,10,10,0,0,0,0,0,0
2008,4006,51,11,62,3,22,25,0,0,0,0,0,0
2008,4007,16,2,18,5,15,20,0,0,0,0,0,0
2008,4008,22,6,28,3,9,12,0,0,0,0,0,0
2008,4016,78,38,116,1,11,12,0,0,0,0,0,0
2008,4019,6,0,6,1,0,1,0,0,0,0,0,0
2008,4100,189,29,218,44,72,116,175,42,217,11,39,50
2008,4101,17,2,19,1,4,5,0,0,0,0,0,0
2008,4102,29,3,32,4,9,13,0,0,0,0,0,0
2008,4103,11,4,15,0,3,3,0,0,0,0,0,0
2008,4104,38,6,44,4,15,19,0,0,0,0,0,0
2008,4105,18,1,19,0,7,7,0,0,0,0,0,0
2008,4106,102,11,113,13,28,41,0,0,0,0,0,0
2008,4107,16,0,16,1,4,5,0,0,0,0,0,0
2008,4108,22,4,26,2,8,10,0,0,0,0,0,0
2008,4109,39,8,47,8,14,22,0,0,0,0,0,0
2008,4110,17,2,19,1,4,5,0,0,0,0,0,0
2008,4111,38,1,39,1,12,13,0,0,0,0,0,0
2008,4113,79,15,94,5,34,39,0,0,0,0,0,0
2008,4114,41,5,46,2,16,18,0,0,0,0,0,0
2008,4115,24,6,30,1,6,7,0,0,0,0,0,0
2008,4116,100,14,114,6,30,36,0,0,0,0,0,0
2008,4117,71,9,80,6,23,29,0,0,0,0,0,0
2008,4119,10,1,11,0,1,1,0,0,0,0,0,0
2008,4120,34,5,39,5,10,15,0,0,0,0,0,0
2008,4127,27,2,29,2,8,10,0,0,0,0,0,0
2008,4200,273,19,292,22,94,116,141,46,187,27,32,59
2008,4201,11,1,12,0,3,3,0,0,0,0,0,0
2008,4202,47,3,50,1,8,9,0,0,0,5,9,14
2008,4203,123,14,137,18,47,65,0,0,0,0,0,0
2008,4204,102,8,110,4,45,49,0,0,0,0,0,0
2008,4211,3,1,4,1,1,2,0,0,0,0,0,0
2008,4297,29,3,32,7,7,14,0,0,0,0,0,0
2008,4300,424,57,481,53,108,161,34,7,41,0,0,0
2008,4302,42,3,45,3,18,21,0,0,0,0,0,0
2008,4304,52,8,60,7,25,32,0,0,0,2,2,4
2008,4305,27,2,29,3,13,16,0,0,0,0,0,0
2008,4307,38,4,42,6,15,21,0,0,0,0,0,0
2008,4308,78,8,86,4,20,24,0,0,0,0,0,0
2008,4310,35,2,37,3,16,19,0,0,0,0,0,0
2008,4311,90,7,97,16,33,49,0,0,0,0,0,0
2008,4312,69,22,91,23,43,66,0,0,0,0,0,0
2008,4313,1245,138,1383,85,286,371,0,0,0,0,0,0
2008,4314,133,15,148,16,49,65,0,0,0,4,2,6
2008,4316,206,17,223,14,52,66,0,0,0,0,0,0
2008,4317,26,3,29,14,10,24,0,0,0,0,0,0
2008,4320,5,1,6,5,1,6,0,0,0,0,0,0
2008,4321,6,1,7,2,2,4,0,0,0,0,0,0
2008,4327,9,1,10,7,3,10,0,0,0,0,0,0
2008,4400,113,20,133,15,40,55,4,1,5,88,60,148
2008,4401,20,2,22,6,5,11,0,0,0,0,0,0
2008,4402,86,9,95,7,19,26,0,0,0,0,0,0
2008,4403,60,4,64,8,15,23,0,0,0,0,0,0
2008,4404,19,0,19,2,6,8,0,0,0,0,0,0
2008,4497,17,4,21,8,18,26,0,0,0,0,0,0
2008,4500,83,12,95,10,39,49,45,23,68,10,18,28
2008,4501,16,2,18,0,11,11,0,0,0,0,0,0
2008,4502,112,6,118,12,42,54,0,0,0,0,0,0
2008,4600,11,0,11,0,0,0,0,0,0,1,3,4
2008,4700,56,3,59,10,11,21,25,7,32,5,4,9
2008,4703,2,0,2,0,1,1,0,0,0,0,0,0
2008,4706,8,1,9,1,4,5,0,0,0,0,0,0
2008,4707,3,0,3,0,0,0,0,0,0,0,0,0
2008,4708,10,0,10,3,3,6,0,0,0,0,0,0
2008,4709,14,0,14,2,4,6,0,0,0,0,0,0
2008,4710,4,0,4,0,1,1,0,0,0,0,0,0
2008,4800,104,10,114,18,62,80,1,0,1,193,89,282
2008,4801,35,1,36,1,14,15,0,0,0,0,0,0
2008,4802,21,3,24,1,5,6,0,0,0,0,0,0
2008,4803,117,6,123,12,54,66,0,0,0,0,0,0
2008,4804,8,2,10,0,1,1,0,0,0,0,0,0
2008,4805,25,0,25,1,10,11,0,0,0,0,0,0
2008,4806,102,10,112,7,57,64,0,0,0,0,0,0
2008,4807,109,8,117,6,21,27,0,0,0,0,0,0
2008,4813,3,1,4,0,2,2,0,0,0,0,0,0
2008,4900,242,19,261,26,88,114,197,49,246,33,52,85
2008,4901,12,2,14,2,7,9,0,0,0,0,0,0
2008,4902,12,0,12,0,7,7,0,0,0,0,0,0
2008,4903,16,3,19,2,9,11,0,0,0,0,0,0
2008,4904,78,3,81,4,24,28,0,0,0,0,0,0
2008,4905,160,18,178,15,68,83,0,0,0,0,0,0
2008,4906,12,2,14,1,6,7,0,0,0,0,0,0
2008,4908,65,5,70,2,22,24,0,0,0,0,0,0
2008,4909,9,3,12,2,3,5,0,0,0,0,0,0
2008,4914,12,0,12,4,8,12,0,0,0,0,0,0
2008,5000,238,15,253,20,102,122,175,42,217,6,63,69
2008,5001,48,3,51,5,17,22,0,0,0,0,0,0
2008,5002,247,14,261,8,93,101,0,0,0,0,0,0
2008,5003,12,0,12,1,3,4,0,0,0,0,0,0
2008,5004,25,1,26,2,8,10,0,0,0,0,0,0
2008,5007,72,7,79,3,38,41,0,0,0,0,0,0
2008,5010,8,3,11,3,8,11,0,0,0,0,0,0
2008,5100,46,5,51,3,23,26,34,17,51,0,6,6
2008,5102,60,8,68,7,29,36,0,0,0,0,0,0
2008,5200,46,3,49,5,21,26,25,11,36,2,4,6
2008,5201,13,1,14,2,8,10,0,0,0,0,0,0
2008,5202,22,2,24,4,11,15,0,0,0,0,0,0
2008,5300,16,1,17,1,5,6,0,0,0,6,7,13
2008,5400,234,29,263,16,81,97,190,46,236,38,52,90
2008,5401,34,4,38,3,9,12,0,0,0,0,0,0
2008,5402,13,3,16,0,1,1,0,0,0,0,0,0
2008,5403,16,0,16,1,1,2,0,0,0,0,0,0
2008,5404,15,1,16,1,3,4,0,0,0,0,0,0
2008,5405,50,5,55,2,20,22,0,0,0,0,0,0
2008,5406,61,11,72,5,31,36,0,0,0,0,0,0
2008,5407,119,16,135,12,46,58,0,0,0,0,0,0
2008,5408,14,0,14,0,2,2,0,0,0,0,0,0
2008,5411,4,1,5,0,1,1,0,0,0,0,0,0
2008,5500,63,2,65,2,20,22,0,0,0,26,18,44
2008,5501,13,1,14,0,4,4,0,0,0,0,0,0
2008,5600,469,57,526,96,206,302,173,24,197,105,93,198
2008,5604,211,23,234,37,77,114,0,0,0,5,3,8
2008,5605,20,3,23,1,7,8,0,0,0,0,0,0
2008,5606,33,1,34,4,7,11,0,0,0,0,0,0
2008,5608,131,9,140,6,36,42,0,0,0,0,0,0
2008,5609,117,10,127,16,46,62,0,0,0,0,0,0
2008,5622,12,1,13,5,9,14,0,0,0,0,0,0
2008,5680,14,1,15,0,1,1,0,0,0,0,0,0
2008,5700,72,10,82,9,32,41,2,0,2,74,57,131
2008,5701,52,7,59,8,27,35,0,0,0,0,0,0
2008,5702,11,0,11,0,2,2,0,0,0,0,0,0
2008,5703,57,8,65,2,23,25,0,0,0,0,0,0
2008,5704,67,5,72,7,30,37,0,0,0,0,0,0
2008,5797,35,8,43,12,22,34,0,0,0,0,0,0
2008,5800,63,4,67,5,26,31,50,19,69,6,4,10
2008,5801,18,1,19,0,12,12,0,0,0,0,0,0
2008,5802,6,2,8,0,0,0,0,0,0,0,0,0
2008,10M1,186,33,219,1,7,8,0,0,0,0,0,0
2008,190C,24,1,25,3,4,7,0,0,0,0,0,0
2008,190R,7,1,8,3,2,5,0,0,0,0,0,0
2008,340H,118,10,128,17,50,67,0,0,0,0,0,0
2009,100,443,57,500,182,217,399,438,61,499,95,166,261
2009,101,80,11,91,4,31,35,0,0,0,4,4,8
2009,102,24,1,25,2,7,9,0,0,0,0,0,0
2009,103,139,40,179,24,62,86,1,0,1,6,8,14
2009,104,37,2,39,3,14,17,0,0,0,0,0,0
2009,105,160,16,176,11,73,84,1,0,1,7,7,14
2009,106,163,22,185,15,69,84,0,0,0,13,10,23
2009,107,83,7,90,8,47,55,0,0,0,0,0,0
2009,108,50,5,55,5,17,22,0,0,0,0,0,0
2009,109,706,87,793,45,219,264,0,0,0,0,0,0
2009,110,17,2,19,2,6,8,0,0,0,0,0,0
2009,111,76,7,83,4,30,34,0,0,0,0,0,0
2009,112,87,5,92,5,31,36,0,0,0,6,2,8
2009,113,61,9,70,3,23,26,0,0,0,0,0,0
2009,114,51,6,57,5,18,23,0,0,0,0,0,0
2009,115,11,3,14,3,6,9,0,0,0,0,0,0
2009,197,44,18,62,24,25,49,0,0,0,0,0,0
2009,200,11,0,11,0,3,3,0,0,0,0,0,0
2009,300,46,1,47,2,16,18,1,0,1,11,14,25
2009,302,5,1,6,0,1,1,0,0,0,0,0,0
2009,303,10,1,11,0,1,1,0,0,0,0,0,0
2009,305,7,0,7,1,0,1,0,0,0,0,0,0
2009,400,96,4,100,7,41,48,1,0,1,66,41,107
2009,402,88,7,95,12,43,55,0,0,0,0,0,0
2009,403,15,1,16,0,5,5,0,0,0,0,0,0
2009,404,21,2,23,4,7,11,0,0,0,0,0,0
2009,405,26,0,26,2,12,14,0,0,0,0,0,0
2009,497,14,2,16,1,7,8,0,0,0,0,0,0
2009,500,51,5,56,6,22,28,2,0,2,10,10,20
2009,501,9,0,9,0,1,1,0,0,0,0,0,0
2009,600,28,2,30,1,19,20,2,0,2,6,6,12
2009,601,7,2,9,0,1,1,0,0,0,0,0,0
2009,602,10,0,10,0,2,2,0,0,0,0,0,0
2009,700,279,44,323,47,151,198,276,41,317,57,61,118
2009,701,105,9,114,4,36,40,0,0,0,2,2,4
2009,702,55,6,61,2,15,17,0,0,0,0,0,0
2009,703,10,1,11,0,1,1,0,0,0,0,0,0
2009,704,126,26,152,8,36,44,0,0,0,2,2,4
2009,705,39,2,41,3,8,11,0,0,0,0,0,0
2009,706,28,2,30,0,3,3,0,0,0,0,0,0
2009,707,30,2,32,3,12,15,0,0,0,0,0,0
2009,708,66,9,75,1,18,19,0,0,0,0,4,4
2009,709,38,5,43,4,14,18,0,0,0,0,0,0
2009,710,164,15,179,27,63,90,0,0,0,1,5,6
2009,711,50,4,54,5,13,18,0,0,0,0,2,2
2009,712,62,16,78,8,29,37,0,0,0,0,0,0
2009,713,9,0,9,0,0,0,0,0,0,0,0,0
2009,714,37,2,39,2,12,14,0,0,0,0,0,0
2009,716,9,0,9,0,1,1,0,0,0,0,0,0
2009,718,167,17,184,43,33,76,0,0,0,0,0,0
2009,721,21,3,24,6,6,12,0,0,0,0,0,0
2009,724,53,3,56,4,15,19,0,0,0,0,0,0
2009,800,26,3,29,5,4,9,1,0,1,14,10,24
2009,801,10,3,13,0,1,1,0,0,0,0,0,0
2009,900,163,8,171,4,74,78,12,1,13,70,47,117
2009,901,16,1,17,1,8,9,0,0,0,0,0,0
2009,902,35,5,40,6,16,22,0,0,0,0,0,0
2009,1000,377,47,424,53,131,184,296,111,407,9,20,29
2009,1001,81,12,93,8,34,42,0,0,0,1,2,3
2009,1002,18,2,20,2,8,10,0,0,0,0,0,0
2009,1003,10,2,12,0,4,4,0,0,0,0,0,0
2009,1004,10,0,10,0,1,1,0,0,0,0,0,0
2009,1005,726,101,827,114,276,390,0,0,0,0,0,0
2009,1006,13,0,13,1,3,4,0,0,0,0,0,0
2009,1007,14,2,16,2,1,3,0,0,0,0,0,0
2009,1008,14,1,15,0,6,6,0,0,0,0,0,0
2009,1009,8,1,9,0,1,1,0,0,0,0,0,0
2009,1011,14,2,16,0,3,3,0,0,0,0,0,0
2009,1012,30,2,32,1,12,13,0,0,0,0,0,0
2009,1013,29,1,30,4,4,8,0,0,0,0,0,0
2009,1015,32,4,36,2,8,10,0,0,0,0,0,0
2009,1017,14,1,15,1,2,3,0,0,0,0,0,0
2009,1031,1,1,2,0,1,1,0,0,0,0,0,0
2009,1097,18,3,21,0,9,9,0,0,0,0,0,0
2009,1100,21,3,24,4,11,15,1,0,1,12,9,21
2009,1101,8,0,8,0,2,2,0,0,0,0,0,0
2009,1102,7,4,11,1,1,2,0,0,0,0,0,0
2009,1200,79,8,87,5,35,40,70,24,94,6,4,10
2009,1201,22,3,25,2,8,10,0,0,0,0,0,0
2009,1203,43,4,47,2,26,28,0,0,0,0,0,0
2009,1204,4,0,4,0,0,0,0,0,0,0,0,0
2009,1205,16,0,16,1,8,9,0,0,0,0,0,0
2009,1206,2,0,2,0,0,0,0,0,0,0,0,0
2009,1207,5,1,6,0,1,1,0,0,0,0,0,0
2009,1208,7,6,13,1,7,8,0,0,0,0,0,0
2009,1300,97,3,100,9,52,61,62,20,82,9,18,27
2009,1301,33,1,34,3,12,15,0,0,0,0,0,0
2009,1302,41,2,43,11,17,28,0,0,0,0,0,0
2009,1303,3,1,4,0,0,0,0,0,0,0,0,0
2009,1304,54,1,55,5,18,23,0,0,0,0,0,0
2009,1305,5,0,5,0,1,1,0,0,0,0,0,0
2009,1306,16,1,17,1,1,2,0,0,0,0,0,0
2009,1307,5,0,5,0,0,0,0,0,0,0,0,0
2009,1400,25,1,26,3,12,15,11,1,12,1,3,4
2009,1401,12,1,13,2,4,6,0,0,0,0,0,0
2009,1500,342,22,364,37,180,217,374,118,492,19,48,67
2009,1501,16,2,18,2,6,8,0,0,0,0,0,0
2009,1502,315,24,339,19,107,126,0,0,0,0,0,0
2009,1503,46,2,48,8,14,22,0,0,0,3,2,5
2009,1506,31,2,33,3,14,17,0,0,0,0,0,0
2009,1507,16,2,18,2,6,8,0,0,0,0,0,0
2009,1508,12,2,14,0,10,10,0,0,0,0,0,0
2009,1509,11,2,13,0,2,2,0,0,0,0,0,0
2009,1511,16,0,16,2,5,7,0,0,0,0,0,0
2009,1514,3,0,3,0,0,0,0,0,0,0,0,0
2009,1515,7,1,8,1,8,9,0,0,0,0,0,0
2009,1597,8,3,11,1,3,4,0,0,0,0,0,0
2009,1600,73,7,80,4,40,44,0,0,0,48,49,97
2009,1601,17,4,21,1,9,10,0,0,0,0,0,0
2009,1602,46,5,51,2,20,22,0,0,0,0,0,0
2009,1603,28,3,31,2,5,7,0,0,0,0,0,0
2009,1700,54,4,58,4,21,25,1,0,1,40,34,74
2009,1701,12,1,13,0,2,2,0,0,0,0,0,0
2009,1702,20,2,22,1,7,8,0,0,0,0,0,0
2009,1800,28,3,31,2,7,9,26,16,42,2,11,13
2009,1801,13,0,13,1,1,2,0,0,0,0,0,0
2009,1900,6565,1247,7812,2183,3671,5854,1369,386,1755,486,682,1168
2009,1901,73,10,83,6,39,45,0,0,0,0,0,0
2009,1902,65,3,68,3,23,26,0,0,0,3,2,5
2009,1905,58,2,60,6,23,29,0,0,0,0,0,0
2009,1906,69,6,75,0,23,23,0,0,0,6,1,7
2009,1907,28,3,31,1,11,12,0,0,0,0,1,1
2009,1909,44,4,48,5,15,20,0,0,0,0,0,0
2009,1910,124,9,133,15,44,59,0,0,0,4,4,8
2009,1912,150,10,160,20,67,87,0,0,0,6,4,10
2009,1913,35,4,39,2,14,16,0,0,0,5,1,6
2009,1916,55,1,56,5,23,28,0,0,0,3,1,4
2009,1918,101,7,108,17,25,42,0,0,0,3,1,4
2009,1920,105,14,119,12,38,50,0,0,0,0,0,0
2009,1922,119,8,127,13,26,39,0,0,0,5,3,8
2009,1923,64,6,70,3,23,26,0,0,0,5,3,8
2009,1924,80,9,89,4,14,18,0,0,0,5,3,8
2009,1925,231,27,258,28,69,97,0,0,0,7,9,16
2009,1926,46,7,53,10,28,38,0,0,0,2,3,5
2009,1928,91,8,99,0,22,22,0,0,0,8,4,12
2009,1929,34,2,36,10,5,15,0,0,0,1,9,10
2009,1931,68,3,71,8,26,34,0,0,0,5,1,6
2009,1933,166,23,189,11,59,70,0,0,0,3,8,11
2009,1934,28,0,28,0,9,9,0,0,0,0,0,0
2009,1938,41,4,45,4,15,19,0,0,0,1,0,1
2009,1941,862,87,949,92,232,324,6,0,6,30,19,49
2009,1942,8063,1884,9947,925,1923,2848,27,6,33,235,132,367
2009,1944,55,9,64,11,18,29,0,0,0,3,2,5
2009,1945,37,2,39,4,13,17,0,0,0,4,1,5
2009,1946,47,6,53,6,20,26,0,0,0,0,4,4
2009,1947,77,6,83,6,30,36,0,0,0,6,1,7
2009,1948,66,11,77,3,21,24,0,0,0,2,3,5
2009,1951,22,3,25,3,3,6,0,0,0,2,2,4
2009,1953,210,34,244,23,79,102,0,0,0,13,8,21
2009,1955,164,14,178,26,66,92,0,0,0,11,8,19
2009,1956,80,7,87,11,45,56,0,0,0,2,7,9
2009,1961,34,2,36,3,9,12,0,0,0,3,3,6
2009,1962,54,2,56,3,11,14,0,0,0,0,0,0
2009,1963,21,5,26,1,6,7,0,0,0,0,0,0
2009,1965,184,18,202,85,92,177,0,1,1,9,8,17
2009,1966,14,3,17,2,3,5,0,0,0,0,0,0
2009,1967,30,4,34,5,8,13,0,0,0,0,0,0
2009,1969,80,4,84,4,31,35,0,0,0,4,2,6
2009,1970,34,1,35,1,14,15,0,0,0,0,0,0
2009,1972,210,15,225,24,67,91,1,0,1,6,8,14
2009,1973,50,3,53,0,16,16,0,0,0,3,0,3
2009,1975,105,8,113,12,46,58,0,0,0,4,3,7
2009,1976,115,10,125,16,38,54,0,0,0,0,0,0
2009,1978,18,2,20,2,9,11,0,0,0,0,0,0
2009,1981,14,2,16,4,2,6,0,0,0,0,0,0
2009,1982,24,2,26,12,15,27,0,0,0,0,0,0
2009,1983,16,4,20,7,7,14,0,0,0,0,0,0
2009,1984,21,2,23,7,8,15,0,0,0,0,0,0
2009,1997,56,7,63,6,23,29,0,0,0,0,0,0
2009,2000,70,4,74,4,32,36,0,0,0,0,0,0
2009,2001,17,2,19,0,6,6,0,0,0,0,0,0
2009,2002,54,5,59,3,18,21,0,0,0,0,0,0
2009,2100,111,15,126,19,64,83,54,22,76,12,15,27
2009,2101,8,0,8,0,1,1,0,0,0,0,0,0
2009,2103,9,2,11,3,2,5,0,0,0,0,0,0
2009,2104,29,2,31,0,9,9,0,0,0,0,0,0
2009,2105,20,2,22,0,5,5,0,0,0,0,0,0
2009,2106,47,11,58,1,18,19,0,0,0,0,0,0
2009,2107,8,0,8,0,0,0,0,0,0,0,0,0
2009,2108,15,4,19,0,7,7,0,0,0,0,0,0
2009,2109,63,6,69,4,23,27,0,0,0,0,0,0
2009,2110,16,2,18,2,3,5,0,0,0,0,0,0
2009,2111,13,0,13,0,4,4,0,0,0,0,0,0
2009,2113,5,1,6,1,0,1,0,0,0,0,0,0
2009,2200,35,5,40,3,11,14,8,8,16,0,0,0
2009,2300,75,2,77,10,22,32,36,15,51,1,7,8
2009,2301,14,3,17,0,6,6,0,0,0,0,0,0
2009,2303,26,1,27,2,12,14,0,0,0,0,0,0
2009,2304,12,1,13,2,4,6,0,0,0,0,0,0
2009,2400,101,3,104,5,27,32,70,24,94,12,10,22
2009,2401,33,1,34,2,8,10,0,0,0,0,0,0
2009,2402,5,2,7,0,2,2,0,0,0,0,0,0
2009,2403,8,1,9,0,2,2,0,0,0,0,0,0
2009,2404,17,1,18,1,9,10,0,0,0,0,0,0
2009,2405,36,3,39,4,13,17,0,0,0,0,0,0
2009,2406,93,6,99,7,30,37,0,0,0,0,0,0
2009,2412,7,3,10,2,7,9,0,0,0,0,0,0
2009,2500,13,0,13,1,2,3,5,4,9,0,0,0
2009,2501,6,0,6,0,1,1,0,0,0,0,0,0
2009,2600,26,0,26,4,3,7,0,0,0,9,7,16
2009,2601,19,1,20,0,3,3,0,0,0,0,0,0
2009,2700,150,10,160,9,69,78,114,37,151,15,27,42
2009,2701,13,1,14,1,6,7,0,0,0,0,0,0
2009,2702,6,0,6,0,0,0,0,0,0,0,0,0
2009,2703,12,1,13,0,2,2,0,0,0,0,0,0
2009,2704,12,3,15,1,3,4,0,0,0,0,0,0
2009,2705,18,1,19,0,3,3,0,0,0,0,0,0
2009,2706,47,6,53,2,5,7,0,0,0,6,6,12
2009,2707,13,6,19,1,6,7,0,0,0,0,0,0
2009,2708,150,14,164,15,43,58,0,0,0,0,0,0
2009,2709,9,1,10,0,1,1,0,0,0,0,0,0
2009,2710,43,4,47,3,11,14,0,0,0,0,2,2
2009,2711,23,1,24,0,5,5,0,0,0,0,0,0
2009,2712,24,5,29,1,8,9,0,0,0,0,0,0
2009,2714,6,0,6,0,0,0,0,0,0,0,0,0
2009,2719,10,5,15,1,1,2,0,0,0,0,0,0
2009,2800,88,5,93,9,22,31,2,1,3,0,0,0
2009,2801,9,2,11,1,3,4,0,0,0,0,0,0
2009,2802,62,9,71,3,40,43,0,0,0,0,0,0
2009,2803,11,1,12,0,4,4,0,0,0,0,0,0
2009,2808,84,7,91,1,2,3,0,0,0,0,0,0
2009,2900,58,5,63,5,36,41,9,0,9,35,39,74
2009,2901,24,1,25,1,8,9,0,0,0,0,0,0
2009,2902,10,0,10,0,0,0,0,0,0,0,0,0
2009,2908,24,1,25,0,4,4,0,0,0,0,0,0
2009,3000,957,110,1067,703,718,1421,646,94,740,236,140,376
2009,3001,352,32,384,67,128,195,13,8,21,0,9,9
2009,3002,91,8,99,3,31,34,0,0,0,1,0,1
2009,3003,83,7,90,3,38,41,0,0,0,4,1,5
2009,3004,142,17,159,11,52,63,1,0,1,7,4,11
2009,3005,53,2,55,2,11,13,0,0,0,3,2,5
2009,3006,23,1,24,0,8,8,0,0,0,0,0,0
2009,3007,55,4,59,2,19,21,0,0,0,0,0,0
2009,3008,138,18,156,5,58,63,0,0,0,4,1,5
2009,3009,158,8,166,19,55,74,0,0,0,0,0,0
2009,3010,215,10,225,23,91,114,0,0,0,14,5,19
2009,3011,41,6,47,5,30,35,0,0,0,0,0,0
2009,3012,64,4,68,9,26,35,0,0,0,0,0,0
2009,3013,18,4,22,0,4,4,0,0,0,0,0,0
2009,3014,129,10,139,30,50,80,0,0,0,7,2,9
2009,3015,142,17,159,15,55,70,0,0,0,0,0,0
2009,3016,46,3,49,2,14,16,0,0,0,0,0,0
2009,3019,324,29,353,41,138,179,0,0,0,50,64,114
2009,3020,30,1,31,7,8,15,0,0,0,4,5,9
2009,3022,82,9,91,7,44,51,0,0,0,0,0,0
2009,3024,90,6,96,5,37,42,0,0,0,2,0,2
2009,3026,156,39,195,23,64,87,0,0,0,0,0,0
2009,3027,19,3,22,1,4,5,0,0,0,0,0,0
2009,3097,27,3,30,3,7,10,0,0,0,0,0,0
2009,3100,164,19,183,21,102,123,43,7,50,57,20,77
2009,3101,21,1,22,1,6,7,0,0,0,0,0,0
2009,3103,31,1,32,2,8,10,0,0,0,0,0,0
2009,3104,46,6,52,3,25,28,0,0,0,0,0,0
2009,3105,114,8,122,12,56,68,0,0,0,5,6,11
2009,3200,31,2,33,0,13,13,0,0,0,10,9,19
2009,3300,1542,160,1702,162,688,850,299,48,347,641,317,958
2009,3301,31,4,35,1,12,13,0,0,0,0,0,0
2009,3302,53,4,57,1,19,20,0,0,0,0,0,0
2009,3303,20,1,21,4,7,11,0,0,0,0,0,0
2009,3306,27,3,30,3,3,6,0,0,0,0,0,0
2009,3308,66,2,68,4,21,25,0,0,0,0,0,0
2009,3309,69,3,72,16,34,50,0,0,0,0,0,0
2009,3311,79,13,92,11,36,47,0,0,0,5,4,9
2009,3313,333,37,370,30,137,167,0,0,0,0,0,0
2009,3315,153,21,174,10,57,67,0,0,0,3,1,4
2009,3325,50,5,55,13,26,39,0,0,0,0,0,0
2009,3342,81,9,90,4,38,42,0,0,0,0,0,0
2009,3344,15,2,17,2,6,8,0,0,0,0,0,0
2009,3397,25,3,28,2,10,12,0,0,0,0,0,0
2009,3400,516,95,611,140,251,391,480,138,618,115,238,353
2009,3401,73,8,81,2,25,27,0,0,0,0,0,0
2009,3402,30,3,33,1,12,13,0,0,0,0,0,0
2009,3403,4,0,4,0,0,0,0,0,0,0,0,0
2009,3404,573,127,700,84,243,327,0,0,0,0,0,0
2009,3408,21,1,22,0,6,6,0,0,0,0,0,0
2009,3414,19,2,21,5,1,6,0,0,0,0,0,0
2009,3420,3,0,3,4,1,5,0,0,0,0,0,0
2009,3422,464,142,606,0,0,0,0,0,0,0,0,0
2009,3477,95,13,108,33,18,51,0,0,0,0,0,0
2009,3496,75,12,87,7,33,40,0,0,0,0,0,0
2009,3499,6905,627,7532,1654,1996,3650,0,0,0,0,0,0
2009,3500,27,2,29,0,6,6,15,11,26,1,2,3
2009,3501,23,4,27,1,9,10,0,0,0,0,0,0
2009,3600,1152,173,1325,255,676,931,390,75,465,193,475,668
2009,3601,37,2,39,1,13,14,0,0,0,0,0,0
2009,3602,85,12,97,3,46,49,0,0,0,0,0,0
2009,3603,60,2,62,7,28,35,0,0,0,0,0,0
2009,3604,178,19,197,12,84,96,0,0,0,0,0,0
2009,3605,38,9,47,2,21,23,0,0,0,0,0,0
2009,3607,210,10,220,13,91,104,0,0,0,0,0,0
2009,3608,68,14,82,16,42,58,0,0,0,0,0,0
2009,3609,97,14,111,5,36,41,0,0,0,0,0,0
2009,3610,297,27,324,26,118,144,0,0,0,0,0,0
2009,3611,73,3,76,5,30,35,0,0,0,0,0,0
2009,3614,13,3,16,3,6,9,0,0,0,0,0,0
2009,3623,24,1,25,37,20,57,0,0,0,0,0,0
2009,3639,10,1,11,5,1,6,0,0,0,0,0,0
2009,3650,10,4,14,39,22,61,0,0,0,0,0,0
2009,3657,32,8,40,0,7,7,0,0,0,0,0,0
2009,3700,1141,185,1326,269,512,781,748,187,935,283,432,715
2009,3701,99,10,109,7,40,47,0,0,0,0,0,0
2009,3702,206,26,232,12,69,81,0,0,0,6,6,12
2009,3703,36,5,41,3,17,20,0,0,0,0,0,0
2009,3705,110,7,117,15,52,67,0,0,0,0,0,0
2009,3706,145,13,158,5,46,51,0,0,0,0,0,0
2009,3708,59,7,66,5,25,30,0,0,0,0,0,0
2009,3709,82,8,90,7,28,35,0,0,0,0,0,0
2009,3710,183,23,206,20,78,98,0,0,0,0,0,0
2009,3711,1618,276,1894,270,483,753,0,0,0,0,0,0
2009,3714,23,5,28,5,16,21,0,0,0,0,0,0
2009,3715,118,18,136,7,19,26,0,0,0,0,0,0
2009,3732,16,0,16,8,13,21,0,0,0,0,0,0
2009,3797,29,5,34,17,15,32,0,0,0,0,0,0
2009,3800,251,65,316,72,91,163,508,101,609,8,6,14
2009,3801,1981,386,2367,225,261,486,0,0,0,0,0,0
2009,3803,24,2,26,8,14,22,0,0,0,0,0,0
2009,3816,12,2,14,0,0,0,0,0,0,0,0,0
2009,3897,34,7,41,64,18,82,0,0,0,0,0,0
2009,3900,260,31,291,17,124,141,24,5,29,195,126,321
2009,3901,10,0,10,0,4,4,0,0,0,0,0,0
2009,3902,65,6,71,3,31,34,0,0,0,0,0,0
2009,3903,62,4,66,5,24,29,0,0,0,1,0,1
2009,3904,22,5,27,3,10,13,0,0,0,0,0,0
2009,3905,349,35,384,64,151,215,0,0,0,0,0,0
2009,3906,83,8,91,9,36,45,0,0,0,0,0,0
2009,3915,16,3,19,1,6,7,0,0,0,0,0,0
2009,4000,147,6,153,13,52,65,0,0,0,98,56,154
2009,4001,22,3,25,2,6,8,0,0,0,0,0,0
2009,4002,19,0,19,2,8,10,0,0,0,0,0,0
2009,4003,12,2,14,1,5,6,0,0,0,0,0,0
2009,4004,32,4,36,1,9,10,0,0,0,0,0,0
2009,4005,20,3,23,0,11,11,0,0,0,0,0,0
2009,4006,48,11,59,3,24,27,0,0,0,0,0,0
2009,4007,17,2,19,4,16,20,0,0,0,0,0,0
2009,4008,22,5,27,3,8,11,0,0,0,0,0,0
2009,4016,81,37,118,1,14,15,0,0,0,0,0,0
2009,4019,5,0,5,0,0,0,0,0,0,0,0,0
2009,4100,187,31,218,55,74,129,76,10,86,82,70,152
2009,4101,16,2,18,1,4,5,0,0,0,0,0,0
2009,4102,27,3,30,4,9,13,0,0,0,0,0,0
2009,4103,11,4,15,1,3,4,0,0,0,0,0,0
2009,4104,34,5,39,4,14,18,0,0,0,0,0,0
2009,4105,17,1,18,0,7,7,0,0,0,0,0,0
2009,4106,98,11,109,12,30,42,0,0,0,0,0,0
2009,4107,14,0,14,1,2,3,0,0,0,0,0,0
2009,4108,22,4,26,1,8,9,0,0,0,0,0,0
2009,4109,40,8,48,10,15,25,0,0,0,0,0,0
2009,4110,17,2,19,1,4,5,0,0,0,0,0,0
2009,4111,33,3,36,1,11,12,0,0,0,0,0,0
2009,4113,79,15,94,9,31,40,0,0,0,0,0,0
2009,4114,40,5,45,0,14,14,0,0,0,0,0,0
2009,4115,25,6,31,1,7,8,0,0,0,0,0,0
2009,4116,100,14,114,6,30,36,0,0,0,0,0,0
2009,4117,69,9,78,6,23,29,0,0,0,0,0,0
2009,4119,10,0,10,0,1,1,0,0,0,0,0,0
2009,4120,34,5,39,5,10,15,0,0,0,0,0,0
2009,4127,34,2,36,1,10,11,0,0,0,0,0,0
2009,4200,267,18,285,25,95,120,132,40,172,27,30,57
2009,4201,9,1,10,0,2,2,0,0,0,0,0,0
2009,4202,48,3,51,1,14,15,0,0,0,5,0,5
2009,4203,117,14,131,15,47,62,0,0,0,0,0,0
2009,4204,104,7,111,4,43,47,0,0,0,0,0,0
2009,4211,3,1,4,1,0,1,0,0,0,0,0,0
2009,4297,27,3,30,8,7,15,0,0,0,0,0,0
2009,4300,409,55,464,63,105,168,34,6,40,0,0,0
2009,4302,38,3,41,3,19,22,0,0,0,0,0,0
2009,4304,49,6,55,5,21,26,0,0,0,2,2,4
2009,4305,27,2,29,3,13,16,0,0,0,0,0,0
2009,4307,37,5,42,6,13,19,0,0,0,0,0,0
2009,4308,78,8,86,4,19,23,0,0,0,0,0,0
2009,4310,35,2,37,3,14,17,0,0,0,0,0,0
2009,4311,87,7,94,13,35,48,0,0,0,0,0,0
2009,4312,68,18,86,24,44,68,0,0,0,0,0,0
2009,4313,1238,133,1371,84,294,378,0,0,0,0,0,0
2009,4314,131,14,145,15,52,67,0,0,0,4,2,6
2009,4316,199,16,215,17,52,69,0,0,0,0,0,0
2009,4317,25,3,28,15,8,23,0,0,0,0,0,0
2009,4320,4,1,5,5,1,6,0,0,0,0,0,0
2009,4321,7,1,8,2,2,4,0,0,0,0,0,0
2009,4327,10,1,11,7,3,10,0,0,0,0,0,0
2009,4400,119,21,140,3,38,41,4,1,5,99,52,151
2009,4401,22,2,24,4,2,6,0,0,0,0,0,0
2009,4402,82,9,91,5,17,22,0,0,0,0,0,0
2009,4403,59,5,64,7,16,23,0,0,0,0,0,0
2009,4404,19,0,19,2,6,8,0,0,0,0,0,0
2009,4497,14,4,18,8,18,26,0,0,0,0,0,0
2009,4500,73,10,83,5,36,41,44,15,59,19,17,36
2009,4501,15,2,17,0,10,10,0,0,0,0,0,0
2009,4502,106,6,112,8,30,38,0,0,0,0,0,0
2009,4600,10,0,10,0,0,0,0,0,0,2,2,4
2009,4700,51,3,54,7,11,18,21,7,28,5,2,7
2009,4703,2,0,2,0,1,1,0,0,0,0,0,0
2009,4706,8,1,9,1,3,4,0,0,0,0,0,0
2009,4707,3,1,4,0,0,0,0,0,0,0,0,0
2009,4708,10,0,10,2,4,6,0,0,0,0,0,0
2009,4709,15,0,15,2,4,6,0,0,0,0,0,0
2009,4710,4,0,4,0,1,1,0,0,0,0,0,0
2009,4800,104,7,111,17,60,77,1,0,1,178,83,261
2009,4801,35,1,36,1,15,16,0,0,0,0,0,0
2009,4802,21,3,24,0,4,4,0,0,0,0,0,0
2009,4803,115,7,122,12,49,61,0,0,0,0,0,0
2009,4804,7,2,9,0,1,1,0,0,0,0,0,0
2009,4805,25,1,26,1,11,12,0,0,0,0,0,0
2009,4806,96,10,106,4,57,61,0,0,0,0,0,0
2009,4807,105,6,111,8,26,34,0,0,0,0,0,0
2009,4813,3,1,4,0,2,2,0,0,0,0,0,0
2009,4900,230,18,248,27,88,115,191,51,242,36,57,93
2009,4901,15,2,17,1,7,8,0,0,0,0,0,0
2009,4902,12,0,12,0,6,6,0,0,0,0,0,0
2009,4903,12,5,17,2,7,9,0,0,0,0,0,0
2009,4904,67,3,70,1,17,18,0,0,0,0,0,0
2009,4905,152,17,169,11,62,73,0,0,0,0,0,0
2009,4906,13,1,14,1,5,6,0,0,0,0,0,0
2009,4908,62,5,67,3,24,27,0,0,0,0,0,0
2009,4909,8,3,11,3,4,7,0,0,0,0,0,0
2009,4914,12,0,12,4,8,12,0,0,0,0,0,0
2009,5000,214,10,224,19,93,112,181,40,221,5,59,64
2009,5001,46,3,49,3,15,18,0,0,0,0,0,0
2009,5002,231,14,245,9,85,94,0,0,0,0,0,0
2009,5003,13,0,13,0,3,3,0,0,0,0,0,0
2009,5004,25,1,26,1,8,9,0,0,0,0,0,0
2009,5007,72,7,79,6,38,44,0,0,0,0,0,0
2009,5010,8,3,11,3,7,10,0,0,0,0,0,0
2009,5100,50,5,55,3,19,22,35,17,52,0,4,4
2009,5102,57,8,65,5,22,27,0,0,0,0,0,0
2009,5200,41,3,44,7,21,28,24,11,35,3,4,7
2009,5201,14,1,15,2,8,10,0,0,0,0,0,0
2009,5202,20,2,22,2,10,12,0,0,0,0,0,0
2009,5300,15,1,16,1,4,5,0,0,0,5,6,11
2009,5400,234,38,272,17,77,94,166,47,213,51,39,90
2009,5401,33,4,37,3,8,11,0,0,0,0,0,0
2009,5402,13,3,16,0,1,1,0,0,0,0,0,0
2009,5403,16,0,16,1,1,2,0,0,0,0,0,0
2009,5404,19,2,21,1,3,4,0,0,0,0,0,0
2009,5405,53,5,58,6,20,26,0,0,0,0,0,0
2009,5406,62,10,72,4,25,29,0,0,0,0,0,0
2009,5407,113,19,132,11,46,57,0,0,0,0,0,0
2009,5408,13,0,13,0,2,2,0,0,0,0,0,0
2009,5411,3,1,4,0,1,1,0,0,0,0,0,0
2009,5500,61,2,63,3,20,23,0,0,0,24,16,40
2009,5501,12,1,13,0,4,4,0,0,0,0,0,0
2009,5600,480,43,523,74,207,281,177,31,208,86,95,181
2009,5604,211,22,233,40,93,133,0,0,0,5,3,8
2009,5605,21,3,24,2,6,8,0,0,0,0,0,0
2009,5606,31,1,32,3,6,9,0,0,0,0,0,0
2009,5608,122,9,131,6,35,41,0,0,0,0,0,0
2009,5609,110,9,119,16,41,57,0,0,0,0,0,0
2009,5622,11,1,12,5,7,12,0,0,0,0,0,0
2009,5680,15,1,16,0,1,1,0,0,0,0,0,0
2009,5700,73,10,83,7,26,33,1,0,1,77,54,131
2009,5701,52,6,58,8,27,35,0,0,0,0,0,0
2009,5702,10,0,10,0,2,2,0,0,0,0,0,0
2009,5703,57,8,65,1,21,22,0,0,0,0,0,0
2009,5704,70,5,75,6,28,34,0,0,0,0,0,0
2009,5797,37,9,46,12,20,32,0,0,0,0,0,0
2009,5800,63,4,67,2,26,28,51,19,70,7,5,12
2009,5801,17,2,19,2,9,11,0,0,0,0,0,0
2009,5802,5,3,8,0,0,0,0,0,0,0,0,0
2009,10M1,182,35,217,3,9,12,0,0,0,0,0,0
2009,190C,24,1,25,3,4,7,0,0,0,0,0,0
2009,190R,7,1,8,3,3,6,0,0,0,0,0,0
2009,340H,117,10,127,17,50,67,0,0,0,0,0,0
2010,100,436,53,489,177,214,391,436,61,497,91,167,258
2010,101,76,9,85,3,35,38,0,0,0,5,2,7
2010,102,24,1,25,2,7,9,0,0,0,0,0,0
2010,103,133,37,170,19,63,82,1,0,1,8,6,14
2010,104,37,1,38,3,14,17,0,0,0,0,0,0
2010,105,160,17,177,10,73,83,1,0,1,9,7,16
2010,106,175,24,199,17,76,93,0,0,0,13,7,20
2010,107,76,7,83,6,39,45,0,0,0,0,0,0
2010,108,44,7,51,5,16,21,0,0,0,0,0,0
2010,109,600,74,674,47,214,261,0,0,0,0,0,0
2010,110,17,2,19,2,6,8,0,0,0,0,0,0
2010,111,74,7,81,4,28,32,0,0,0,0,0,0
2010,112,81,6,87,5,27,32,0,0,0,6,2,8
2010,113,65,9,74,3,22,25,0,0,0,0,0,0
2010,114,50,5,55,5,18,23,0,0,0,0,0,0
2010,115,13,3,16,3,7,10,0,0,0,0,0,0
2010,197,49,16,65,21,24,45,0,0,0,0,0,0
2010,200,15,0,15,0,3,3,0,0,0,0,0,0
2010,300,44,1,45,2,16,18,1,0,1,12,13,25
2010,302,5,1,6,0,1,1,0,0,0,0,0,0
2010,303,8,1,9,0,1,1,0,0,0,0,0,0
2010,305,5,0,5,0,0,0,0,0,0,0,0,0
2010,400,97,3,100,7,39,46,1,0,1,67,44,111
2010,402,90,7,97,11,38,49,0,0,0,0,0,0
2010,403,14,1,15,0,5,5,0,0,0,0,0,0
2010,404,20,3,23,10,3,13,0,0,0,0,0,0
2010,405,23,1,24,3,10,13,0,0,0,0,0,0
2010,497,14,2,16,1,7,8,0,0,0,0,0,0
2010,500,45,5,50,5,20,25,2,0,2,10,8,18
2010,501,6,0,6,0,1,1,0,0,0,0,0,0
2010,600,32,2,34,1,18,19,2,0,2,6,8,14
2010,601,6,2,8,0,1,1,0,0,0,0,0,0
2010,602,11,0,11,0,3,3,0,0,0,0,0,0
2010,700,284,48,332,44,151,195,264,41,305,60,60,120
2010,701,91,9,100,1,28,29,4,0,4,0,0,0
2010,702,56,5,61,2,14,16,0,0,0,0,0,0
2010,703,10,1,11,0,2,2,0,0,0,0,0,0
2010,704,124,23,147,9,36,45,0,0,0,3,1,4
2010,705,40,3,43,1,7,8,0,0,0,0,0,0
2010,706,28,1,29,0,4,4,0,0,0,0,0,0
2010,707,29,2,31,3,13,16,0,0,0,0,0,0
2010,708,63,9,72,1,21,22,0,0,0,0,0,0
2010,709,38,5,43,3,12,15,0,0,0,0,0,0
2010,710,171,17,188,35,60,95,0,0,0,1,5,6
2010,711,49,3,52,4,16,20,0,0,0,1,1,2
2010,712,62,14,76,5,27,32,0,0,0,0,0,0
2010,713,10,0,10,0,0,0,0,0,0,0,0,0
2010,714,37,2,39,3,13,16,0,0,0,0,0,0
2010,716,10,1,11,0,1,1,0,0,0,0,0,0
2010,718,169,21,190,43,33,76,0,0,0,0,0,0
2010,721,20,3,23,5,5,10,0,0,0,0,0,0
2010,724,55,3,58,5,15,20,0,0,0,0,0,0
2010,800,27,2,29,5,4,9,1,0,1,15,9,24
2010,801,11,3,14,0,1,1,0,0,0,0,0,0
2010,900,153,9,162,15,56,71,10,1,11,62,40,102
2010,901,17,1,18,1,6,7,0,0,0,0,0,0
2010,902,34,5,39,6,15,21,0,0,0,0,0,0
2010,1000,299,45,344,51,122,173,282,67,349,7,18,25
2010,1001,84,10,94,9,35,44,0,0,0,2,2,4
2010,1002,18,3,21,2,7,9,0,0,0,0,0,0
2010,1003,10,2,12,0,4,4,0,0,0,0,0,0
2010,1004,10,0,10,0,1,1,0,0,0,0,0,0
2010,1005,694,99,793,54,160,214,0,0,0,0,0,0
2010,1006,11,0,11,1,3,4,0,0,0,0,0,0
2010,1007,15,3,18,2,1,3,0,0,0,0,0,0
2010,1008,13,1,14,0,7,7,0,0,0,0,0,0
2010,1009,11,1,12,0,2,2,0,0,0,0,0,0
2010,1011,15,1,16,0,3,3,0,0,0,0,0,0
2010,1012,30,3,33,1,13,14,0,0,0,0,0,0
2010,1013,34,1,35,3,4,7,0,0,0,0,0,0
2010,1015,27,4,31,1,7,8,0,0,0,0,0,0
2010,1017,14,1,15,1,2,3,0,0,0,0,0,0
2010,1097,17,3,20,0,8,8,0,0,0,0,0,0
2010,1100,20,3,23,5,12,17,3,0,3,13,12,25
2010,1101,9,1,10,0,2,2,0,0,0,0,0,0
2010,1102,7,3,10,0,1,1,0,0,0,0,0,0
2010,1200,78,8,86,5,35,40,65,26,91,6,4,10
2010,1201,23,3,26,2,8,10,0,0,0,0,0,0
2010,1203,44,4,48,2,25,27,0,0,0,0,0,0
2010,1204,4,0,4,0,0,0,0,0,0,0,0,0
2010,1205,18,0,18,1,8,9,0,0,0,0,0,0
2010,1207,7,1,8,0,1,1,0,0,0,0,0,0
2010,1208,6,6,12,1,7,8,0,0,0,0,0,0
2010,1300,95,3,98,8,53,61,61,21,82,10,20,30
2010,1301,36,2,38,3,11,14,0,0,0,0,0,0
2010,1302,38,2,40,6,13,19,0,0,0,0,0,0
2010,1303,3,1,4,0,0,0,0,0,0,0,0,0
2010,1304,50,2,52,4,19,23,0,0,0,0,0,0
2010,1306,16,0,16,2,1,3,0,0,0,0,0,0
2010,1307,5,0,5,0,0,0,0,0,0,0,0,0
2010,1400,23,1,24,3,12,15,10,0,10,1,3,4
2010,1401,12,0,12,1,5,6,0,0,0,0,0,0
2010,1500,336,27,363,35,157,192,355,104,459,29,48,77
2010,1501,16,2,18,3,6,9,0,0,0,0,0,0
2010,1502,324,25,349,19,101,120,0,0,0,0,0,0
2010,1503,43,3,46,11,12,23,0,0,0,3,2,5
2010,1505,6,1,7,0,3,3,0,0,0,0,0,0
2010,1506,30,2,32,4,12,16,0,0,0,0,0,0
2010,1507,21,2,23,2,6,8,0,0,0,0,0,0
2010,1508,14,2,16,0,10,10,0,0,0,0,0,0
2010,1509,12,2,14,0,2,2,0,0,0,0,0,0
2010,1511,15,0,15,2,5,7,0,0,0,0,0,0
2010,1514,3,0,3,0,0,0,0,0,0,0,0,0
2010,1515,7,1,8,1,8,9,0,0,0,0,0,0
2010,1597,8,3,11,1,3,4,0,0,0,0,0,0
2010,1600,68,8,76,4,37,41,0,0,0,51,46,97
2010,1601,16,3,19,4,8,12,0,0,0,0,0,0
2010,1602,46,5,51,3,20,23,0,0,0,0,0,0
2010,1603,24,3,27,2,5,7,0,0,0,0,0,0
2010,1700,52,5,57,3,18,21,1,0,1,38,36,74
2010,1701,11,0,11,0,2,2,0,0,0,0,0,0
2010,1702,16,2,18,1,8,9,0,0,0,0,0,0
2010,1800,27,3,30,2,7,9,26,16,42,2,11,13
2010,1801,16,0,16,1,1,2,0,0,0,0,0,0
2010,1900,6665,1247,7912,2421,3864,6285,1236,353,1589,521,683,1204
2010,1901,74,10,84,6,38,44,0,0,0,0,0,0
2010,1902,63,2,65,3,22,25,0,0,0,3,2,5
2010,1905,56,3,59,4,24,28,0,0,0,0,0,0
2010,1906,66,6,72,0,22,22,0,0,0,5,1,6
2010,1907,29,3,32,1,11,12,0,0,0,0,1,1
2010,1909,49,4,53,6,13,19,0,0,0,0,0,0
2010,1910,118,9,127,11,42,53,0,0,0,1,0,1
2010,1912,138,11,149,14,63,77,0,0,0,6,4,10
2010,1913,32,3,35,2,15,17,0,0,0,5,1,6
2010,1916,54,1,55,5,21,26,0,0,0,3,1,4
2010,1918,92,7,99,21,22,43,0,0,0,3,1,4
2010,1920,104,14,118,11,36,47,0,0,0,0,0,0
2010,1922,120,7,127,10,28,38,0,0,0,5,2,7
2010,1923,59,4,63,4,13,17,0,0,0,5,3,8
2010,1924,81,8,89,6,18,24,0,0,0,4,3,7
2010,1925,227,27,254,21,74,95,0,0,0,10,8,18
2010,1926,44,5,49,10,28,38,0,0,0,2,3,5
2010,1928,89,7,96,2,24,26,0,0,0,6,5,11
2010,1929,32,2,34,10,5,15,0,0,0,0,8,8
2010,1931,65,4,69,18,26,44,0,0,0,5,1,6
2010,1933,163,25,188,11,60,71,0,0,0,4,7,11
2010,1934,26,0,26,1,8,9,0,0,0,0,0,0
2010,1938,36,4,40,4,14,18,0,0,0,1,0,1
2010,1941,801,82,883,76,214,290,5,1,6,46,27,73
2010,1942,7956,1870,9826,831,1728,2559,27,5,32,219,118,337
2010,1944,56,9,65,11,18,29,0,0,0,3,2,5
2010,1946,43,5,48,4,19,23,0,0,0,0,4,4
2010,1947,64,7,71,3,28,31,0,0,0,6,1,7
2010,1948,62,10,72,5,20,25,0,0,0,2,3,5
2010,1951,19,2,21,2,3,5,0,0,0,0,5,5
2010,1953,203,37,240,23,76,99,0,0,0,11,9,20
2010,1955,140,14,154,21,68,89,0,0,0,10,9,19
2010,1956,86,8,94,9,39,48,0,0,0,2,6,8
2010,1961,33,2,35,4,9,13,0,0,0,3,3,6
2010,1962,50,3,53,4,11,15,0,0,0,0,0,0
2010,1963,22,6,28,1,6,7,0,0,0,0,0,0
2010,1965,182,21,203,82,86,168,0,1,1,7,8,15
2010,1966,15,3,18,1,4,5,0,0,0,0,0,0
2010,1967,32,3,35,4,9,13,0,0,0,0,0,0
2010,1969,80,4,84,4,31,35,0,0,0,4,2,6
2010,1970,34,1,35,1,13,14,0,0,0,0,0,0
2010,1972,200,16,216,29,74,103,1,0,1,7,8,15
2010,1973,47,3,50,0,13,13,0,0,0,2,0,2
2010,1975,100,7,107,13,44,57,0,0,0,2,4,6
2010,1976,113,10,123,15,35,50,0,0,0,0,0,0
2010,1978,16,2,18,3,9,12,0,0,0,0,0,0
2010,1981,14,2,16,4,3,7,0,0,0,0,0,0
2010,1982,24,3,27,14,12,26,0,0,0,0,0,0
2010,1983,14,3,17,6,6,12,0,0,0,0,0,0
2010,1984,20,2,22,7,8,15,0,0,0,0,0,0
2010,1997,51,6,57,15,22,37,0,0,0,0,0,0
2010,2000,67,4,71,3,30,33,0,0,0,0,0,0
2010,2001,15,2,17,1,5,6,0,0,0,0,0,0
2010,2002,54,5,59,3,15,18,0,0,0,0,0,0
2010,2100,108,14,122,18,61,79,51,20,71,9,15,24
2010,2101,8,1,9,0,1,1,0,0,0,0,0,0
2010,2103,10,1,11,3,2,5,0,0,0,0,0,0
2010,2104,28,2,30,0,8,8,0,0,0,0,0,0
2010,2105,19,2,21,0,5,5,0,0,0,0,0,0
2010,2106,45,10,55,1,15,16,0,0,0,0,0,0
2010,2107,9,0,9,0,0,0,0,0,0,0,0,0
2010,2108,15,4,19,0,7,7,0,0,0,0,0,0
2010,2109,59,6,65,3,18,21,0,0,0,0,0,0
2010,2110,16,2,18,1,4,5,0,0,0,0,0,0
2010,2111,13,0,13,1,3,4,0,0,0,0,0,0
2010,2113,5,1,6,1,0,1,0,0,0,0,0,0
2010,2200,35,5,40,3,10,13,8,8,16,0,0,0
2010,2300,68,2,70,8,21,29,34,14,48,2,7,9
2010,2301,13,3,16,0,5,5,0,0,0,0,0,0
2010,2303,26,1,27,2,12,14,0,0,0,0,0,0
2010,2304,11,1,12,2,4,6,0,0,0,0,0,0
2010,2400,110,3,113,6,19,25,0,0,0,81,31,112
2010,2401,35,1,36,2,8,10,0,0,0,0,0,0
2010,2402,5,2,7,0,1,1,0,0,0,0,0,0
2010,2403,6,0,6,0,2,2,0,0,0,0,0,0
2010,2404,18,1,19,1,9,10,0,0,0,0,0,0
2010,2405,35,3,38,4,16,20,0,0,0,0,0,0
2010,2406,90,6,96,9,27,36,0,0,0,0,0,0
2010,2412,7,3,10,2,7,9,0,0,0,0,0,0
2010,2500,12,1,13,4,4,8,4,1,5,0,0,0
2010,2501,7,0,7,0,1,1,0,0,0,0,0,0
2010,2600,28,0,28,1,3,4,0,0,0,12,7,19
2010,2601,17,1,18,0,3,3,0,0,0,0,0,0
2010,2700,141,13,154,14,51,65,115,38,153,14,26,40
2010,2701,12,1,13,1,6,7,0,0,0,0,0,0
2010,2702,6,0,6,0,0,0,0,0,0,0,0,0
2010,2703,8,1,9,1,2,3,0,0,0,0,0,0
2010,2704,13,2,15,1,3,4,0,0,0,0,0,0
2010,2705,18,1,19,0,3,3,0,0,0,0,0,0
2010,2706,43,7,50,2,4,6,0,0,0,3,7,10
2010,2707,15,7,22,1,7,8,0,0,0,0,0,0
2010,2708,145,12,157,13,40,53,0,0,0,0,0,0
2010,2709,9,1,10,0,1,1,0,0,0,0,0,0
2010,2710,37,4,41,2,7,9,0,0,0,0,0,0
2010,2711,21,0,21,0,5,5,0,0,0,0,0,0
2010,2712,26,4,30,1,8,9,0,0,0,0,0,0
2010,2714,6,0,6,0,0,0,0,0,0,0,0,0
2010,2719,9,4,13,1,1,2,0,0,0,0,0,0
2010,2800,91,7,98,9,21,30,1,0,1,0,0,0
2010,2801,9,2,11,1,3,4,0,0,0,0,0,0
2010,2802,57,9,66,3,38,41,0,0,0,0,0,0
2010,2803,10,1,11,0,4,4,0,0,0,0,0,0
2010,2808,91,6,97,1,2,3,0,0,0,0,0,0
2010,2900,59,4,63,7,35,42,8,1,9,33,38,71
2010,2901,23,0,23,0,8,8,0,0,0,0,0,0
2010,2902,11,1,12,0,1,1,0,0,0,0,0,0
2010,2908,24,2,26,0,4,4,0,0,0,0,0,0
2010,3000,1083,147,1230,339,575,914,730,114,844,322,201,523
2010,3001,337,29,366,40,111,151,15,8,23,0,8,8
2010,3002,89,8,97,3,33,36,0,0,0,1,0,1
2010,3003,82,8,90,4,37,41,0,0,0,3,1,4
2010,3004,130,16,146,5,38,43,1,0,1,6,5,11
2010,3005,52,4,56,2,13,15,0,0,0,3,1,4
2010,3006,23,1,24,0,8,8,0,0,0,0,0,0
2010,3007,52,4,56,1,19,20,0,0,0,0,0,0
2010,3008,130,17,147,4,61,65,0,0,0,3,1,4
2010,3009,155,6,161,12,56,68,0,0,0,0,0,0
2010,3010,205,10,215,23,83,106,0,0,0,13,5,18
2010,3011,41,6,47,6,31,37,0,0,0,0,0,0
2010,3012,57,5,62,9,24,33,0,0,0,0,0,0
2010,3013,17,5,22,0,4,4,0,0,0,0,0,0
2010,3014,127,10,137,26,44,70,0,0,0,7,2,9
2010,3015,141,17,158,15,59,74,0,0,0,0,0,0
2010,3016,44,2,46,3,15,18,0,0,0,0,0,0
2010,3019,322,31,353,42,115,157,0,0,0,49,64,113
2010,3020,29,1,30,5,6,11,0,0,0,4,4,8
2010,3022,81,9,90,7,33,40,0,0,0,0,0,0
2010,3024,86,7,93,5,37,42,0,0,0,2,0,2
2010,3026,158,42,200,26,63,89,0,0,0,0,0,0
2010,3027,19,4,23,1,6,7,0,0,0,0,0,0
2010,3097,28,3,31,4,10,14,0,0,0,0,0,0
2010,3100,143,16,159,12,78,90,46,9,55,57,42,99
2010,3101,21,1,22,1,6,7,0,0,0,0,0,0
2010,3103,30,1,31,1,9,10,0,0,0,0,0,0
2010,3104,45,6,51,2,23,25,0,0,0,0,0,0
2010,3105,112,7,119,8,39,47,0,0,0,5,5,10
2010,3200,29,2,31,0,14,14,0,0,0,10,8,18
2010,3300,1528,158,1686,151,656,807,348,52,400,617,295,912
2010,3301,30,3,33,1,10,11,0,0,0,0,0,0
2010,3302,52,4,56,1,16,17,0,0,0,0,0,0
2010,3303,22,0,22,3,6,9,0,0,0,0,0,0
2010,3306,24,1,25,3,3,6,0,0,0,0,0,0
2010,3308,63,3,66,4,20,24,0,0,0,0,0,0
2010,3309,67,3,70,9,27,36,0,0,0,0,0,0
2010,3311,74,14,88,7,30,37,0,0,0,0,0,0
2010,3313,324,37,361,28,123,151,0,0,0,0,0,0
2010,3315,149,23,172,10,57,67,0,0,0,3,2,5
2010,3325,49,4,53,11,27,38,0,0,0,0,0,0
2010,3342,77,9,86,4,39,43,0,0,0,0,0,0
2010,3344,17,2,19,2,8,10,0,0,0,0,0,0
2010,3397,24,3,27,1,9,10,0,0,0,0,0,0
2010,3400,482,86,568,136,237,373,480,138,618,104,234,338
2010,3401,67,7,74,0,25,25,0,0,0,0,0,0
2010,3402,32,3,35,1,10,11,0,0,0,0,0,0
2010,3403,1,0,1,0,0,0,0,0,0,0,0,0
2010,3404,568,128,696,77,246,323,0,0,0,0,0,0
2010,3408,20,2,22,6,8,14,0,0,0,0,0,0
2010,3414,20,2,22,4,3,7,0,0,0,0,0,0
2010,3420,3,0,3,3,1,4,0,0,0,0,0,0
2010,3422,523,142,665,9,43,52,0,0,0,0,0,0
2010,3477,79,10,89,8,15,23,0,0,0,0,0,0
2010,3496,74,13,87,9,37,46,0,0,0,0,0,0
2010,3499,7050,610,7660,1477,1964,3441,0,0,0,0,0,0
2010,3500,28,3,31,0,7,7,16,11,27,1,2,3
2010,3501,21,4,25,0,8,8,0,0,0,0,0,0
2010,3600,1116,169,1285,652,236,888,397,85,482,202,453,655
2010,3601,37,2,39,0,13,13,0,0,0,0,0,0
2010,3602,94,8,102,3,45,48,0,0,0,0,0,0
2010,3603,56,2,58,3,20,23,0,0,0,0,0,0
2010,3604,167,17,184,14,77,91,0,0,0,0,0,0
2010,3605,42,8,50,1,21,22,0,0,0,0,0,0
2010,3607,214,10,224,15,90,105,0,0,0,0,0,0
2010,3608,64,13,77,13,27,40,0,0,0,0,0,0
2010,3609,95,15,110,7,36,43,0,0,0,0,0,0
2010,3610,291,28,319,36,129,165,0,0,0,0,0,0
2010,3611,75,5,80,4,37,41,0,0,0,0,0,0
2010,3614,13,3,16,3,5,8,0,0,0,0,0,0
2010,3623,23,1,24,36,20,56,0,0,0,0,0,0
2010,3639,8,1,9,5,2,7,0,0,0,0,0,0
2010,3650,11,4,15,34,22,56,0,0,0,0,0,0
2010,3657,33,7,40,1,11,12,0,0,0,0,0,0
2010,3700,1081,170,1251,275,499,774,755,195,950,286,414,700
2010,3701,98,12,110,9,38,47,0,0,0,0,0,0
2010,3702,204,26,230,8,62,70,0,0,0,6,6,12
2010,3703,37,6,43,2,16,18,0,0,0,0,0,0
2010,3705,112,8,120,16,48,64,0,0,0,0,0,0
2010,3706,146,14,160,9,45,54,0,0,0,0,0,0
2010,3708,60,7,67,4,26,30,0,0,0,0,0,0
2010,3709,77,8,85,7,28,35,0,0,0,0,0,0
2010,3710,186,22,208,15,69,84,0,0,0,0,0,0
2010,3711,1595,268,1863,230,423,653,0,0,0,0,0,0
2010,3714,22,4,26,6,14,20,0,0,0,0,0,0
2010,3715,117,18,135,5,17,22,0,0,0,0,0,0
2010,3732,15,0,15,6,12,18,0,0,0,0,0,0
2010,3797,28,4,32,19,15,34,0,0,0,0,0,0
2010,3800,263,58,321,70,85,155,476,99,575,8,6,14
2010,3801,1894,356,2250,166,213,379,0,0,0,0,0,0
2010,3803,22,3,25,10,11,21,0,0,0,0,0,0
2010,3816,13,1,14,0,0,0,0,0,0,0,0,0
2010,3897,36,7,43,58,17,75,0,0,0,0,0,0
2010,3900,239,27,266,18,96,114,24,2,26,171,122,293
2010,3901,10,0,10,0,3,3,0,0,0,0,0,0
2010,3902,66,6,72,3,36,39,0,0,0,0,0,0
2010,3903,55,4,59,6,21,27,0,0,0,0,0,0
2010,3904,20,3,23,2,8,10,0,0,0,0,0,0
2010,3905,310,32,342,53,137,190,0,0,0,0,0,0
2010,3906,77,8,85,9,33,42,0,0,0,0,0,0
2010,3915,15,4,19,1,4,5,0,0,0,0,0,0
2010,4000,141,6,147,12,49,61,0,0,0,99,51,150
2010,4001,22,3,25,1,5,6,0,0,0,0,0,0
2010,4002,17,1,18,2,8,10,0,0,0,0,0,0
2010,4003,13,3,16,0,6,6,0,0,0,0,0,0
2010,4004,30,2,32,1,11,12,0,0,0,0,0,0
2010,4005,20,3,23,0,11,11,0,0,0,0,0,0
2010,4006,46,11,57,3,23,26,0,0,0,0,0,0
2010,4007,16,2,18,4,15,19,0,0,0,0,0,0
2010,4008,22,4,26,1,8,9,0,0,0,0,0,0
2010,4016,77,34,111,0,12,12,0,0,0,0,0,0
2010,4019,4,0,4,0,1,1,0,0,0,0,0,0
2010,4100,210,27,237,43,80,123,75,8,83,94,66,160
2010,4101,15,2,17,1,4,5,0,0,0,0,0,0
2010,4102,28,3,31,4,8,12,0,0,0,0,0,0
2010,4103,9,4,13,0,3,3,0,0,0,0,0,0
2010,4104,31,5,36,4,12,16,0,0,0,0,0,0
2010,4105,16,1,17,0,7,7,0,0,0,0,0,0
2010,4106,97,11,108,13,31,44,0,0,0,0,0,0
2010,4107,12,0,12,1,2,3,0,0,0,0,0,0
2010,4108,22,3,25,1,8,9,0,0,0,0,0,0
2010,4109,41,7,48,8,17,25,0,0,0,0,0,0
2010,4110,16,2,18,1,3,4,0,0,0,0,0,0
2010,4111,33,3,36,1,11,12,0,0,0,0,0,0
2010,4113,76,14,90,2,24,26,0,0,0,0,0,0
2010,4114,39,5,44,0,14,14,0,0,0,0,0,0
2010,4115,25,5,30,0,7,7,0,0,0,0,0,0
2010,4116,94,12,106,5,31,36,0,0,0,0,0,0
2010,4117,64,8,72,7,21,28,0,0,0,0,0,0
2010,4119,8,1,9,0,0,0,0,0,0,0,0,0
2010,4120,30,5,35,4,11,15,0,0,0,0,0,0
2010,4127,35,2,37,1,9,10,0,0,0,0,0,0
2010,4200,252,17,269,23,92,115,130,37,167,27,27,54
2010,4201,11,0,11,0,2,2,0,0,0,0,0,0
2010,4202,47,3,50,1,15,16,0,0,0,4,0,4
2010,4203,115,16,131,20,38,58,0,0,0,0,0,0
2010,4204,99,6,105,3,41,44,0,0,0,0,0,0
2010,4211,3,1,4,0,1,1,0,0,0,0,0,0
2010,4297,27,3,30,8,8,16,0,0,0,0,0,0
2010,4300,432,63,495,49,104,153,35,7,42,0,0,0
2010,4302,37,3,40,3,19,22,0,0,0,0,0,0
2010,4304,51,7,58,5,19,24,0,0,0,2,2,4
2010,4305,27,3,30,4,13,17,0,0,0,0,0,0
2010,4307,37,5,42,6,13,19,0,0,0,0,0,0
2010,4308,76,8,84,4,18,22,0,0,0,0,0,0
2010,4310,34,2,36,3,14,17,0,0,0,0,0,0
2010,4311,86,8,94,11,32,43,0,0,0,0,0,0
2010,4312,69,17,86,20,37,57,0,0,0,0,0,0
2010,4313,1135,124,1259,81,284,365,0,0,0,0,0,0
2010,4314,124,13,137,16,56,72,0,0,0,4,6,10
2010,4316,195,18,213,18,55,73,0,0,0,0,0,0
2010,4317,25,3,28,23,15,38,0,0,0,0,0,0
2010,4320,4,0,4,5,1,6,0,0,0,0,0,0
2010,4321,8,0,8,2,2,4,0,0,0,0,0,0
2010,4327,9,0,9,5,3,8,0,0,0,0,0,0
2010,4400,105,18,123,3,38,41,5,3,8,92,49,141
2010,4401,19,2,21,5,3,8,0,0,0,0,0,0
2010,4402,80,8,88,5,16,21,0,0,0,0,0,0
2010,4403,63,3,66,4,15,19,0,0,0,0,0,0
2010,4404,18,0,18,2,5,7,0,0,0,0,0,0
2010,4497,15,4,19,10,15,25,0,0,0,0,0,0
2010,4500,77,10,87,6,37,43,41,13,54,11,15,26
2010,4501,14,2,16,0,10,10,0,0,0,0,0,0
2010,4502,99,6,105,7,26,33,0,0,0,0,0,0
2010,4591,15,8,23,1,3,4,0,0,0,0,0,0
2010,4600,10,0,10,0,0,0,0,0,0,3,2,5
2010,4700,51,0,51,7,10,17,19,6,25,3,3,6
2010,4703,1,0,1,0,1,1,0,0,0,0,0,0
2010,4706,8,0,8,0,3,3,0,0,0,0,0,0
2010,4707,3,1,4,0,0,0,0,0,0,0,0,0
2010,4708,10,0,10,2,3,5,0,0,0,0,0,0
2010,4709,14,0,14,2,4,6,0,0,0,0,0,0
2010,4710,4,0,4,0,1,1,0,0,0,0,0,0
2010,4800,100,6,106,16,56,72,1,0,1,159,56,215
2010,4801,35,1,36,1,14,15,0,0,0,0,0,0
2010,4802,21,3,24,0,4,4,0,0,0,0,0,0
2010,4803,109,5,114,14,54,68,0,0,0,0,0,0
2010,4804,8,2,10,0,1,1,0,0,0,0,0,0
2010,4805,24,1,25,0,12,12,0,0,0,0,0,0
2010,4806,91,10,101,5,53,58,0,0,0,0,0,0
2010,4807,84,5,89,6,21,27,0,0,0,0,0,0
2010,4813,3,1,4,0,2,2,0,0,0,0,0,0
2010,4900,216,17,233,26,81,107,189,47,236,33,46,79
2010,4901,13,2,15,1,7,8,0,0,0,0,0,0
2010,4902,8,1,9,0,6,6,0,0,0,0,0,0
2010,4903,12,4,16,1,7,8,0,0,0,0,0,0
2010,4904,57,3,60,1,18,19,0,0,0,0,0,0
2010,4905,151,17,168,12,64,76,0,0,0,0,0,0
2010,4906,13,1,14,1,5,6,0,0,0,0,0,0
2010,4908,62,5,67,3,23,26,0,0,0,0,0,0
2010,4909,8,3,11,3,6,9,0,0,0,0,0,0
2010,4914,13,0,13,8,7,15,0,0,0,0,0,0
2010,5000,188,9,197,16,81,97,169,36,205,6,52,58
2010,5001,46,3,49,3,14,17,0,0,0,0,0,0
2010,5002,221,15,236,11,72,83,0,0,0,0,0,0
2010,5003,12,0,12,0,3,3,0,0,0,0,0,0
2010,5004,20,1,21,1,8,9,0,0,0,0,0,0
2010,5007,72,9,81,5,36,41,0,0,0,0,0,0
2010,5010,8,3,11,3,10,13,0,0,0,0,0,0
2010,5100,50,5,55,3,22,25,35,18,53,0,4,4
2010,5102,56,8,64,4,21,25,0,0,0,0,0,0
2010,5200,46,3,49,5,20,25,22,9,31,2,5,7
2010,5201,14,1,15,2,8,10,0,0,0,0,0,0
2010,5202,20,2,22,2,8,10,0,0,0,0,0,0
2010,5300,14,1,15,0,4,4,0,0,0,7,5,12
2010,5400,230,31,261,17,74,91,174,46,220,40,50,90
2010,5401,31,4,35,3,7,10,0,0,0,0,0,0
2010,5402,13,4,17,0,1,1,0,0,0,0,0,0
2010,5403,14,0,14,1,1,2,0,0,0,0,0,0
2010,5404,17,1,18,5,3,8,0,0,0,0,0,0
2010,5405,52,6,58,6,19,25,0,0,0,0,0,0
2010,5406,61,12,73,5,23,28,0,0,0,0,0,0
2010,5407,117,18,135,11,47,58,0,0,0,0,0,0
2010,5408,13,0,13,0,2,2,0,0,0,0,0,0
2010,5411,3,2,5,0,1,1,0,0,0,0,0,0
2010,5500,63,2,65,2,19,21,0,0,0,25,17,42
2010,5501,11,1,12,0,5,5,0,0,0,0,0,0
2010,5600,398,45,443,77,187,264,262,34,296,99,103,202
2010,5604,213,23,236,38,95,133,0,0,0,4,4,8
2010,5605,20,4,24,2,6,8,0,0,0,0,0,0
2010,5606,29,1,30,5,5,10,0,0,0,0,0,0
2010,5608,113,9,122,6,33,39,0,0,0,0,0,0
2010,5609,106,9,115,16,42,58,0,0,0,0,0,0
2010,5622,12,1,13,4,6,10,0,0,0,0,0,0
2010,5680,15,1,16,0,1,1,0,0,0,0,0,0
2010,5700,72,9,81,6,28,34,2,0,2,71,48,119
2010,5701,53,5,58,7,25,32,0,0,0,0,0,0
2010,5702,9,0,9,0,2,2,0,0,0,0,0,0
2010,5703,54,10,64,1,17,18,0,0,0,0,0,0
2010,5704,61,6,67,6,23,29,0,0,0,0,0,0
2010,5797,38,8,46,11,21,32,0,0,0,0,0,0
2010,5800,63,3,66,2,24,26,46,18,64,7,5,12
2010,5801,18,2,20,3,7,10,0,0,0,0,0,0
2010,5802,4,3,7,0,0,0,0,0,0,0,0,0
2010,10M1,187,36,223,4,9,13,0,0,0,0,0,0
2010,190C,24,1,25,3,4,7,0,0,0,0,0,0
2010,190R,8,1,9,5,3,8,0,0,0,0,0,0
2010,340H,113,10,123,19,55,74,0,0,0,0,0,0
2011,100,446,49,495,182,209,391,390,65,455,96,162,258
2011,101,76,8,84,3,35,38,0,0,0,5,3,8
2011,102,24,1,25,2,7,9,0,0,0,0,0,0
2011,103,131,33,164,18,63,81,0,1,1,8,7,15
2011,104,34,1,35,3,13,16,0,0,0,0,0,0
2011,105,147,18,165,12,72,84,1,0,1,7,8,15
2011,106,164,22,186,14,70,84,0,0,0,17,7,24
2011,107,76,7,83,8,39,47,0,0,0,0,0,0
2011,108,47,7,54,4,16,20,0,0,0,0,0,0
2011,109,575,72,647,49,217,266,0,0,0,0,0,0
2011,110,17,2,19,2,6,8,0,0,0,0,0,0
2011,111,73,7,80,3,28,31,0,0,0,0,0,0
2011,112,84,7,91,4,25,29,0,0,0,4,2,6
2011,113,67,9,76,4,22,26,0,0,0,0,0,0
2011,114,50,5,55,7,20,27,0,0,0,0,0,0
2011,115,11,2,13,3,7,10,0,0,0,0,0,0
2011,197,48,16,64,21,21,42,0,0,0,0,0,0
2011,200,15,0,15,0,3,3,0,0,0,0,0,0
2011,300,47,1,48,2,16,18,1,0,1,15,13,28
2011,302,5,1,6,0,1,1,0,0,0,0,0,0
2011,303,8,1,9,0,1,1,0,0,0,0,0,0
2011,305,5,0,5,0,0,0,0,0,0,0,0,0
2011,400,104,3,107,7,41,48,1,0,1,93,33,126
2011,402,88,7,95,14,40,54,0,0,0,0,0,0
2011,403,15,1,16,0,6,6,0,0,0,0,0,0
2011,404,19,3,22,3,12,15,0,0,0,0,0,0
2011,405,22,2,24,3,9,12,0,0,0,0,0,0
2011,497,14,2,16,1,11,12,0,0,0,0,0,0
2011,500,44,5,49,5,18,23,2,0,2,10,8,18
2011,501,6,0,6,0,1,1,0,0,0,0,0,0
2011,600,31,1,32,1,17,18,2,0,2,6,7,13
2011,601,6,2,8,0,1,1,0,0,0,0,0,0
2011,602,11,0,11,0,3,3,0,0,0,0,0,0
2011,700,274,41,315,38,152,190,260,43,303,56,56,112
2011,701,83,9,92,1,27,28,4,0,4,0,0,0
2011,702,55,5,60,4,13,17,0,0,0,0,0,0
2011,703,10,1,11,0,2,2,0,0,0,0,0,0
2011,704,128,21,149,7,36,43,0,0,0,2,2,4
2011,705,40,3,43,1,8,9,0,0,0,0,0,0
2011,706,22,1,23,0,3,3,0,0,0,0,0,0
2011,707,25,2,27,1,11,12,0,0,0,0,0,0
2011,708,64,7,71,1,21,22,0,0,0,0,0,0
2011,709,39,5,44,4,13,17,0,0,0,0,0,0
2011,710,170,21,191,28,61,89,0,0,0,1,4,5
2011,711,49,3,52,4,13,17,0,0,0,1,1,2
2011,712,61,15,76,5,26,31,0,0,0,0,0,0
2011,713,10,0,10,0,0,0,0,0,0,0,0,0
2011,714,34,2,36,2,11,13,0,0,0,0,0,0
2011,716,9,1,10,0,1,1,0,0,0,0,0,0
2011,718,171,21,192,41,33,74,0,0,0,0,0,0
2011,721,19,3,22,5,5,10,0,0,0,0,0,0
2011,724,51,3,54,5,12,17,0,0,0,0,0,0
2011,800,25,1,26,4,4,8,1,0,1,12,8,20
2011,801,11,1,12,0,1,1,0,0,0,0,0,0
2011,900,142,7,149,18,57,75,10,0,10,60,39,99
2011,901,16,1,17,1,8,9,0,0,0,0,0,0
2011,902,34,5,39,5,12,17,0,0,0,0,0,0
2011,1000,350,41,391,59,124,183,262,81,343,6,19,25
2011,1001,87,12,99,8,38,46,0,0,0,0,1,1
2011,1002,16,3,19,4,7,11,0,0,0,0,0,0
2011,1003,9,2,11,0,4,4,0,0,0,0,0,0
2011,1004,10,0,10,1,1,2,0,0,0,0,0,0
2011,1005,658,93,751,45,156,201,0,0,0,0,0,0
2011,1006,7,1,8,1,3,4,0,0,0,0,0,0
2011,1007,15,3,18,2,1,3,0,0,0,0,0,0
2011,1008,13,1,14,0,6,6,0,0,0,0,0,0
2011,1009,9,1,10,0,2,2,0,0,0,0,0,0
2011,1011,15,1,16,0,3,3,0,0,0,1,0,1
2011,1012,28,3,31,1,14,15,0,0,0,0,0,0
2011,1013,31,2,33,2,1,3,0,0,0,0,0,0
2011,1015,27,4,31,1,7,8,0,0,0,0,0,0
2011,1017,14,1,15,0,3,3,0,0,0,0,0,0
2011,1097,17,3,20,1,8,9,0,0,0,0,0,0
2011,1100,14,2,16,5,9,14,2,0,2,9,11,20
2011,1101,10,0,10,0,2,2,0,0,0,0,0,0
2011,1102,7,2,9,0,1,1,0,0,0,0,0,0
2011,1200,70,8,78,5,32,37,65,23,88,5,4,9
2011,1201,24,3,27,1,9,10,0,0,0,0,0,0
2011,1203,44,3,47,2,28,30,0,0,0,0,0,0
2011,1204,4,0,4,0,0,0,0,0,0,0,0,0
2011,1205,17,0,17,1,8,9,0,0,0,0,0,0
2011,1207,5,0,5,0,0,0,0,0,0,0,0,0
2011,1208,6,5,11,1,6,7,0,0,0,0,0,0
2011,1300,94,3,97,9,52,61,62,18,80,10,17,27
2011,1301,34,2,36,3,10,13,0,0,0,0,0,0
2011,1302,37,1,38,6,13,19,0,0,0,0,0,0
2011,1303,3,1,4,0,0,0,0,0,0,0,0,0
2011,1304,44,1,45,5,18,23,0,0,0,0,0,0
2011,1306,16,0,16,1,1,2,0,0,0,0,0,0
2011,1307,5,0,5,0,0,0,0,0,0,0,0,0
2011,1400,23,1,24,3,12,15,10,0,10,1,3,4
2011,1401,12,0,12,1,4,5,0,0,0,0,0,0
2011,1500,338,22,360,31,176,207,374,104,478,20,53,73
2011,1501,16,2,18,3,6,9,0,0,0,0,0,0
2011,1502,327,20,347,38,101,139,0,0,0,0,0,0
2011,1503,43,2,45,15,8,23,0,0,0,5,0,5
2011,1505,9,2,11,0,8,8,0,0,0,0,0,0
2011,1506,30,2,32,3,12,15,0,0,0,0,0,0
2011,1507,18,3,21,2,7,9,0,0,0,0,0,0
2011,1508,14,2,16,0,11,11,0,0,0,0,0,0
2011,1509,12,2,14,0,2,2,0,0,0,0,0,0
2011,1511,14,0,14,2,5,7,0,0,0,0,0,0
2011,1514,3,0,3,0,0,0,0,0,0,0,0,0
2011,1515,7,1,8,2,11,13,0,0,0,0,0,0
2011,1597,9,2,11,1,3,4,0,0,0,0,0,0
2011,1600,62,7,69,4,38,42,0,0,0,50,45,95
2011,1601,16,3,19,4,8,12,0,0,0,0,0,0
2011,1602,48,4,52,2,22,24,0,0,0,0,0,0
2011,1603,26,3,29,2,5,7,0,0,0,0,0,0
2011,1607,13,2,15,0,2,2,0,0,0,0,0,0
2011,1700,46,5,51,2,19,21,0,0,0,36,31,67
2011,1701,9,0,9,0,2,2,0,0,0,0,0,0
2011,1702,19,1,20,1,7,8,0,0,0,0,0,0
2011,1800,21,1,22,2,6,8,14,9,23,3,6,9
2011,1801,16,0,16,0,1,1,0,0,0,0,0,0
2011,1900,6478,1206,7684,2473,3903,6376,1170,343,1513,514,681,1195
2011,1901,74,10,84,6,38,44,0,0,0,0,0,0
2011,1902,61,2,63,4,22,26,0,0,0,2,2,4
2011,1905,58,4,62,2,23,25,0,0,0,0,0,0
2011,1906,64,6,70,0,22,22,0,0,0,4,2,6
2011,1907,25,3,28,1,10,11,0,0,0,0,1,1
2011,1909,47,4,51,7,15,22,0,0,0,0,0,0
2011,1910,103,9,112,11,38,49,0,0,0,1,0,1
2011,1912,141,15,156,13,61,74,0,0,0,5,4,9
2011,1913,32,3,35,2,15,17,0,0,0,5,1,6
2011,1916,54,1,55,3,21,24,0,0,0,3,1,4
2011,1918,99,6,105,16,23,39,0,0,0,3,1,4
2011,1920,99,15,114,14,36,50,0,0,0,0,0,0
2011,1922,114,7,121,11,29,40,0,0,0,5,2,7
2011,1923,58,3,61,7,11,18,0,0,0,5,2,7
2011,1924,85,8,93,4,14,18,0,0,0,4,3,7
2011,1925,212,25,237,22,75,97,0,0,0,10,9,19
2011,1926,46,5,51,10,27,37,0,0,0,2,3,5
2011,1928,86,7,93,2,24,26,1,0,1,6,5,11
2011,1929,32,2,34,11,5,16,0,0,0,0,8,8
2011,1931,62,4,66,15,23,38,0,0,0,5,1,6
2011,1933,160,23,183,11,60,71,0,0,0,3,7,10
2011,1934,26,0,26,1,8,9,0,0,0,0,0,0
2011,1938,36,4,40,4,14,18,0,0,0,1,0,1
2011,1941,762,79,841,69,209,278,6,0,6,44,24,68
2011,1942,7890,1870,9760,822,1716,2538,79,21,100,213,113,326
2011,1944,47,13,60,10,19,29,0,0,0,3,2,5
2011,1946,41,5,46,4,19,23,0,0,0,1,3,4
2011,1947,61,8,69,3,26,29,0,0,0,6,1,7
2011,1948,59,9,68,5,17,22,0,0,0,2,3,5
2011,1951,22,3,25,2,3,5,0,0,0,0,6,6
2011,1953,196,35,231,21,68,89,0,0,0,11,8,19
2011,1955,134,14,148,18,65,83,0,0,0,10,8,18
2011,1956,81,8,89,8,42,50,0,0,0,2,6,8
2011,1961,30,2,32,3,9,12,0,0,0,3,3,6
2011,1962,51,3,54,4,10,14,0,0,0,0,0,0
2011,1963,20,7,27,1,5,6,0,0,0,0,0,0
2011,1965,183,20,203,89,80,169,0,1,1,7,8,15
2011,1966,13,3,16,0,5,5,0,0,0,0,0,0
2011,1967,33,3,36,2,3,5,0,0,0,2,6,8
2011,1969,75,5,80,3,28,31,0,0,0,4,2,6
2011,1970,32,1,33,1,11,12,0,0,0,0,0,0
2011,1972,198,16,214,33,74,107,1,0,1,7,7,14
2011,1973,46,3,49,0,11,11,0,0,0,0,0,0
2011,1975,91,6,97,3,33,36,0,0,0,2,3,5
2011,1976,107,9,116,16,34,50,0,0,0,0,0,0
2011,1978,16,2,18,4,10,14,0,0,0,0,0,0
2011,1981,15,1,16,4,3,7,0,0,0,0,0,0
2011,1982,21,2,23,12,10,22,0,0,0,0,0,0
2011,1983,15,3,18,7,6,13,0,0,0,0,0,0
2011,1984,19,3,22,8,7,15,0,0,0,0,0,0
2011,1997,51,7,58,14,23,37,0,0,0,0,0,0
2011,2000,65,4,69,3,27,30,0,0,0,0,0,0
2011,2001,13,1,14,1,4,5,0,0,0,0,0,0
2011,2002,54,5,59,2,23,25,0,0,0,0,0,0
2011,2100,104,14,118,16,58,74,45,20,65,9,16,25
2011,2101,6,2,8,0,1,1,0,0,0,0,0,0
2011,2103,9,2,11,3,2,5,0,0,0,0,0,0
2011,2104,28,3,31,0,6,6,0,0,0,0,0,0
2011,2105,18,2,20,0,4,4,0,0,0,0,0,0
2011,2106,44,10,54,1,14,15,0,0,0,0,0,0
2011,2107,9,0,9,0,0,0,0,0,0,0,0,0
2011,2108,16,3,19,0,7,7,0,0,0,0,0,0
2011,2109,55,6,61,3,17,20,0,0,0,0,0,0
2011,2110,16,2,18,1,4,5,0,0,0,0,0,0
2011,2111,13,0,13,0,3,3,0,0,0,0,0,0
2011,2113,7,1,8,1,0,1,0,0,0,0,0,0
2011,2200,35,4,39,3,11,14,9,7,16,0,0,0
2011,2300,62,1,63,8,15,23,35,13,48,1,3,4
2011,2301,12,3,15,0,4,4,0,0,0,0,0,0
2011,2303,25,1,26,2,12,14,0,0,0,0,0,0
2011,2304,11,1,12,2,4,6,0,0,0,0,0,0
2011,2400,113,3,116,5,23,28,0,0,0,67,26,93
2011,2401,30,1,31,1,9,10,0,0,0,0,0,0
2011,2402,5,2,7,0,0,0,0,0,0,0,0,0
2011,2403,8,0,8,0,2,2,0,0,0,0,0,0
2011,2404,17,0,17,1,9,10,0,0,0,0,0,0
2011,2405,35,3,38,4,15,19,0,0,0,0,0,0
2011,2406,81,4,85,8,24,32,0,0,0,0,0,0
2011,2412,7,4,11,1,8,9,0,0,0,0,0,0
2011,2500,10,1,11,2,5,7,4,1,5,0,0,0
2011,2501,5,0,5,0,1,1,0,0,0,0,0,0
2011,2600,28,0,28,0,2,2,0,0,0,12,7,19
2011,2601,17,1,18,0,3,3,0,0,0,0,0,0
2011,2700,133,12,145,7,55,62,102,36,138,14,22,36
2011,2701,11,1,12,1,6,7,0,0,0,0,0,0
2011,2702,6,0,6,0,0,0,0,0,0,0,0,0
2011,2703,9,2,11,1,2,3,0,0,0,0,0,0
2011,2704,15,1,16,1,3,4,0,0,0,0,0,0
2011,2705,16,1,17,0,3,3,0,0,0,0,0,0
2011,2706,38,6,44,1,4,5,0,0,0,3,7,10
2011,2707,13,7,20,2,7,9,0,0,0,0,0,0
2011,2708,138,8,146,11,38,49,0,0,0,0,0,0
2011,2709,8,1,9,0,1,1,0,0,0,0,0,0
2011,2710,34,5,39,2,7,9,0,0,0,0,0,0
2011,2711,16,0,16,0,3,3,0,0,0,0,0,0
2011,2712,25,4,29,1,8,9,0,0,0,0,0,0
2011,2714,6,0,6,0,0,0,0,0,0,0,0,0
2011,2719,10,3,13,1,5,6,0,0,0,0,0,0
2011,2800,96,6,102,8,19,27,1,0,1,0,0,0
2011,2801,8,2,10,1,3,4,0,0,0,0,0,0
2011,2802,61,9,70,3,36,39,0,0,0,0,0,0
2011,2803,11,0,11,0,4,4,0,0,0,0,0,0
2011,2808,94,7,101,2,7,9,0,0,0,0,0,0
2011,2900,51,5,56,7,32,39,10,0,10,34,34,68
2011,2901,21,1,22,0,7,7,0,0,0,0,0,0
2011,2902,11,1,12,0,1,1,0,0,0,0,0,0
2011,2908,24,2,26,0,4,4,0,0,0,0,0,0
2011,3000,1108,148,1256,470,680,1150,599,93,692,268,93,361
2011,3001,324,29,353,39,105,144,13,8,21,0,9,9
2011,3002,86,8,94,3,33,36,0,0,0,1,0,1
2011,3003,75,8,83,4,36,40,0,0,0,3,2,5
2011,3004,118,15,133,14,51,65,1,0,1,6,4,10
2011,3005,48,5,53,3,7,10,0,0,0,2,1,3
2011,3006,23,1,24,0,8,8,0,0,0,0,0,0
2011,3007,53,3,56,1,19,20,0,0,0,0,0,0
2011,3008,127,15,142,6,58,64,0,0,0,4,1,5
2011,3009,151,5,156,15,50,65,0,0,0,0,0,0
2011,3010,195,9,204,18,82,100,0,0,0,13,5,18
2011,3011,42,5,47,7,31,38,0,0,0,0,0,0
2011,3012,64,4,68,7,30,37,0,0,0,0,0,0
2011,3013,17,5,22,0,4,4,0,0,0,0,0,0
2011,3014,121,10,131,15,47,62,0,0,0,7,2,9
2011,3015,141,17,158,16,52,68,0,0,0,0,0,0
2011,3016,42,2,44,4,14,18,0,0,0,0,0,0
2011,3019,306,30,336,40,112,152,0,0,0,48,65,113
2011,3020,29,2,31,6,6,12,0,0,0,3,3,6
2011,3022,84,8,92,8,40,48,0,0,0,0,0,0
2011,3024,85,7,92,4,35,39,0,0,0,2,0,2
2011,3026,156,42,198,20,60,80,0,0,0,0,0,0
2011,3027,18,5,23,4,7,11,0,0,0,0,0,0
2011,3097,29,3,32,4,10,14,0,0,0,0,0,0
2011,3100,168,20,188,17,74,91,25,3,28,57,41,98
2011,3101,21,0,21,1,6,7,0,0,0,0,0,0
2011,3103,21,1,22,2,7,9,0,0,0,0,0,0
2011,3104,43,6,49,2,23,25,0,0,0,0,0,0
2011,3105,111,7,118,11,45,56,0,0,0,4,2,6
2011,3200,29,2,31,0,13,13,0,0,0,9,8,17
2011,3300,1476,144,1620,138,657,795,345,56,401,614,299,913
2011,3301,28,3,31,1,10,11,0,0,0,0,0,0
2011,3302,51,5,56,1,18,19,0,0,0,0,0,0
2011,3303,22,0,22,3,6,9,0,0,0,0,0,0
2011,3306,28,3,31,3,2,5,0,0,0,0,0,0
2011,3308,57,3,60,4,18,22,0,0,0,0,0,0
2011,3309,62,3,65,11,27,38,0,0,0,0,0,0
2011,3311,71,14,85,7,31,38,0,0,0,0,0,0
2011,3313,328,39,367,26,118,144,0,0,0,0,0,0
2011,3315,140,19,159,10,53,63,0,0,0,2,3,5
2011,3325,49,4,53,11,26,37,0,0,0,0,0,0
2011,3342,78,8,86,3,38,41,0,0,0,0,0,0
2011,3344,16,2,18,2,5,7,0,0,0,0,0,0
2011,3397,23,3,26,1,9,10,0,0,0,0,0,0
2011,3400,516,99,615,135,244,379,449,129,578,96,211,307
2011,3401,70,7,77,1,26,27,0,0,0,0,0,0
2011,3402,31,3,34,1,10,11,0,0,0,0,0,0
2011,3403,2,0,2,0,1,1,0,0,0,0,0,0
2011,3404,553,125,678,80,189,269,0,0,0,0,0,0
2011,3408,19,2,21,6,10,16,0,0,0,0,0,0
2011,3414,21,2,23,3,3,6,0,0,0,0,0,0
2011,3420,2,0,2,3,1,4,0,0,0,0,0,0
2011,3422,438,119,557,10,33,43,0,0,0,0,0,0
2011,3477,71,10,81,8,15,23,0,0,0,0,0,0
2011,3496,73,12,85,8,37,45,0,0,0,0,0,0
2011,3499,6854,563,7417,1237,1801,3038,0,0,0,0,0,0
2011,3500,25,2,27,0,5,5,0,0,0,15,11,26
2011,3501,20,4,24,0,8,8,0,0,0,0,0,0
2011,3600,1045,169,1214,169,443,612,416,76,492,147,564,711
2011,3601,36,1,37,0,13,13,0,0,0,0,0,0
2011,3602,94,8,102,5,46,51,0,0,0,0,0,0
2011,3603,46,1,47,3,19,22,0,0,0,0,0,0
2011,3604,164,17,181,11,76,87,0,0,0,0,0,0
2011,3605,42,7,49,1,21,22,0,0,0,0,0,0
2011,3607,214,10,224,12,84,96,0,0,0,0,0,0
2011,3608,62,14,76,10,25,35,0,0,0,0,0,0
2011,3609,85,13,98,4,32,36,0,0,0,0,0,0
2011,3610,269,27,296,39,130,169,0,0,0,0,0,0
2011,3611,71,4,75,5,23,28,0,0,0,0,0,0
2011,3614,13,3,16,2,6,8,0,0,0,0,0,0
2011,3623,23,1,24,35,17,52,0,0,0,0,0,0
2011,3639,8,1,9,5,3,8,0,0,0,0,0,0
2011,3650,12,3,15,23,19,42,0,0,0,0,0,0
2011,3657,32,7,39,1,11,12,0,0,0,0,0,0
2011,3700,1089,162,1251,306,498,804,753,192,945,286,406,692
2011,3701,94,13,107,7,39,46,0,0,0,0,0,0
2011,3702,197,21,218,20,58,78,1,0,1,6,6,12
2011,3703,36,7,43,1,18,19,0,0,0,0,0,0
2011,3705,110,8,118,15,50,65,0,0,0,0,0,0
2011,3706,143,14,157,8,43,51,0,0,0,0,0,0
2011,3708,59,7,66,2,27,29,0,0,0,0,0,0
2011,3709,74,6,80,4,24,28,0,0,0,0,0,0
2011,3710,183,20,203,14,67,81,0,0,0,0,0,0
2011,3711,1569,265,1834,221,400,621,0,0,0,0,0,0
2011,3714,18,4,22,6,15,21,0,0,0,0,0,0
2011,3715,110,17,127,5,17,22,0,0,0,0,0,0
2011,3732,17,0,17,10,12,22,0,0,0,0,0,0
2011,3797,26,4,30,19,16,35,0,0,0,0,0,0
2011,3800,248,58,306,69,76,145,474,93,567,12,13,25
2011,3801,1869,341,2210,190,250,440,0,0,0,0,0,0
2011,3803,23,3,26,11,10,21,0,0,0,0,0,0
2011,3816,12,2,14,0,0,0,0,0,0,0,0,0
2011,3897,37,9,46,49,17,66,0,0,0,0,0,0
2011,3900,233,25,258,19,89,108,25,1,26,178,121,299
2011,3901,11,0,11,0,1,1,0,0,0,0,0,0
2011,3902,64,5,69,0,15,15,0,0,0,3,17,20
2011,3903,55,4,59,5,19,24,0,0,0,0,0,0
2011,3904,20,2,22,1,8,9,0,0,0,0,0,0
2011,3905,291,30,321,53,120,173,0,0,0,0,0,0
2011,3906,77,6,83,9,32,41,0,0,0,0,0,0
2011,3915,13,4,17,1,5,6,0,0,0,0,0,0
2011,4000,144,6,150,12,49,61,0,0,0,98,50,148
2011,4001,21,3,24,2,6,8,0,0,0,0,0,0
2011,4002,16,1,17,2,8,10,0,0,0,0,0,0
2011,4003,15,3,18,0,5,5,0,0,0,0,0,0
2011,4004,25,2,27,1,11,12,0,0,0,0,0,0
2011,4005,19,3,22,0,11,11,0,0,0,0,0,0
2011,4006,46,11,57,3,23,26,0,0,0,0,0,0
2011,4007,16,2,18,4,15,19,0,0,0,0,0,0
2011,4008,23,4,27,1,9,10,0,0,0,0,0,0
2011,4016,77,33,110,0,12,12,0,0,0,0,0,0
2011,4019,6,0,6,0,1,1,0,0,0,0,0,0
2011,4100,211,24,235,49,80,129,78,9,87,87,63,150
2011,4101,16,2,18,1,5,6,0,0,0,0,0,0
2011,4102,28,3,31,4,7,11,0,0,0,0,0,0
2011,4103,8,3,11,0,3,3,0,0,0,0,0,0
2011,4104,29,4,33,4,12,16,0,0,0,0,0,0
2011,4105,16,1,17,0,6,6,0,0,0,0,0,0
2011,4106,98,11,109,12,28,40,0,0,0,0,0,0
2011,4108,20,2,22,1,6,7,0,0,0,0,0,0
2011,4109,39,8,47,8,15,23,0,0,0,0,0,0
2011,4110,16,2,18,1,3,4,0,0,0,0,0,0
2011,4111,32,3,35,1,3,4,0,0,0,0,0,0
2011,4113,74,13,87,3,24,27,0,0,0,0,0,0
2011,4114,37,5,42,0,15,15,0,0,0,0,0,0
2011,4116,90,12,102,6,28,34,0,0,0,0,0,0
2011,4117,71,8,79,7,22,29,0,0,0,0,0,0
2011,4119,8,1,9,0,0,0,0,0,0,0,0,0
2011,4120,31,5,36,3,10,13,0,0,0,0,0,0
2011,4127,33,2,35,1,7,8,0,0,0,0,0,0
2011,4200,244,17,261,27,87,114,134,35,169,24,32,56
2011,4201,11,1,12,0,2,2,0,0,0,0,0,0
2011,4202,45,3,48,2,16,18,0,0,0,4,0,4
2011,4203,118,16,134,25,45,70,0,0,0,0,0,0
2011,4204,97,5,102,4,41,45,0,0,0,0,0,0
2011,4211,3,1,4,0,1,1,0,0,0,0,0,0
2011,4297,25,4,29,8,7,15,0,0,0,0,0,0
2011,4300,427,57,484,58,110,168,553,152,705,75,131,206
2011,4302,37,3,40,3,19,22,0,0,0,0,0,0
2011,4304,51,7,58,4,19,23,0,0,0,2,2,4
2011,4305,26,4,30,4,13,17,0,0,0,0,0,0
2011,4307,35,5,40,6,13,19,0,0,0,0,0,0
2011,4308,73,9,82,4,19,23,0,0,0,0,0,0
2011,4310,32,2,34,2,14,16,0,0,0,0,0,0
2011,4311,84,9,93,8,36,44,0,0,0,0,0,0
2011,4312,68,15,83,18,40,58,0,0,0,0,0,0
2011,4313,1030,73,1103,80,273,353,0,0,0,0,0,0
2011,4314,118,13,131,14,47,61,0,0,0,3,2,5
2011,4316,186,17,203,17,54,71,0,0,0,0,0,0
2011,4317,24,2,26,25,15,40,0,0,0,0,0,0
2011,4320,4,0,4,5,1,6,0,0,0,0,0,0
2011,4321,9,0,9,4,2,6,0,0,0,0,0,0
2011,4327,9,0,9,5,3,8,0,0,0,0,0,0
2011,4400,109,20,129,5,30,35,8,1,9,94,46,140
2011,4401,19,1,20,4,4,8,0,0,0,0,0,0
2011,4402,80,7,87,5,16,21,0,0,0,0,0,0
2011,4403,62,3,65,4,13,17,0,0,0,0,0,0
2011,4404,19,0,19,2,6,8,0,0,0,0,0,0
2011,4497,14,3,17,9,12,21,0,0,0,0,0,0
2011,4500,72,10,82,7,37,44,37,12,49,13,17,30
2011,4501,14,2,16,0,10,10,0,0,0,0,0,0
2011,4502,92,6,98,8,24,32,0,0,0,0,0,0
2011,4591,14,7,21,1,3,4,0,0,0,0,0,0
2011,4600,11,0,11,0,0,0,0,0,0,2,3,5
2011,4700,48,1,49,8,10,18,22,6,28,3,2,5
2011,4703,1,0,1,0,0,0,0,0,0,0,0,0
2011,4706,8,0,8,0,3,3,0,0,0,0,0,0
2011,4707,2,1,3,0,0,0,0,0,0,0,0,0
2011,4708,10,0,10,2,3,5,0,0,0,0,0,0
2011,4709,14,0,14,2,4,6,0,0,0,0,0,0
2011,4710,4,0,4,0,1,1,0,0,0,0,0,0
2011,4800,100,6,106,20,68,88,1,0,1,163,57,220
2011,4801,33,1,34,1,16,17,0,0,0,0,0,0
2011,4802,20,3,23,0,5,5,0,0,0,0,0,0
2011,4803,108,6,114,15,47,62,0,0,0,0,0,0
2011,4804,7,2,9,0,1,1,0,0,0,0,0,0
2011,4805,22,2,24,0,11,11,0,0,0,0,0,0
2011,4806,80,10,90,4,52,56,0,0,0,0,0,0
2011,4807,85,6,91,6,20,26,0,0,0,0,0,0
2011,4813,2,1,3,0,2,2,0,0,0,0,0,0
2011,4900,202,17,219,21,68,89,179,46,225,31,46,77
2011,4901,12,2,14,1,7,8,0,0,0,0,0,0
2011,4902,10,0,10,0,5,5,0,0,0,0,0,0
2011,4903,12,4,16,1,8,9,0,0,0,0,0,0
2011,4904,52,3,55,1,17,18,0,0,0,0,0,0
2011,4905,150,14,164,14,57,71,0,0,0,0,0,0
2011,4906,13,1,14,1,5,6,0,0,0,0,0,0
2011,4908,57,5,62,2,19,21,0,0,0,0,0,0
2011,4909,8,3,11,3,6,9,0,0,0,0,0,0
2011,4914,14,0,14,2,11,13,0,0,0,0,0,0
2011,5000,168,7,175,13,62,75,173,37,210,5,44,49
2011,5001,47,4,51,3,13,16,0,0,0,0,0,0
2011,5002,202,15,217,9,71,80,0,0,0,0,0,0
2011,5003,11,0,11,0,3,3,0,0,0,0,0,0
2011,5004,20,1,21,2,8,10,0,0,0,0,0,0
2011,5007,68,9,77,4,37,41,0,0,0,0,0,0
2011,5010,7,4,11,3,6,9,0,0,0,0,0,0
2011,5100,45,3,48,3,21,24,37,14,51,0,4,4
2011,5102,54,8,62,4,21,25,0,0,0,0,0,0
2011,5200,33,3,36,8,20,28,28,8,36,2,4,6
2011,5201,13,0,13,3,6,9,0,0,0,0,0,0
2011,5202,21,1,22,1,8,9,0,0,0,0,0,0
2011,5300,18,1,19,0,4,4,0,0,0,7,4,11
2011,5400,229,32,261,17,70,87,175,48,223,38,44,82
2011,5401,31,4,35,3,7,10,0,0,0,0,0,0
2011,5402,12,3,15,0,1,1,0,0,0,0,0,0
2011,5403,14,0,14,1,1,2,0,0,0,0,0,0
2011,5404,16,1,17,1,3,4,0,0,0,0,0,0
2011,5405,52,7,59,8,19,27,0,0,0,0,0,0
2011,5406,62,8,70,5,22,27,0,0,0,0,0,0
2011,5407,118,17,135,11,51,62,0,0,0,0,0,0
2011,5408,12,0,12,0,1,1,0,0,0,0,0,0
2011,5411,2,2,4,0,1,1,0,0,0,0,0,0
2011,5500,62,2,64,2,20,22,0,0,0,25,17,42
2011,5501,9,1,10,0,5,5,0,0,0,0,0,0
2011,5600,396,45,441,76,188,264,249,37,286,103,100,203
2011,5604,213,22,235,38,100,138,0,0,0,5,4,9
2011,5605,20,4,24,2,6,8,0,0,0,0,0,0
2011,5606,27,1,28,5,5,10,0,0,0,0,0,0
2011,5608,113,9,122,6,33,39,0,0,0,0,0,0
2011,5609,101,8,109,13,39,52,0,0,0,0,0,0
2011,5622,12,1,13,4,7,11,0,0,0,0,0,0
2011,5680,12,1,13,0,1,1,0,0,0,0,0,0
2011,5700,69,10,79,10,26,36,2,0,2,74,51,125
2011,5701,52,7,59,6,25,31,0,0,0,0,0,0
2011,5702,10,0,10,0,2,2,0,0,0,0,0,0
2011,5703,53,9,62,1,15,16,0,0,0,0,0,0
2011,5704,56,6,62,6,21,27,0,0,0,0,0,0
2011,5797,39,8,47,6,17,23,0,0,0,0,0,0
2011,5800,63,2,65,1,23,24,48,20,68,6,5,11
2011,5801,18,2,20,3,8,11,0,0,0,0,0,0
2011,5802,4,3,7,0,0,0,0,0,0,0,0,0
2011,10M1,177,35,212,12,9,21,0,0,0,0,0,0
2011,190C,24,1,25,3,4,7,0,0,0,0,0,0
2011,190R,7,0,7,5,3,8,0,0,0,0,0,0
2011,340H,115,13,128,19,55,74,0,0,0,0,0,0
2012,100,443,52,495,193,198,391,380,77,457,102,154,256
2012,101,74,7,81,3,28,31,0,0,0,0,0,0
2012,102,24,1,25,2,5,7,0,0,0,0,0,0
2012,103,136,34,170,20,60,80,0,1,1,7,7,14
2012,104,33,1,34,3,12,15,0,0,0,0,0,0
2012,105,154,20,174,8,74,82,1,0,1,8,8,16
2012,106,158,21,179,14,66,80,0,0,0,14,9,23
2012,107,75,7,82,7,39,46,0,0,0,0,0,0
2012,108,44,7,51,4,16,20,0,0,0,0,0,0
2012,109,559,67,626,49,216,265,0,0,0,0,0,0
2012,110,16,3,19,2,6,8,0,0,0,0,0,0
2012,111,74,7,81,3,28,31,0,0,0,0,0,0
2012,112,83,7,90,4,26,30,0,0,0,4,2,6
2012,113,64,10,74,3,21,24,0,0,0,0,0,0
2012,114,51,5,56,5,19,24,0,0,0,0,0,0
2012,115,12,2,14,4,7,11,0,0,0,0,0,0
2012,197,49,18,67,24,24,48,0,0,0,0,0,0
2012,200,14,0,14,0,3,3,0,0,0,0,0,0
2012,300,39,1,40,2,14,16,1,0,1,15,13,28
2012,302,4,1,5,0,0,0,0,0,0,0,0,0
2012,303,8,1,9,0,1,1,0,0,0,0,0,0
2012,305,5,0,5,0,0,0,0,0,0,0,0,0
2012,400,103,2,105,7,43,50,1,0,1,90,51,141
2012,402,83,7,90,12,43,55,0,0,0,0,0,0
2012,403,15,1,16,0,6,6,0,0,0,0,0,0
2012,404,20,3,23,2,12,14,0,0,0,0,0,0
2012,405,19,2,21,3,7,10,0,0,0,0,0,0
2012,497,13,2,15,1,10,11,0,0,0,0,0,0
2012,500,42,5,47,4,19,23,2,1,3,9,9,18
2012,501,6,0,6,0,1,1,0,0,0,0,0,0
2012,600,25,3,28,4,17,21,2,0,2,5,7,12
2012,601,7,1,8,0,1,1,0,0,0,0,0,0
2012,602,11,0,11,0,3,3,0,0,0,0,0,0
2012,700,286,46,332,42,146,188,267,41,308,54,58,112
2012,701,78,8,86,1,25,26,0,0,0,0,0,0
2012,702,56,4,60,4,10,14,0,0,0,0,0,0
2012,703,10,0,10,0,2,2,0,0,0,0,0,0
2012,704,124,20,144,7,39,46,0,0,0,4,1,5
2012,705,38,3,41,0,6,6,0,0,0,0,0,0
2012,706,18,1,19,0,3,3,0,0,0,0,0,0
2012,707,25,2,27,1,11,12,0,0,0,0,0,0
2012,708,58,9,67,1,16,17,0,0,0,0,0,0
2012,709,35,5,40,4,12,16,0,0,0,0,0,0
2012,710,162,20,182,28,61,89,0,0,0,1,4,5
2012,711,46,4,50,2,14,16,0,0,0,1,1,2
2012,712,62,15,77,5,28,33,0,0,0,0,0,0
2012,713,9,1,10,0,0,0,0,0,0,0,0,0
2012,714,33,1,34,1,12,13,0,0,0,0,0,0
2012,716,10,2,12,0,1,1,0,0,0,0,0,0
2012,718,168,20,188,43,38,81,0,0,0,0,0,0
2012,721,19,3,22,5,5,10,0,0,0,0,0,0
2012,724,53,4,57,5,12,17,0,0,0,0,0,0
2012,800,24,1,25,4,4,8,1,0,1,17,6,23
2012,801,10,1,11,0,1,1,0,0,0,0,0,0
2012,900,133,5,138,24,49,73,12,3,15,72,43,115
2012,901,16,1,17,1,8,9,0,0,0,0,0,0
2012,902,31,5,36,5,14,19,0,0,0,0,0,0
2012,1000,338,41,379,42,117,159,305,95,400,10,18,28
2012,1001,76,14,90,8,38,46,0,0,0,0,1,1
2012,1002,16,3,19,5,6,11,0,0,0,0,0,0
2012,1003,9,2,11,0,4,4,0,0,0,0,0,0
2012,1004,15,0,15,0,1,1,0,0,0,0,0,0
2012,1005,648,88,736,45,153,198,0,0,0,0,0,0
2012,1006,7,1,8,0,2,2,0,0,0,0,0,0
2012,1007,13,5,18,2,1,3,0,0,0,0,0,0
2012,1008,11,1,12,0,6,6,0,0,0,0,0,0
2012,1009,9,1,10,0,2,2,0,0,0,0,0,0
2012,1011,13,1,14,0,2,2,0,0,0,0,0,0
2012,1012,28,2,30,1,14,15,0,0,0,0,0,0
2012,1013,30,2,32,3,2,5,0,0,0,0,0,0
2012,1015,27,4,31,2,6,8,0,0,0,0,0,0
2012,1017,14,1,15,2,3,5,0,0,0,0,0,0
2012,1097,18,3,21,1,8,9,0,0,0,0,0,0
2012,1100,21,2,23,3,9,12,1,0,1,11,13,24
2012,1101,9,0,9,0,2,2,0,0,0,0,0,0
2012,1102,5,2,7,0,1,1,0,0,0,0,0,0
2012,1200,68,8,76,5,28,33,69,23,92,5,4,9
2012,1201,24,2,26,1,9,10,0,0,0,0,0,0
2012,1203,47,3,50,2,24,26,0,0,0,0,0,0
2012,1204,3,1,4,0,0,0,0,0,0,0,0,0
2012,1205,15,0,15,1,8,9,0,0,0,0,0,0
2012,1207,5,0,5,0,0,0,0,0,0,0,0,0
2012,1208,6,5,11,1,7,8,0,0,0,0,0,0
2012,1300,91,4,95,10,49,59,69,19,88,11,17,28
2012,1301,30,3,33,3,10,13,0,0,0,0,0,0
2012,1302,37,1,38,6,12,18,0,0,0,0,0,0
2012,1303,4,1,5,0,0,0,0,0,0,0,0,0
2012,1304,48,2,50,6,16,22,0,0,0,0,0,0
2012,1306,15,0,15,1,1,2,0,0,0,0,0,0
2012,1307,5,0,5,0,0,0,0,0,0,0,0,0
2012,1400,23,1,24,3,12,15,10,0,10,1,3,4
2012,1401,12,0,12,1,4,5,0,0,0,0,0,0
2012,1500,363,30,393,33,174,207,392,99,491,19,53,72
2012,1501,16,2,18,2,5,7,0,0,0,0,0,0
2012,1502,327,20,347,21,105,126,0,0,0,0,0,0
2012,1503,40,2,42,15,11,26,0,0,0,0,0,0
2012,1505,11,0,11,0,2,2,0,0,0,0,0,0
2012,1506,29,2,31,3,12,15,0,0,0,0,0,0
2012,1507,18,2,20,2,7,9,0,0,0,0,0,0
2012,1509,12,2,14,0,2,2,0,0,0,0,0,0
2012,1511,14,0,14,3,4,7,0,0,0,0,0,0
2012,1514,3,0,3,0,0,0,0,0,0,0,0,0
2012,1515,7,1,8,2,9,11,0,0,0,0,0,0
2012,1597,9,2,11,1,3,4,0,0,0,0,0,0
2012,1600,69,5,74,3,42,45,0,0,0,60,48,108
2012,1601,16,2,18,3,9,12,0,0,0,0,0,0
2012,1602,46,4,50,2,24,26,0,0,0,0,0,0
2012,1603,26,3,29,2,5,7,0,0,0,0,0,0
2012,1607,12,3,15,0,2,2,0,0,0,0,0,0
2012,1700,43,5,48,2,21,23,0,0,0,39,28,67
2012,1701,9,0,9,0,1,1,0,0,0,0,0,0
2012,1702,19,2,21,1,7,8,0,0,0,0,0,0
2012,1800,26,1,27,3,6,9,16,8,24,3,6,9
2012,1801,15,0,15,0,1,1,0,0,0,0,0,0
2012,1900,6448,1266,7714,2452,3899,6351,1210,350,1560,513,658,1171
2012,1901,73,9,82,6,36,42,0,0,0,0,0,0
2012,1902,63,2,65,4,24,28,0,0,0,2,6,8
2012,1905,55,5,60,2,23,25,0,0,0,0,0,0
2012,1906,64,4,68,0,20,20,0,0,0,4,3,7
2012,1907,24,3,27,1,10,11,0,0,0,0,1,1
2012,1909,45,3,48,7,10,17,0,0,0,0,0,0
2012,1910,101,10,111,16,41,57,0,0,0,1,0,1
2012,1912,138,15,153,15,61,76,0,0,0,5,4,9
2012,1913,32,5,37,4,14,18,0,0,0,4,1,5
2012,1916,55,1,56,5,20,25,0,0,0,3,0,3
2012,1918,94,7,101,19,24,43,0,0,0,3,1,4
2012,1920,92,15,107,7,30,37,0,0,0,0,0,0
2012,1922,110,7,117,15,29,44,0,0,0,0,0,0
2012,1923,55,3,58,6,10,16,0,0,0,5,2,7
2012,1924,87,8,95,3,17,20,0,0,0,5,3,8
2012,1925,214,26,240,24,73,97,0,0,0,11,8,19
2012,1926,46,4,50,6,23,29,0,0,0,2,3,5
2012,1928,88,7,95,3,23,26,1,0,1,5,6,11
2012,1929,31,2,33,10,5,15,0,0,0,0,9,9
2012,1931,62,4,66,11,23,34,0,0,0,5,1,6
2012,1933,157,21,178,11,55,66,0,0,0,1,7,8
2012,1934,26,0,26,1,8,9,0,0,0,0,0,0
2012,1938,36,4,40,4,14,18,0,0,0,0,0,0
2012,1941,718,77,795,63,198,261,5,1,6,46,23,69
2012,1942,7977,1898,9875,913,1722,2635,86,31,117,212,117,329
2012,1944,48,11,59,12,22,34,0,0,0,3,2,5
2012,1946,41,5,46,5,20,25,0,0,0,1,3,4
2012,1947,62,7,69,2,24,26,0,0,0,6,1,7
2012,1948,59,9,68,6,20,26,0,0,0,2,3,5
2012,1951,22,3,25,1,6,7,0,0,0,2,4,6
2012,1953,195,35,230,21,64,85,0,0,0,8,8,16
2012,1955,140,11,151,24,64,88,0,0,0,10,8,18
2012,1956,79,8,87,8,38,46,0,0,0,4,5,9
2012,1961,29,1,30,2,6,8,0,0,0,3,3,6
2012,1962,50,3,53,2,8,10,0,0,0,0,0,0
2012,1963,20,5,25,1,5,6,0,0,0,0,0,0
2012,1965,181,21,202,85,81,166,0,1,1,9,7,16
2012,1966,13,2,15,1,2,3,0,0,0,0,0,0
2012,1967,32,4,36,2,3,5,0,0,0,2,6,8
2012,1969,66,5,71,7,30,37,0,0,0,4,2,6
2012,1970,33,1,34,1,11,12,0,0,0,0,0,0
2012,1972,191,16,207,18,67,85,1,0,1,7,8,15
2012,1973,44,3,47,1,11,12,0,0,0,0,0,0
2012,1975,84,6,90,11,42,53,0,0,0,3,2,5
2012,1976,112,10,122,16,33,49,0,0,0,0,0,0
2012,1978,16,2,18,2,10,12,0,0,0,0,0,0
2012,1981,16,1,17,4,3,7,0,0,0,0,0,0
2012,1982,23,2,25,12,8,20,0,0,0,0,0,0
2012,1983,15,2,17,9,6,15,0,0,0,0,0,0
2012,1984,18,5,23,7,6,13,0,0,0,0,0,0
2012,1997,46,8,54,16,24,40,0,0,0,0,0,0
2012,2000,69,3,72,3,29,32,0,0,0,0,0,0
2012,2001,12,1,13,1,4,5,0,0,0,0,0,0
2012,2002,53,5,58,2,18,20,0,0,0,0,0,0
2012,2100,103,13,116,17,61,78,55,21,76,10,17,27
2012,2101,6,2,8,0,1,1,0,0,0,0,0,0
2012,2103,9,2,11,3,2,5,0,0,0,0,0,0
2012,2104,27,3,30,0,6,6,0,0,0,0,0,0
2012,2105,19,2,21,0,4,4,0,0,0,0,0,0
2012,2106,46,10,56,2,14,16,0,0,0,0,0,0
2012,2107,8,0,8,0,0,0,0,0,0,0,0,0
2012,2108,13,3,16,0,7,7,0,0,0,0,0,0
2012,2109,51,7,58,3,17,20,0,0,0,0,0,0
2012,2110,16,2,18,1,5,6,0,0,0,0,0,0
2012,2111,12,1,13,0,3,3,0,0,0,0,0,0
2012,2113,7,1,8,1,0,1,0,0,0,0,0,0
2012,2200,37,3,40,3,10,13,9,7,16,0,0,0
2012,2300,64,2,66,8,20,28,39,15,54,0,7,7
2012,2301,13,2,15,0,4,4,0,0,0,0,0,0
2012,2303,25,1,26,2,12,14,0,0,0,0,0,0
2012,2304,11,1,12,1,5,6,0,0,0,0,0,0
2012,2400,98,3,101,4,24,28,1,0,1,61,27,88
2012,2401,29,1,30,1,9,10,0,0,0,0,0,0
2012,2402,5,2,7,0,0,0,0,0,0,0,0,0
2012,2403,9,0,9,0,2,2,0,0,0,0,0,0
2012,2404,17,0,17,0,8,8,0,0,0,0,0,0
2012,2405,33,3,36,4,15,19,0,0,0,0,0,0
2012,2406,79,4,83,7,21,28,0,0,0,0,0,0
2012,2412,9,3,12,3,8,11,0,0,0,0,0,0
2012,2500,10,1,11,2,5,7,2,0,2,4,1,5
2012,2501,5,0,5,0,1,1,0,0,0,0,0,0
2012,2600,26,1,27,0,2,2,0,0,0,13,8,21
2012,2601,17,0,17,0,3,3,0,0,0,0,0,0
2012,2700,136,11,147,8,55,63,107,37,144,15,23,38
2012,2701,13,1,14,1,6,7,0,0,0,0,0,0
2012,2702,6,0,6,0,0,0,0,0,0,0,0,0
2012,2703,9,2,11,1,2,3,0,0,0,0,0,0
2012,2704,12,1,13,0,3,3,0,0,0,0,0,0
2012,2705,15,1,16,0,3,3,0,0,0,0,0,0
2012,2706,41,5,46,1,4,5,0,0,0,5,7,12
2012,2707,11,7,18,2,7,9,0,0,0,0,0,0
2012,2708,138,9,147,10,39,49,0,0,0,0,0,0
2012,2709,7,1,8,0,1,1,0,0,0,0,0,0
2012,2710,32,5,37,2,6,8,0,0,0,0,0,0
2012,2711,15,0,15,0,3,3,0,0,0,0,0,0
2012,2712,27,2,29,1,8,9,0,0,0,0,0,0
2012,2714,6,0,6,0,0,0,0,0,0,0,0,0
2012,2719,12,3,15,1,5,6,0,0,0,0,0,0
2012,2800,92,6,98,8,19,27,1,0,1,0,0,0
2012,2801,8,2,10,1,3,4,0,0,0,0,0,0
2012,2802,58,9,67,5,34,39,0,0,0,0,0,0
2012,2803,10,1,11,0,4,4,0,0,0,0,0,0
2012,2808,108,6,114,2,8,10,0,0,0,0,0,0
2012,2900,50,5,55,8,29,37,9,0,9,32,30,62
2012,2901,19,1,20,0,7,7,0,0,0,0,0,0
2012,2902,10,0,10,0,1,1,0,0,0,0,0,0
2012,2908,21,1,22,0,4,4,0,0,0,0,0,0
2012,3000,1019,164,1183,656,732,1388,642,60,702,277,94,371
2012,3001,313,29,342,38,99,137,11,7,18,0,9,9
2012,3002,78,7,85,2,35,37,0,0,0,1,0,1
2012,3003,77,6,83,4,33,37,0,0,0,3,1,4
2012,3004,112,15,127,12,51,63,0,1,1,4,3,7
2012,3005,50,5,55,2,11,13,0,0,0,3,0,3
2012,3006,22,1,23,0,7,7,0,0,0,0,0,0
2012,3007,54,4,58,1,17,18,0,0,0,0,0,0
2012,3008,124,15,139,6,54,60,0,0,0,4,1,5
2012,3009,148,5,153,14,45,59,0,0,0,0,0,0
2012,3010,184,11,195,17,78,95,0,0,0,13,5,18
2012,3011,40,4,44,7,31,38,0,0,0,0,0,0
2012,3012,62,4,66,7,27,34,0,0,0,0,0,0
2012,3013,16,5,21,0,3,3,0,0,0,0,0,0
2012,3014,122,10,132,21,49,70,0,0,0,6,2,8
2012,3015,141,14,155,16,45,61,0,0,0,0,0,0
2012,3016,43,3,46,5,18,23,0,0,0,0,0,0
2012,3019,289,30,319,38,109,147,0,0,0,47,65,112
2012,3020,29,2,31,6,5,11,0,0,0,3,3,6
2012,3022,79,7,86,9,36,45,0,0,0,0,0,0
2012,3024,81,6,87,5,27,32,0,0,0,2,0,2
2012,3026,160,40,200,19,61,80,0,0,0,0,0,0
2012,3027,22,4,26,3,7,10,0,0,0,0,0,0
2012,3097,27,2,29,6,8,14,0,0,0,0,0,0
2012,3100,179,13,192,17,73,90,32,5,37,52,52,104
2012,3101,20,0,20,1,5,6,0,0,0,0,0,0
2012,3103,18,1,19,2,4,6,0,0,0,0,0,0
2012,3104,46,6,52,4,22,26,0,0,0,0,0,0
2012,3105,110,6,116,11,46,57,0,0,0,5,4,9
2012,3200,28,1,29,0,11,11,0,0,0,8,6,14
2012,3300,1389,143,1532,210,646,856,339,45,384,623,311,934
2012,3301,24,3,27,1,11,12,0,0,0,0,0,0
2012,3302,48,3,51,2,19,21,0,0,0,0,0,0
2012,3303,22,0,22,5,6,11,0,0,0,0,0,0
2012,3306,27,2,29,3,1,4,0,0,0,0,0,0
2012,3308,55,2,57,3,19,22,0,0,0,0,0,0
2012,3309,60,3,63,11,29,40,0,0,0,0,0,0
2012,3311,73,14,87,4,28,32,0,0,0,0,0,0
2012,3313,328,38,366,31,123,154,0,0,0,0,0,0
2012,3315,132,16,148,8,44,52,0,0,0,3,2,5
2012,3325,41,3,44,5,22,27,0,0,0,0,0,0
2012,3342,76,8,84,3,38,41,0,0,0,0,0,0
2012,3344,21,2,23,1,6,7,0,0,0,0,0,0
2012,3397,26,4,30,1,12,13,0,0,0,0,0,0
2012,3400,529,98,627,128,224,352,437,122,559,99,231,330
2012,3401,64,8,72,1,25,26,0,0,0,0,0,0
2012,3402,31,3,34,1,12,13,0,0,0,0,0,0
2012,3404,513,114,627,59,175,234,0,0,0,0,0,0
2012,3408,20,2,22,5,7,12,0,0,0,0,0,0
2012,3414,22,1,23,2,3,5,0,0,0,0,0,0
2012,3420,1,0,1,3,1,4,0,0,0,0,0,0
2012,3422,436,126,562,11,33,44,0,0,0,0,0,0
2012,3477,77,8,85,10,16,26,0,0,0,0,0,0
2012,3496,72,13,85,7,35,42,0,0,0,0,0,0
2012,3499,6853,565,7418,1545,1922,3467,0,0,0,0,0,0
2012,3500,19,2,21,0,3,3,0,0,0,10,10,20
2012,3501,19,3,22,0,8,8,0,0,0,0,0,0
2012,3600,1032,154,1186,238,592,830,436,96,532,213,425,638
2012,3601,35,1,36,0,13,13,0,0,0,0,0,0
2012,3602,96,6,102,4,47,51,0,0,0,0,0,0
2012,3603,45,1,46,3,18,21,0,0,0,0,0,0
2012,3604,160,19,179,11,74,85,0,0,0,0,0,0
2012,3605,43,7,50,0,17,17,0,0,0,0,0,0
2012,3607,214,10,224,15,81,96,0,0,0,0,0,0
2012,3608,67,13,80,9,26,35,0,0,0,0,0,0
2012,3609,81,10,91,14,37,51,0,0,0,0,0,0
2012,3610,247,25,272,34,122,156,0,0,0,0,0,0
2012,3611,67,3,70,1,21,22,0,0,0,0,0,0
2012,3614,11,4,15,4,8,12,0,0,0,0,0,0
2012,3623,22,1,23,36,17,53,0,0,0,0,0,0
2012,3639,7,1,8,4,2,6,0,0,0,0,0,0
2012,3650,11,3,14,23,18,41,0,0,0,0,0,0
2012,3657,33,8,41,5,11,16,0,0,0,0,0,0
2012,3700,1109,173,1282,324,513,837,799,189,988,282,427,709
2012,3701,98,14,112,8,38,46,0,0,0,0,0,0
2012,3702,189,21,210,18,59,77,0,0,0,3,9,12
2012,3703,36,6,42,1,19,20,0,0,0,0,0,0
2012,3705,104,8,112,13,56,69,0,0,0,0,0,0
2012,3706,134,15,149,8,42,50,0,0,0,0,0,0
2012,3708,58,7,65,2,27,29,0,0,0,0,0,0
2012,3709,74,6,80,3,27,30,0,0,0,0,0,0
2012,3710,185,18,203,12,67,79,0,0,0,0,0,0
2012,3711,1586,280,1866,219,396,615,0,0,0,0,0,0
2012,3714,20,2,22,7,17,24,0,0,0,0,0,0
2012,3715,109,17,126,5,19,24,0,0,0,0,0,0
2012,3732,14,1,15,6,10,16,0,0,0,0,0,0
2012,3797,27,4,31,17,14,31,0,0,0,0,0,0
2012,3800,265,57,322,65,71,136,452,86,538,11,10,21
2012,3801,1838,335,2173,187,239,426,0,0,0,0,0,0
2012,3803,21,3,24,13,12,25,0,0,0,0,0,0
2012,3816,10,2,12,0,0,0,0,0,0,0,0,0
2012,3897,40,9,49,53,15,68,0,0,0,0,0,0
2012,3900,233,20,253,22,91,113,26,1,27,176,113,289
2012,3901,10,0,10,0,1,1,0,0,0,0,0,0
2012,3902,65,5,70,0,11,11,0,0,0,3,16,19
2012,3903,56,4,60,6,16,22,0,0,0,0,0,0
2012,3904,21,2,23,1,8,9,0,0,0,0,0,0
2012,3905,295,36,331,64,125,189,0,0,0,0,0,0
2012,3906,72,6,78,7,31,38,0,0,0,0,0,0
2012,3915,17,5,22,0,5,5,0,0,0,0,0,0
2012,4000,148,4,152,11,50,61,0,0,0,109,56,165
2012,4001,20,3,23,2,5,7,0,0,0,0,0,0
2012,4002,13,1,14,2,6,8,0,0,0,0,0,0
2012,4003,10,6,16,0,5,5,0,0,0,0,0,0
2012,4004,26,1,27,1,11,12,0,0,0,0,0,0
2012,4005,19,3,22,0,11,11,0,0,0,0,0,0
2012,4006,45,8,53,2,23,25,0,0,0,0,0,0
2012,4007,13,2,15,4,15,19,0,0,0,0,0,0
2012,4008,23,3,26,1,9,10,0,0,0,0,0,0
2012,4016,77,30,107,0,14,14,0,0,0,0,0,0
2012,4019,6,0,6,3,3,6,0,0,0,0,0,0
2012,4100,210,24,234,51,84,135,71,9,80,92,60,152
2012,4101,16,2,18,1,5,6,0,0,0,0,0,0
2012,4102,25,3,28,5,7,12,0,0,0,0,0,0
2012,4103,8,3,11,0,3,3,0,0,0,0,0,0
2012,4104,32,4,36,4,13,17,0,0,0,0,0,0
2012,4105,17,0,17,0,6,6,0,0,0,0,0,0
2012,4106,96,10,106,12,29,41,0,0,0,0,0,0
2012,4108,21,3,24,1,5,6,0,0,0,0,0,0
2012,4109,39,8,47,5,14,19,0,0,0,0,0,0
2012,4111,29,4,33,1,3,4,0,0,0,0,0,0
2012,4113,74,13,87,3,25,28,0,0,0,0,0,0
2012,4114,40,5,45,1,14,15,0,0,0,0,0,0
2012,4116,91,12,103,8,26,34,0,0,0,0,0,0
2012,4117,73,8,81,6,22,28,0,0,0,0,0,0
2012,4119,8,1,9,0,0,0,0,0,0,0,0,0
2012,4120,30,5,35,3,10,13,0,0,0,0,0,0
2012,4127,31,2,33,1,7,8,0,0,0,0,0,0
2012,4200,225,13,238,27,84,111,140,35,175,25,32,57
2012,4201,11,0,11,0,2,2,0,0,0,0,0,0
2012,4202,45,3,48,2,16,18,0,0,0,4,0,4
2012,4203,116,17,133,22,47,69,0,0,0,0,0,0
2012,4204,88,5,93,3,40,43,0,0,0,0,0,0
2012,4211,2,1,3,0,1,1,0,0,0,0,0,0
2012,4297,29,3,32,7,8,15,0,0,0,0,0,0
2012,4300,410,65,475,62,115,177,514,142,656,76,133,209
2012,4302,41,3,44,2,19,21,0,0,0,0,0,0
2012,4304,51,7,58,4,19,23,0,0,0,2,2,4
2012,4305,26,4,30,3,12,15,0,0,0,0,0,0
2012,4307,35,4,39,6,14,20,0,0,0,0,0,0
2012,4308,71,8,79,4,17,21,0,0,0,0,0,0
2012,4310,32,3,35,2,14,16,0,0,0,0,0,0
2012,4311,84,10,94,11,33,44,0,0,0,0,0,0
2012,4312,67,12,79,18,37,55,0,0,0,0,0,0
2012,4313,989,105,1094,80,261,341,0,0,0,0,0,0
2012,4314,124,13,137,16,44,60,0,0,0,3,1,4
2012,4316,186,15,201,17,49,66,0,0,0,0,0,0
2012,4317,26,2,28,25,16,41,0,0,0,0,0,0
2012,4320,3,0,3,5,1,6,0,0,0,0,0,0
2012,4321,9,0,9,4,2,6,0,0,0,0,0,0
2012,4327,9,0,9,4,2,6,0,0,0,0,0,0
2012,4400,96,18,114,4,30,34,9,1,10,91,37,128
2012,4401,20,1,21,5,3,8,0,0,0,0,0,0
2012,4402,81,8,89,4,17,21,0,0,0,0,0,0
2012,4403,63,3,66,4,11,15,0,0,0,0,0,0
2012,4404,19,1,20,2,5,7,0,0,0,0,0,0
2012,4497,11,4,15,0,11,11,0,0,0,0,0,0
2012,4500,71,7,78,8,37,45,43,12,55,13,18,31
2012,4501,14,2,16,0,6,6,0,0,0,0,0,0
2012,4502,91,7,98,8,24,32,0,0,0,0,0,0
2012,4591,13,6,19,1,3,4,0,0,0,0,0,0
2012,4600,9,1,10,0,0,0,0,0,0,4,2,6
2012,4700,48,1,49,7,10,17,22,6,28,5,2,7
2012,4703,2,0,2,0,0,0,0,0,0,0,0,0
2012,4706,8,0,8,0,3,3,0,0,0,0,0,0
2012,4707,1,1,2,0,0,0,0,0,0,0,0,0
2012,4708,10,0,10,1,4,5,0,0,0,0,0,0
2012,4709,14,0,14,2,4,6,0,0,0,0,0,0
2012,4710,4,0,4,0,1,1,0,0,0,0,0,0
2012,4800,96,7,103,14,53,67,1,0,1,171,67,238
2012,4801,32,2,34,1,16,17,0,0,0,0,0,0
2012,4802,20,1,21,0,5,5,0,0,0,0,0,0
2012,4803,108,9,117,11,50,61,0,0,0,0,0,0
2012,4804,6,2,8,0,1,1,0,0,0,0,0,0
2012,4805,19,2,21,0,12,12,0,0,0,0,0,0
2012,4806,79,10,89,3,50,53,0,0,0,0,0,0
2012,4807,87,5,92,10,21,31,0,0,0,0,0,0
2012,4813,2,1,3,0,1,1,0,0,0,0,0,0
2012,4900,208,15,223,26,69,95,0,0,0,188,83,271
2012,4901,12,2,14,0,7,7,0,0,0,0,0,0
2012,4902,9,1,10,1,5,6,0,0,0,0,0,0
2012,4903,13,2,15,0,8,8,0,0,0,0,0,0
2012,4904,50,3,53,1,17,18,0,0,0,0,0,0
2012,4905,146,14,160,13,55,68,0,0,0,0,0,0
2012,4906,12,1,13,1,5,6,0,0,0,0,0,0
2012,4908,57,5,62,2,19,21,0,0,0,0,0,0
2012,4909,8,3,11,4,7,11,0,0,0,0,0,0
2012,4914,12,1,13,4,8,12,0,0,0,0,0,0
2012,5000,165,7,172,15,60,75,182,34,216,6,49,55
2012,5001,49,3,52,2,13,15,0,0,0,0,0,0
2012,5002,207,9,216,9,66,75,0,0,0,0,0,0
2012,5003,11,0,11,0,3,3,0,0,0,0,0,0
2012,5004,20,1,21,1,9,10,0,0,0,0,0,0
2012,5007,69,9,78,3,35,38,0,0,0,0,0,0
2012,5010,8,4,12,3,6,9,0,0,0,0,0,0
2012,5100,48,3,51,4,17,21,38,15,53,0,4,4
2012,5102,56,8,64,3,19,22,0,0,0,0,0,0
2012,5200,30,3,33,6,12,18,29,10,39,4,10,14
2012,5201,13,1,14,3,6,9,0,0,0,0,0,0
2012,5202,22,0,22,1,9,10,0,0,0,0,0,0
2012,5300,17,1,18,1,5,6,0,0,0,10,6,16
2012,5400,222,31,253,21,72,93,201,47,248,46,48,94
2012,5401,30,4,34,3,7,10,0,0,0,0,0,0
2012,5402,14,4,18,0,1,1,0,0,0,0,0,0
2012,5403,13,0,13,0,1,1,0,0,0,0,0,0
2012,5404,17,1,18,0,3,3,0,0,0,0,0,0
2012,5405,51,7,58,10,14,24,0,0,0,0,0,0
2012,5406,61,9,70,5,21,26,0,0,0,0,0,0
2012,5407,120,14,134,9,54,63,0,0,0,0,0,0
2012,5408,10,0,10,1,1,2,0,0,0,0,0,0
2012,5411,4,2,6,0,1,1,0,0,0,0,0,0
2012,5500,56,2,58,1,20,21,0,0,0,24,16,40
2012,5501,12,0,12,0,4,4,0,0,0,0,0,0
2012,5600,476,52,528,83,197,280,191,29,220,97,94,191
2012,5604,202,27,229,43,110,153,0,0,0,5,4,9
2012,5605,20,4,24,2,6,8,0,0,0,0,0,0
2012,5606,28,0,28,5,5,10,0,0,0,0,0,0
2012,5608,115,8,123,16,33,49,0,0,0,0,0,0
2012,5609,114,8,122,13,38,51,0,0,0,0,0,0
2012,5622,14,1,15,4,7,11,0,0,0,0,0,0
2012,5680,12,1,13,0,1,1,0,0,0,0,0,0
2012,5700,70,8,78,7,24,31,4,1,5,65,48,113
2012,5701,51,7,58,5,26,31,0,0,0,0,0,0
2012,5702,10,0,10,0,2,2,0,0,0,0,0,0
2012,5703,50,8,58,1,14,15,0,0,0,0,0,0
2012,5704,58,7,65,3,18,21,0,0,0,0,0,0
2012,5797,39,8,47,10,15,25,0,0,0,0,0,0
2012,5800,61,3,64,0,23,23,48,20,68,10,7,17
2012,5801,17,2,19,3,8,11,0,0,0,0,0,0
2012,5802,4,2,6,0,0,0,0,0,0,0,0,0
2012,10M1,190,37,227,6,10,16,0,0,0,0,0,0
2012,190C,23,2,25,4,4,8,0,0,0,0,0,0
2012,190R,9,0,9,4,4,8,0,0,0,0,0,0
2012,340H,114,13,127,18,60,78,0,0,0,0,0,0
2013,100,473,57,530,178,213,391,356,52,408,120,150,270
2013,101,72,9,81,3,27,30,0,0,0,0,0,0
2013,102,23,1,24,1,4,5,0,0,0,0,0,0
2013,103,133,33,166,20,60,80,1,0,1,6,8,14
2013,104,34,1,35,3,13,16,0,0,0,0,0,0
2013,105,148,20,168,9,73,82,1,0,1,8,8,16
2013,106,159,20,179,15,70,85,0,0,0,16,9,25
2013,107,78,7,85,8,34,42,0,0,0,0,0,0
2013,108,47,7,54,5,16,21,0,0,0,0,0,0
2013,109,565,74,639,48,208,256,0,0,0,0,0,0
2013,110,16,4,20,1,7,8,0,0,0,0,0,0
2013,111,75,6,81,4,28,32,0,0,0,0,0,0
2013,112,82,7,89,5,29,34,0,0,0,2,0,2
2013,113,64,9,73,3,19,22,0,0,0,0,0,0
2013,114,52,4,56,5,19,24,0,0,0,0,0,0
2013,115,10,3,13,3,7,10,0,0,0,0,0,0
2013,197,47,18,65,52,30,82,0,0,0,0,0,0
2013,200,15,0,15,0,3,3,0,0,0,0,0,0
2013,300,40,1,41,2,15,17,1,0,1,14,13,27
2013,302,5,0,5,0,0,0,0,0,0,0,0,0
2013,303,7,1,8,0,1,1,0,0,0,0,0,0
2013,305,6,0,6,0,0,0,0,0,0,0,0,0
2013,400,106,2,108,6,43,49,1,0,1,90,51,141
2013,402,78,5,83,9,43,52,0,0,0,0,0,0
2013,403,13,1,14,0,5,5,0,0,0,0,0,0
2013,404,21,2,23,1,12,13,0,0,0,0,0,0
2013,405,17,2,19,2,7,9,0,0,0,0,0,0
2013,497,14,2,16,2,9,11,0,0,0,0,0,0
2013,500,47,5,52,4,16,20,2,1,3,12,10,22
2013,501,7,0,7,0,1,1,0,0,0,0,0,0
2013,600,28,3,31,2,18,20,2,0,2,7,7,14
2013,601,8,1,9,0,1,1,0,0,0,0,0,0
2013,602,9,1,10,0,2,2,0,0,0,0,0,0
2013,700,272,43,315,45,146,191,291,48,339,62,58,120
2013,701,75,8,83,1,20,21,0,0,0,1,2,3
2013,702,55,4,59,4,12,16,0,0,0,0,0,0
2013,703,11,0,11,0,2,2,0,0,0,0,0,0
2013,704,130,18,148,5,38,43,0,0,0,4,1,5
2013,705,40,3,43,1,6,7,0,0,0,0,0,0
2013,706,21,0,21,0,3,3,0,0,0,0,0,0
2013,707,26,1,27,1,11,12,0,0,0,0,0,0
2013,708,60,9,69,1,17,18,0,0,0,0,0,0
2013,709,34,5,39,5,11,16,0,0,0,0,0,0
2013,710,161,24,185,31,63,94,1,0,1,1,5,6
2013,711,48,4,52,4,14,18,0,0,0,1,1,2
2013,712,62,13,75,5,29,34,0,0,0,0,0,0
2013,713,9,1,10,0,0,0,0,0,0,0,0,0
2013,714,34,1,35,0,12,12,0,0,0,0,0,0
2013,716,10,2,12,0,1,1,0,0,0,0,0,0
2013,718,152,23,175,47,39,86,0,0,0,0,0,0
2013,721,20,3,23,6,5,11,0,0,0,0,0,0
2013,724,54,4,58,5,10,15,0,0,0,0,0,0
2013,800,22,1,23,4,4,8,1,0,1,15,6,21
2013,801,10,1,11,0,2,2,0,0,0,0,0,0
2013,900,135,5,140,16,48,64,14,2,16,80,39,119
2013,901,16,1,17,1,8,9,0,0,0,0,0,0
2013,902,33,4,37,6,13,19,0,0,0,0,0,0
2013,1000,348,37,385,46,121,167,321,107,428,9,16,25
2013,1001,79,14,93,11,43,54,0,0,0,0,1,1
2013,1002,18,2,20,3,7,10,0,0,0,0,0,0
2013,1003,9,2,11,0,4,4,0,0,0,0,0,0
2013,1004,12,0,12,0,1,1,0,0,0,0,0,0
2013,1005,618,83,701,45,154,199,0,0,0,0,0,0
2013,1006,7,2,9,0,2,2,0,0,0,0,0,0
2013,1007,14,5,19,1,2,3,0,0,0,0,0,0
2013,1008,10,0,10,1,4,5,0,0,0,0,0,0
2013,1009,11,0,11,0,2,2,0,0,0,0,0,0
2013,1010,9,2,11,0,2,2,0,0,0,0,0,0
2013,1011,10,1,11,0,2,2,0,0,0,0,0,0
2013,1012,24,2,26,1,14,15,0,0,0,0,0,0
2013,1013,30,2,32,3,2,5,0,0,0,0,0,0
2013,1015,28,4,32,2,5,7,0,0,0,0,0,0
2013,1017,13,1,14,1,3,4,0,0,0,0,0,0
2013,1097,18,3,21,1,8,9,0,0,0,0,0,0
2013,1100,21,2,23,3,10,13,2,0,2,9,13,22
2013,1101,9,0,9,0,2,2,0,0,0,0,0,0
2013,1102,6,2,8,0,1,1,0,0,0,0,0,0
2013,1200,70,8,78,5,28,33,69,22,91,5,6,11
2013,1201,22,4,26,1,12,13,0,0,0,0,0,0
2013,1203,44,4,48,3,25,28,0,0,0,0,0,0
2013,1204,4,1,5,0,0,0,0,0,0,0,0,0
2013,1205,15,0,15,1,8,9,0,0,0,0,0,0
2013,1207,5,0,5,0,0,0,0,0,0,0,0,0
2013,1208,8,4,12,1,6,7,0,0,0,0,0,0
2013,1300,96,4,100,7,45,52,67,15,82,14,20,34
2013,1301,28,3,31,4,11,15,0,0,0,0,0,0
2013,1302,34,1,35,6,12,18,0,0,0,0,0,0
2013,1303,4,0,4,0,0,0,0,0,0,0,0,0
2013,1304,45,2,47,6,16,22,0,0,0,0,0,0
2013,1306,16,2,18,1,1,2,0,0,0,0,0,0
2013,1307,5,0,5,0,0,0,0,0,0,0,0,0
2013,1400,23,1,24,3,12,15,10,0,10,1,3,4
2013,1401,12,0,12,1,5,6,0,0,0,0,0,0
2013,1500,376,28,404,40,179,219,415,123,538,20,58,78
2013,1501,18,1,19,2,5,7,0,0,0,0,0,0
2013,1502,319,20,339,37,112,149,0,0,0,0,0,0
2013,1503,42,2,44,14,8,22,0,0,0,0,0,0
2013,1505,14,0,14,0,3,3,0,0,0,0,0,0
2013,1506,29,1,30,4,12,16,0,0,0,0,0,0
2013,1507,18,2,20,2,7,9,0,0,0,0,0,0
2013,1508,14,2,16,0,5,5,0,0,0,0,0,0
2013,1509,13,2,15,0,2,2,0,0,0,0,0,0
2013,1511,18,1,19,3,5,8,0,0,0,0,0,0
2013,1514,3,0,3,0,0,0,0,0,0,0,0,0
2013,1515,6,1,7,1,8,9,0,0,0,1,0,1
2013,1597,9,2,11,1,3,4,0,0,0,0,0,0
2013,1600,74,5,79,2,44,46,0,0,0,71,55,126
2013,1601,19,2,21,3,7,10,0,0,0,0,0,0
2013,1602,47,4,51,2,24,26,0,0,0,0,0,0
2013,1603,27,2,29,2,5,7,0,0,0,0,0,0
2013,1607,13,3,16,0,2,2,0,0,0,0,0,0
2013,1700,46,5,51,2,18,20,0,0,0,46,30,76
2013,1701,7,2,9,0,1,1,0,0,0,0,0,0
2013,1702,20,1,21,1,7,8,0,0,0,0,0,0
2013,1800,28,1,29,2,8,10,16,10,26,3,6,9
2013,1801,15,0,15,0,1,1,0,0,0,0,0,0
2013,1900,6331,1278,7609,2399,3882,6281,1232,345,1577,553,684,1237
2013,1901,75,8,83,6,37,43,0,0,0,0,0,0
2013,1902,64,2,66,2,22,24,0,0,0,0,4,4
2013,1905,51,6,57,3,24,27,0,0,0,0,0,0
2013,1906,59,5,64,0,19,19,0,0,0,4,2,6
2013,1907,23,2,25,1,10,11,0,0,0,0,0,0
2013,1909,47,3,50,7,10,17,0,0,0,0,0,0
2013,1910,107,10,117,10,37,47,0,0,0,1,0,1
2013,1912,134,14,148,15,61,76,0,0,0,4,5,9
2013,1913,31,5,36,4,14,18,0,0,0,4,1,5
2013,1916,53,1,54,7,18,25,0,0,0,3,1,4
2013,1918,94,7,101,19,21,40,0,0,0,3,1,4
2013,1920,95,14,109,4,35,39,0,0,0,0,0,0
2013,1922,108,7,115,10,25,35,0,0,0,6,1,7
2013,1923,58,3,61,5,9,14,0,0,0,5,2,7
2013,1924,83,7,90,5,14,19,0,0,0,3,5,8
2013,1925,213,28,241,17,70,87,0,0,0,13,8,21
2013,1926,46,3,49,7,20,27,0,0,0,2,3,5
2013,1928,89,6,95,2,22,24,1,0,1,6,6,12
2013,1929,29,3,32,10,5,15,0,0,0,1,9,10
2013,1931,60,4,64,11,23,34,0,0,0,5,1,6
2013,1933,144,18,162,6,55,61,0,0,0,0,7,7
2013,1934,22,1,23,0,8,8,0,0,0,0,0,0
2013,1938,36,4,40,4,14,18,0,0,0,0,0,0
2013,1941,696,74,770,96,187,283,4,1,5,40,19,59
2013,1942,7883,1845,9728,853,1615,2468,91,24,115,200,105,305
2013,1944,51,11,62,9,21,30,0,0,0,3,2,5
2013,1946,40,5,45,5,20,25,0,0,0,1,3,4
2013,1947,64,7,71,4,25,29,0,0,0,4,2,6
2013,1948,57,10,67,5,20,25,0,0,0,2,3,5
2013,1951,22,2,24,1,5,6,0,0,0,2,4,6
2013,1953,191,35,226,21,60,81,0,0,0,10,9,19
2013,1955,146,11,157,20,60,80,0,0,0,10,8,18
2013,1956,81,7,88,10,37,47,0,0,0,3,5,8
2013,1961,29,2,31,2,6,8,0,0,0,3,3,6
2013,1962,49,3,52,2,11,13,0,0,0,0,0,0
2013,1963,21,7,28,1,6,7,0,0,0,0,0,0
2013,1965,181,20,201,80,80,160,0,1,1,9,7,16
2013,1966,12,2,14,1,2,3,0,0,0,0,0,0
2013,1967,31,3,34,2,3,5,0,0,0,2,6,8
2013,1969,63,6,69,7,29,36,0,0,0,4,2,6
2013,1970,32,1,33,1,13,14,0,0,0,0,0,0
2013,1972,205,16,221,32,82,114,1,0,1,8,8,16
2013,1973,40,2,42,1,9,10,0,0,0,0,0,0
2013,1975,86,4,90,9,41,50,0,0,0,3,3,6
2013,1976,108,12,120,15,35,50,0,0,0,0,0,0
2013,1978,15,2,17,1,8,9,0,0,0,0,0,0
2013,1981,17,1,18,4,3,7,0,0,0,0,0,0
2013,1982,21,2,23,6,7,13,0,0,0,0,0,0
2013,1983,14,2,16,8,5,13,0,0,0,0,0,0
2013,1984,19,3,22,7,6,13,0,0,0,0,0,0
2013,1997,49,7,56,14,24,38,0,0,0,0,0,0
2013,2000,69,2,71,2,30,32,0,0,0,0,0,0
2013,2001,15,1,16,1,5,6,0,0,0,0,0,0
2013,2002,51,5,56,2,18,20,0,0,0,0,0,0
2013,2100,104,18,122,16,55,71,52,21,73,10,17,27
2013,2101,6,2,8,0,1,1,0,0,0,0,0,0
2013,2103,10,1,11,2,3,5,0,0,0,0,0,0
2013,2105,19,2,21,0,5,5,0,0,0,0,0,0
2013,2106,49,10,59,2,15,17,0,0,0,0,0,0
2013,2107,8,0,8,0,0,0,0,0,0,0,0,0
2013,2109,53,9,62,3,19,22,0,0,0,0,0,0
2013,2110,16,2,18,1,4,5,0,0,0,0,0,0
2013,2111,12,1,13,0,3,3,0,0,0,0,0,0
2013,2113,7,0,7,1,0,1,0,0,0,0,0,0
2013,2117,37,5,42,0,12,12,0,0,0,0,0,0
2013,2200,31,3,34,3,10,13,10,8,18,0,0,0
2013,2300,62,3,65,7,23,30,43,12,55,0,7,7
2013,2301,14,1,15,0,5,5,0,0,0,0,0,0
2013,2303,26,2,28,2,12,14,0,0,0,0,0,0
2013,2304,11,1,12,2,4,6,0,0,0,0,0,0
2013,2400,101,3,104,8,25,33,2,0,2,58,28,86
2013,2401,28,1,29,2,6,8,0,0,0,0,0,0
2013,2402,5,2,7,0,4,4,0,0,0,0,0,0
2013,2403,9,0,9,0,2,2,0,0,0,0,0,0
2013,2404,17,0,17,0,8,8,0,0,0,0,0,0
2013,2405,33,3,36,4,15,19,0,0,0,0,0,0
2013,2406,77,3,80,7,24,31,0,0,0,0,0,0
2013,2412,9,3,12,2,11,13,0,0,0,0,0,0
2013,2500,12,0,12,2,7,9,1,0,1,4,2,6
2013,2501,6,0,6,0,1,1,0,0,0,0,0,0
2013,2600,28,0,28,4,4,8,0,0,0,12,9,21
2013,2601,11,0,11,0,3,3,0,0,0,0,0,0
2013,2700,128,11,139,8,54,62,106,36,142,13,26,39
2013,2701,13,1,14,1,6,7,0,0,0,0,0,0
2013,2702,6,0,6,0,0,0,0,0,0,0,0,0
2013,2703,10,2,12,0,2,2,0,0,0,0,0,0
2013,2704,13,1,14,0,3,3,0,0,0,0,0,0
2013,2705,15,1,16,0,3,3,0,0,0,0,0,0
2013,2706,44,5,49,1,3,4,0,0,0,4,6,10
2013,2707,12,6,18,1,5,6,0,0,0,0,0,0
2013,2708,133,8,141,10,36,46,0,0,0,0,0,0
2013,2709,6,1,7,0,1,1,0,0,0,0,0,0
2013,2710,31,4,35,1,6,7,0,0,0,0,0,0
2013,2711,14,0,14,1,2,3,0,0,0,0,0,0
2013,2712,28,2,30,1,7,8,0,0,0,0,0,0
2013,2714,6,0,6,0,0,0,0,0,0,0,0,0
2013,2719,10,4,14,0,6,6,0,0,0,0,0,0
2013,2800,98,5,103,9,20,29,1,0,1,0,0,0
2013,2801,7,2,9,1,3,4,0,0,0,0,0,0
2013,2802,61,7,68,7,35,42,0,0,0,0,0,0
2013,2803,10,1,11,0,5,5,0,0,0,0,0,0
2013,2808,101,4,105,2,10,12,0,0,0,0,0,0
2013,2900,48,4,52,6,23,29,10,1,11,34,34,68
2013,2901,20,1,21,1,3,4,0,0,0,0,0,0
2013,2902,10,0,10,0,1,1,0,0,0,0,0,0
2013,2908,23,1,24,5,7,12,0,0,0,0,0,0
2013,3000,960,113,1073,605,634,1239,727,101,828,314,209,523
2013,3001,317,29,346,45,103,148,9,6,15,0,9,9
2013,3002,54,4,58,2,30,32,0,0,0,1,0,1
2013,3003,77,7,84,5,30,35,0,0,0,0,0,0
2013,3004,103,13,116,15,55,70,0,1,1,3,3,6
2013,3005,46,5,51,4,12,16,0,0,0,3,0,3
2013,3006,22,1,23,0,7,7,0,0,0,0,0,0
2013,3007,57,3,60,1,17,18,0,0,0,0,0,0
2013,3008,120,15,135,6,53,59,0,0,0,4,1,5
2013,3009,150,4,154,14,48,62,0,0,0,0,0,0
2013,3010,183,10,193,22,77,99,0,0,0,12,6,18
2013,3011,39,5,44,7,27,34,0,0,0,0,0,0
2013,3012,64,3,67,7,28,35,0,0,0,0,0,0
2013,3013,18,5,23,0,4,4,0,0,0,0,0,0
2013,3014,124,11,135,25,44,69,0,0,0,6,1,7
2013,3015,138,14,152,11,49,60,0,0,0,0,0,0
2013,3016,45,2,47,5,11,16,0,0,0,0,0,0
2013,3019,288,29,317,37,101,138,0,0,0,45,65,110
2013,3020,29,2,31,7,5,12,0,0,0,2,3,5
2013,3022,79,8,87,9,38,47,0,0,0,0,0,0
2013,3024,79,6,85,5,27,32,0,0,0,2,0,2
2013,3026,155,39,194,24,63,87,0,0,0,0,0,0
2013,3027,23,4,27,5,7,12,0,0,0,0,0,0
2013,3097,30,3,33,6,8,14,0,0,0,0,0,0
2013,3100,157,16,173,17,77,94,54,7,61,73,58,131
2013,3101,19,0,19,2,5,7,0,0,0,0,0,0
2013,3103,18,1,19,2,5,7,0,0,0,0,0,0
2013,3104,46,6,52,3,23,26,0,0,0,0,0,0
2013,3105,116,6,122,11,45,56,0,0,0,4,4,8
2013,3200,28,1,29,0,12,12,1,0,1,9,7,16
2013,3300,1446,155,1601,161,653,814,406,46,452,692,338,1030
2013,3301,23,4,27,0,12,12,0,0,0,0,0,0
2013,3302,47,3,50,1,16,17,0,0,0,0,0,0
2013,3303,22,0,22,5,6,11,0,0,0,0,0,0
2013,3306,25,3,28,3,2,5,0,0,0,0,0,0
2013,3308,55,3,58,4,19,23,0,0,0,0,0,0
2013,3309,56,3,59,8,25,33,0,0,0,0,0,0
2013,3311,73,13,86,5,28,33,0,0,0,0,0,0
2013,3313,329,38,367,34,119,153,0,0,0,0,0,0
2013,3315,135,15,150,10,45,55,0,0,0,3,3,6
2013,3325,43,3,46,5,20,25,0,0,0,0,0,0
2013,3342,77,8,85,3,38,41,0,0,0,0,0,0
2013,3344,22,1,23,0,6,6,0,0,0,0,0,0
2013,3397,27,2,29,2,11,13,0,0,0,0,0,0
2013,3400,524,104,628,120,210,330,437,112,549,101,242,343
2013,3401,58,7,65,1,25,26,0,0,0,0,0,0
2013,3402,29,2,31,1,10,11,0,0,0,0,0,0
2013,3404,501,111,612,84,184,268,0,0,0,0,0,0
2013,3408,21,2,23,5,8,13,0,0,0,0,0,0
2013,3414,18,2,20,2,3,5,0,0,0,0,0,0
2013,3420,2,0,2,3,1,4,0,0,0,0,0,0
2013,3422,431,115,546,9,39,48,0,0,0,0,0,0
2013,3477,83,9,92,13,16,29,0,0,0,0,0,0
2013,3496,76,13,89,8,36,44,0,0,0,0,0,0
2013,3499,6724,512,7236,1454,1933,3387,0,0,0,0,0,0
2013,3500,16,1,17,0,3,3,0,0,0,10,9,19
2013,3501,21,3,24,0,5,5,0,0,0,0,0,0
2013,3600,1055,155,1210,253,606,859,437,95,532,182,445,627
2013,3601,35,1,36,0,17,17,0,0,0,0,0,0
2013,3602,87,5,92,3,47,50,0,0,0,0,0,0
2013,3603,43,1,44,5,20,25,0,0,0,0,0,0
2013,3604,151,18,169,16,76,92,0,0,0,0,0,0
2013,3605,44,6,50,0,18,18,0,0,0,0,0,0
2013,3607,221,9,230,22,88,110,0,0,0,0,0,0
2013,3608,68,11,79,8,28,36,0,0,0,0,0,0
2013,3609,83,11,94,4,32,36,0,0,0,0,0,0
2013,3610,224,22,246,37,117,154,0,0,0,0,0,0
2013,3611,66,2,68,2,17,19,0,0,0,0,0,0
2013,3614,10,4,14,4,7,11,0,0,0,0,0,0
2013,3623,21,1,22,34,21,55,0,0,0,0,0,0
2013,3639,7,1,8,4,2,6,0,0,0,0,0,0
2013,3650,13,4,17,29,18,47,0,0,0,0,0,0
2013,3657,43,10,53,6,11,17,0,0,0,0,0,0
2013,3700,1132,175,1307,339,524,863,843,211,1054,294,436,730
2013,3701,99,13,112,8,39,47,0,0,0,0,0,0
2013,3702,179,23,202,13,64,77,0,0,0,5,5,10
2013,3703,35,6,41,1,18,19,0,0,0,0,0,0
2013,3705,110,9,119,13,52,65,0,0,0,0,0,0
2013,3706,134,16,150,7,41,48,0,0,0,0,0,0
2013,3708,60,6,66,2,25,27,0,0,0,0,0,0
2013,3709,74,5,79,2,25,27,0,0,0,0,0,0
2013,3710,181,19,200,13,67,80,0,0,0,0,0,0
2013,3711,1589,286,1875,220,416,636,0,0,0,0,0,0
2013,3714,22,1,23,7,17,24,0,0,0,0,0,0
2013,3715,107,17,124,8,19,27,0,0,0,0,0,0
2013,3732,13,1,14,6,10,16,0,0,0,0,0,0
2013,3797,28,5,33,17,15,32,0,0,0,0,0,0
2013,3800,256,53,309,54,84,138,451,81,532,27,6,33
2013,3801,1814,336,2150,183,244,427,0,0,0,0,0,0
2013,3803,26,3,29,16,9,25,0,0,0,0,0,0
2013,3816,10,2,12,0,0,0,0,0,0,0,0,0
2013,3897,43,4,47,56,14,70,0,0,0,0,0,0
2013,3900,228,20,248,36,111,147,26,2,28,177,100,277
2013,3901,8,0,8,0,1,1,0,0,0,0,0,0
2013,3902,66,4,70,0,11,11,0,0,0,3,16,19
2013,3903,57,4,61,6,17,23,0,0,0,0,0,0
2013,3904,20,3,23,1,8,9,0,0,0,0,0,0
2013,3905,316,35,351,45,128,173,0,0,0,0,0,0
2013,3906,74,6,80,6,30,36,0,0,0,0,0,0
2013,3915,17,4,21,0,6,6,0,0,0,0,0,0
2013,4000,150,3,153,11,51,62,0,0,0,102,64,166
2013,4001,23,1,24,2,8,10,0,0,0,0,0,0
2013,4002,15,1,16,3,5,8,0,0,0,0,0,0
2013,4003,11,6,17,0,5,5,0,0,0,0,0,0
2013,4004,32,1,33,1,12,13,0,0,0,0,0,0
2013,4005,20,3,23,0,11,11,0,0,0,0,0,0
2013,4006,49,10,59,1,23,24,0,0,0,0,0,0
2013,4007,15,0,15,4,13,17,0,0,0,0,0,0
2013,4008,25,3,28,1,8,9,0,0,0,0,0,0
2013,4016,92,26,118,0,14,14,0,0,0,0,0,0
2013,4019,6,0,6,2,3,5,0,0,0,0,0,0
2013,4100,222,21,243,52,83,135,67,10,77,106,58,164
2013,4101,17,1,18,1,5,6,0,0,0,0,0,0
2013,4102,29,3,32,6,7,13,0,0,0,0,0,0
2013,4103,8,3,11,0,2,2,0,0,0,0,0,0
2013,4104,34,3,37,4,14,18,0,0,0,0,0,0
2013,4105,16,1,17,0,6,6,0,0,0,0,0,0
2013,4106,92,12,104,12,30,42,0,0,0,0,0,0
2013,4108,21,2,23,2,5,7,0,0,0,0,0,0
2013,4109,39,7,46,6,14,20,0,0,0,0,0,0
2013,4111,30,3,33,1,3,4,0,0,0,0,0,0
2013,4113,83,11,94,3,26,29,0,0,0,0,0,0
2013,4114,40,5,45,3,13,16,0,0,0,0,0,0
2013,4116,93,14,107,8,28,36,0,0,0,0,0,0
2013,4117,72,8,80,8,24,32,0,0,0,0,0,0
2013,4119,8,2,10,0,1,1,0,0,0,0,0,0
2013,4120,32,4,36,3,9,12,0,0,0,0,0,0
2013,4127,28,4,32,5,8,13,0,0,0,0,0,0
2013,4200,233,14,247,31,85,116,147,35,182,30,31,61
2013,4201,11,0,11,0,2,2,0,0,0,0,0,0
2013,4202,44,2,46,2,15,17,0,0,0,5,0,5
2013,4203,119,21,140,20,47,67,0,0,0,0,0,0
2013,4204,87,7,94,7,42,49,0,0,0,0,0,0
2013,4211,4,0,4,4,3,7,0,0,0,0,0,0
2013,4297,30,2,32,8,8,16,0,0,0,0,0,0
2013,4300,394,67,461,74,120,194,523,131,654,122,141,263
2013,4302,38,3,41,2,22,24,0,0,0,0,0,0
2013,4304,53,5,58,3,22,25,0,0,0,2,2,4
2013,4305,24,4,28,3,12,15,0,0,0,0,0,0
2013,4307,36,2,38,5,13,18,0,0,0,0,0,0
2013,4308,69,9,78,4,18,22,0,0,0,0,0,0
2013,4310,31,4,35,2,15,17,0,0,0,0,0,0
2013,4311,85,8,93,10,38,48,0,0,0,0,0,0
2013,4312,76,11,87,26,31,57,0,0,0,0,0,0
2013,4313,978,99,1077,80,267,347,0,0,0,0,0,0
2013,4314,123,10,133,13,44,57,0,0,0,3,2,5
2013,4316,180,16,196,20,54,74,0,0,0,0,0,0
2013,4317,26,4,30,22,17,39,0,0,0,0,0,0
2013,4320,3,0,3,5,2,7,0,0,0,0,0,0
2013,4321,9,0,9,4,2,6,0,0,0,0,0,0
2013,4327,10,0,10,4,2,6,0,0,0,0,0,0
2013,4400,109,16,125,6,36,42,9,1,10,87,40,127
2013,4401,20,1,21,5,3,8,0,0,0,0,0,0
2013,4402,81,7,88,4,17,21,0,0,0,0,0,0
2013,4403,63,3,66,4,11,15,0,0,0,0,0,0
2013,4404,20,0,20,2,5,7,0,0,0,0,0,0
2013,4497,10,3,13,0,10,10,0,0,0,0,0,0
2013,4500,75,6,81,9,35,44,49,12,61,14,20,34
2013,4501,13,2,15,1,5,6,0,0,0,0,0,0
2013,4502,91,7,98,8,24,32,0,0,0,0,0,0
2013,4591,14,4,18,1,3,4,0,0,0,0,0,0
2013,4600,9,1,10,0,0,0,0,0,0,4,2,6
2013,4700,47,1,48,6,9,15,21,5,26,2,2,4
2013,4703,2,0,2,1,0,1,0,0,0,0,0,0
2013,4706,7,0,7,0,3,3,0,0,0,0,0,0
2013,4707,1,1,2,0,0,0,0,0,0,0,0,0
2013,4708,9,0,9,1,4,5,0,0,0,0,0,0
2013,4709,14,0,14,3,3,6,0,0,0,0,0,0
2013,4710,3,0,3,0,1,1,0,0,0,0,0,0
2013,4800,101,7,108,16,48,64,1,0,1,178,67,245
2013,4801,31,2,33,1,13,14,0,0,0,0,0,0
2013,4802,21,1,22,0,5,5,0,0,0,0,0,0
2013,4803,103,8,111,12,49,61,0,0,0,0,0,0
2013,4804,9,2,11,0,1,1,0,0,0,0,0,0
2013,4805,17,4,21,0,11,11,0,0,0,0,0,0
2013,4806,82,10,92,2,52,54,0,0,0,0,0,0
2013,4807,77,5,82,6,21,27,0,0,0,0,0,0
2013,4813,0,1,1,0,1,1,0,0,0,0,0,0
2013,4900,213,15,228,24,69,93,0,0,0,187,73,260
2013,4901,11,2,13,0,7,7,0,0,0,0,0,0
2013,4902,9,1,10,0,6,6,0,0,0,0,0,0
2013,4903,12,3,15,0,8,8,0,0,0,0,0,0
2013,4904,46,3,49,1,19,20,0,0,0,0,0,0
2013,4905,146,15,161,12,58,70,0,0,0,0,0,0
2013,4906,13,1,14,1,4,5,0,0,0,0,0,0
2013,4908,56,5,61,1,19,20,0,0,0,0,0,0
2013,4909,9,3,12,3,6,9,0,0,0,0,0,0
2013,4914,13,0,13,4,8,12,0,0,0,0,0,0
2013,5000,175,13,188,17,68,85,189,25,214,9,39,48
2013,5001,48,3,51,2,13,15,0,0,0,0,0,0
2013,5002,204,13,217,9,66,75,0,0,0,0,0,0
2013,5003,11,1,12,0,3,3,0,0,0,0,0,0
2013,5004,18,1,19,1,7,8,0,0,0,0,0,0
2013,5007,65,8,73,1,34,35,0,0,0,0,0,0
2013,5010,8,3,11,3,6,9,0,0,0,0,0,0
2013,5100,48,3,51,3,17,20,40,14,54,0,3,3
2013,5102,52,6,58,3,20,23,0,0,0,0,0,0
2013,5200,34,3,37,9,18,27,33,11,44,2,4,6
2013,5201,12,2,14,3,5,8,0,0,0,0,0,0
2013,5202,23,1,24,1,8,9,0,0,0,0,0,0
2013,5300,17,1,18,1,4,5,10,4,14,1,2,3
2013,5400,240,34,274,24,72,96,214,44,258,46,55,101
2013,5401,31,4,35,3,7,10,0,0,0,0,0,0
2013,5402,14,4,18,0,2,2,0,0,0,0,0,0
2013,5403,14,0,14,0,1,1,0,0,0,0,0,0
2013,5404,18,1,19,0,3,3,0,0,0,0,0,0
2013,5405,53,8,61,10,19,29,0,0,0,0,0,0
2013,5406,66,8,74,12,24,36,0,0,0,0,0,0
2013,5407,121,14,135,9,57,66,0,0,0,0,0,0
2013,5408,9,0,9,1,0,1,0,0,0,0,0,0
2013,5411,4,3,7,0,1,1,0,0,0,0,0,0
2013,5500,57,4,61,1,20,21,0,0,0,26,17,43
2013,5501,13,0,13,0,7,7,0,0,0,0,0,0
2013,5600,480,59,539,79,198,277,192,26,218,105,88,193
2013,5604,200,27,227,48,96,144,0,0,0,5,2,7
2013,5605,19,3,22,4,4,8,0,0,0,0,0,0
2013,5606,27,0,27,4,5,9,0,0,0,0,0,0
2013,5608,121,9,130,6,31,37,0,0,0,0,0,0
2013,5609,114,8,122,13,38,51,0,0,0,0,0,0
2013,5622,14,1,15,4,7,11,0,0,0,0,0,0
2013,5680,13,1,14,0,1,1,0,0,0,0,0,0
2013,5700,68,10,78,7,27,34,5,1,6,74,50,124
2013,5701,53,5,58,7,26,33,0,0,0,0,0,0
2013,5702,8,0,8,0,2,2,0,0,0,0,0,0
2013,5703,50,8,58,1,14,15,0,0,0,0,0,0
2013,5704,58,7,65,3,20,23,0,0,0,0,0,0
2013,5797,37,8,45,27,17,44,0,0,0,0,0,0
2013,5800,58,2,60,0,22,22,43,21,64,9,10,19
2013,5801,17,1,18,3,7,10,0,0,0,0,0,0
2013,5802,6,2,8,0,1,1,0,0,0,0,0,0
2013,10M1,186,34,220,5,10,15,0,0,0,0,0,0
2013,190C,23,2,25,4,4,8,0,0,0,0,0,0
2013,190R,10,0,10,2,4,6,0,0,0,0,0,0
2013,340H,109,14,123,19,56,75,0,0,0,0,0,0
2014,100,516,63,579,94,223,317,323,54,377,98,135,233
2014,101,74,10,84,4,27,31,0,0,0,0,0,0
2014,102,24,0,24,1,5,6,0,0,0,0,0,0
2014,103,133,34,167,18,58,76,1,0,1,4,9,13
2014,104,34,1,35,3,12,15,0,0,0,0,0,0
2014,105,161,19,180,10,69,79,1,0,1,8,8,16
2014,106,158,17,175,29,66,95,0,0,0,14,5,19
2014,107,77,8,85,9,33,42,0,0,0,0,0,0
2014,108,49,7,56,6,15,21,0,0,0,0,0,0
2014,109,632,83,715,115,264,379,0,0,0,0,0,0
2014,110,16,4,20,1,8,9,0,0,0,0,0,0
2014,111,73,8,81,4,28,32,0,0,0,0,0,0
2014,112,87,6,93,9,34,43,0,0,0,0,0,0
2014,113,62,9,71,5,19,24,0,0,0,0,0,0
2014,114,52,4,56,4,20,24,0,0,0,0,0,0
2014,115,11,3,14,4,4,8,0,0,0,0,0,0
2014,197,52,17,69,52,34,86,0,0,0,0,0,0
2014,200,11,0,11,0,3,3,0,0,0,0,0,0
2014,300,45,1,46,2,16,18,1,0,1,15,13,28
2014,302,7,0,7,0,0,0,0,0,0,0,0,0
2014,303,7,2,9,0,1,1,0,0,0,0,0,0
2014,305,5,0,5,0,0,0,0,0,0,0,0,0
2014,400,106,2,108,17,40,57,1,0,1,84,46,130
2014,402,72,4,76,3,35,38,0,0,0,6,3,9
2014,403,15,1,16,0,5,5,0,0,0,0,0,0
2014,404,19,1,20,1,12,13,0,0,0,0,0,0
2014,405,16,2,18,2,8,10,0,0,0,0,0,0
2014,497,13,3,16,2,9,11,0,0,0,0,0,0
2014,500,41,4,45,4,16,20,2,1,3,15,9,24
2014,501,7,0,7,0,1,1,0,0,0,0,0,0
2014,600,29,3,32,1,19,20,2,0,2,6,7,13
2014,601,7,1,8,0,1,1,0,0,0,0,0,0
2014,602,10,2,12,0,2,2,0,0,0,0,0,0
2014,700,271,39,310,45,150,195,276,53,329,44,62,106
2014,701,80,8,88,1,22,23,0,0,0,2,1,3
2014,702,53,3,56,3,14,17,0,0,0,0,0,0
2014,703,11,0,11,0,2,2,0,0,0,0,0,0
2014,704,131,20,151,7,46,53,0,0,0,3,1,4
2014,705,39,3,42,2,5,7,0,0,0,0,0,0
2014,706,21,0,21,0,3,3,0,0,0,0,0,0
2014,707,23,2,25,1,11,12,0,0,0,0,0,0
2014,708,64,9,73,2,16,18,0,0,0,0,0,0
2014,709,34,6,40,5,10,15,0,0,0,0,0,0
2014,710,156,23,179,34,54,88,1,0,1,1,5,6
2014,711,46,3,49,4,16,20,0,0,0,1,1,2
2014,712,68,16,84,7,23,30,0,0,0,0,0,0
2014,713,9,1,10,0,0,0,0,0,0,0,0,0
2014,714,33,1,34,0,13,13,0,0,0,0,0,0
2014,716,11,1,12,0,1,1,0,0,0,0,0,0
2014,718,167,20,187,52,41,93,0,0,0,0,0,0
2014,721,19,2,21,6,5,11,0,0,0,0,0,0
2014,724,56,5,61,5,11,16,0,0,0,0,0,0
2014,800,24,0,24,4,6,10,1,0,1,12,6,18
2014,801,10,2,12,0,1,1,0,0,0,0,0,0
2014,900,134,7,141,18,50,68,13,1,14,73,45,118
2014,901,15,2,17,0,7,7,0,0,0,0,0,0
2014,902,30,3,33,4,15,19,0,0,0,0,0,0
2014,1000,348,37,385,48,122,170,12,1,13,312,129,441
2014,1001,82,13,95,12,46,58,0,0,0,0,0,0
2014,1002,18,1,19,3,7,10,0,0,0,0,0,0
2014,1003,9,2,11,0,4,4,0,0,0,0,0,0
2014,1004,11,0,11,0,1,1,0,0,0,0,0,0
2014,1005,620,88,708,72,167,239,0,0,0,0,0,0
2014,1006,4,0,4,0,2,2,0,0,0,0,0,0
2014,1007,14,4,18,1,2,3,0,0,0,0,0,0
2014,1008,11,0,11,1,5,6,0,0,0,0,0,0
2014,1009,11,0,11,0,2,2,0,0,0,0,0,0
2014,1010,10,1,11,0,1,1,0,0,0,0,0,0
2014,1011,8,0,8,0,1,1,0,0,0,0,0,0
2014,1012,25,2,27,1,13,14,0,0,0,0,0,0
2014,1013,25,1,26,3,1,4,0,0,0,0,0,0
2014,1015,26,3,29,1,9,10,0,0,0,0,0,0
2014,1017,13,1,14,1,3,4,0,0,0,0,0,0
2014,1097,18,2,20,1,10,11,0,0,0,0,0,0
2014,1100,21,2,23,3,9,12,2,0,2,11,12,23
2014,1101,10,0,10,0,2,2,0,0,0,0,0,0
2014,1102,6,2,8,0,1,1,0,0,0,0,0,0
2014,1200,71,8,79,8,27,35,71,25,96,4,5,9
2014,1201,22,4,26,1,11,12,0,0,0,0,0,0
2014,1203,46,4,50,5,25,30,0,0,0,0,0,0
2014,1204,5,0,5,0,0,0,0,0,0,0,0,0
2014,1205,13,1,14,1,7,8,0,0,0,0,0,0
2014,1207,5,0,5,0,0,0,0,0,0,0,0,0
2014,1208,8,4,12,1,4,5,0,0,0,0,0,0
2014,1300,99,4,103,9,53,62,67,20,87,11,21,32
2014,1301,24,2,26,4,10,14,0,0,0,0,0,0
2014,1302,35,2,37,6,12,18,0,0,0,0,0,0
2014,1303,3,0,3,0,0,0,0,0,0,0,0,0
2014,1304,43,2,45,5,16,21,0,0,0,0,0,0
2014,1306,14,2,16,2,1,3,0,0,0,0,0,0
2014,1307,5,0,5,0,0,0,0,0,0,0,0,0
2014,1400,23,1,24,3,9,12,11,0,11,11,10,21
2014,1401,12,0,12,1,5,6,0,0,0,0,0,0
2014,1500,380,23,403,41,186,227,373,110,483,22,56,78
2014,1501,19,1,20,3,4,7,0,0,0,0,0,0
2014,1502,344,26,370,34,113,147,0,0,0,0,0,0
2014,1503,46,1,47,13,12,25,0,0,0,0,0,0
2014,1505,14,0,14,0,3,3,0,0,0,0,0,0
2014,1506,30,2,32,5,11,16,0,0,0,0,0,0
2014,1507,19,2,21,3,6,9,0,0,0,0,0,0
2014,1508,13,2,15,0,8,8,34,23,57,0,0,0
2014,1509,14,2,16,0,2,2,0,0,0,0,0,0
2014,1511,20,1,21,2,9,11,0,0,0,0,0,0
2014,1514,3,0,3,0,0,0,0,0,0,0,0,0
2014,1515,6,1,7,2,8,10,0,0,0,1,0,1
2014,1597,9,2,11,1,5,6,0,0,0,0,0,0
2014,1600,71,5,76,2,44,46,0,0,0,82,63,145
2014,1601,18,2,20,3,8,11,0,0,0,0,0,0
2014,1602,47,3,50,1,25,26,0,0,0,0,0,0
2014,1603,27,2,29,2,5,7,0,0,0,0,0,0
2014,1607,12,4,16,0,2,2,0,0,0,0,0,0
2014,1700,45,5,50,2,17,19,0,0,0,41,24,65
2014,1701,9,1,10,0,1,1,0,0,0,0,0,0
2014,1702,19,1,20,1,6,7,0,0,0,0,0,0
2014,1800,27,1,28,4,8,12,20,13,33,3,6,9
2014,1801,15,1,16,1,1,2,0,0,0,0,0,0
2014,1900,5649,1167,6816,1646,2555,4201,1912,492,2404,1290,2048,3338
2014,1901,75,7,82,6,38,44,0,0,0,0,0,0
2014,1902,64,2,66,2,23,25,0,0,0,1,3,4
2014,1905,52,7,59,4,22,26,0,0,0,4,4,8
2014,1906,60,5,65,0,19,19,0,0,0,5,2,7
2014,1907,23,2,25,3,8,11,0,0,0,0,0,0
2014,1909,48,3,51,6,10,16,0,0,0,0,0,0
2014,1910,102,11,113,12,45,57,0,0,0,1,0,1
2014,1912,131,15,146,15,55,70,0,0,0,4,5,9
2014,1913,29,5,34,5,16,21,0,0,0,3,2,5
2014,1916,54,1,55,5,20,25,0,0,0,2,2,4
2014,1918,83,5,88,29,25,54,0,0,0,2,1,3
2014,1920,92,16,108,8,30,38,0,0,0,0,0,0
2014,1922,106,8,114,9,24,33,0,0,0,6,1,7
2014,1923,56,4,60,0,8,8,0,0,0,5,2,7
2014,1924,84,8,92,2,18,20,0,0,0,4,4,8
2014,1925,217,27,244,21,64,85,0,0,0,13,7,20
2014,1926,45,4,49,5,22,27,0,0,0,2,3,5
2014,1928,89,7,96,2,20,22,1,0,1,6,6,12
2014,1929,29,5,34,11,5,16,0,0,0,0,9,9
2014,1931,57,4,61,11,20,31,0,0,0,4,2,6
2014,1933,144,18,162,6,55,61,0,0,0,0,7,7
2014,1934,24,1,25,0,8,8,0,0,0,0,0,0
2014,1938,34,4,38,5,16,21,0,0,0,0,0,0
2014,1941,700,75,775,75,188,263,10,1,11,39,17,56
2014,1942,7930,1861,9791,911,1641,2552,96,20,116,204,111,315
2014,1944,50,13,63,11,23,34,0,0,0,3,4,7
2014,1946,41,5,46,4,20,24,0,0,0,1,3,4
2014,1947,65,7,72,3,23,26,0,0,0,4,2,6
2014,1948,59,10,69,4,19,23,0,0,0,2,3,5
2014,1951,21,2,23,1,5,6,0,0,0,2,4,6
2014,1953,192,34,226,23,59,82,0,0,0,11,10,21
2014,1955,147,10,157,20,64,84,0,0,0,8,8,16
2014,1956,82,8,90,11,35,46,0,0,0,3,4,7
2014,1961,26,2,28,0,4,4,0,0,0,4,3,7
2014,1962,49,2,51,2,12,14,0,0,0,0,0,0
2014,1963,21,7,28,0,7,7,0,0,0,0,0,0
2014,1965,181,20,201,80,83,163,0,1,1,10,6,16
2014,1966,12,2,14,1,3,4,0,0,0,0,0,0
2014,1967,32,3,35,0,0,0,0,0,0,2,4,6
2014,1969,71,5,76,4,26,30,0,0,0,4,2,6
2014,1970,31,1,32,3,13,16,0,0,0,0,0,0
2014,1972,193,16,209,27,78,105,1,0,1,6,9,15
2014,1973,37,2,39,1,10,11,0,0,0,0,0,0
2014,1975,82,4,86,8,42,50,0,0,0,3,3,6
2014,1976,110,10,120,14,35,49,0,0,0,0,0,0
2014,1978,14,2,16,1,7,8,0,0,0,0,0,0
2014,1981,18,2,20,4,3,7,0,0,0,0,0,0
2014,1982,21,1,22,13,9,22,0,0,0,0,0,0
2014,1983,14,2,16,9,6,15,0,0,0,0,0,0
2014,1984,18,5,23,7,6,13,0,0,0,0,0,0
2014,1997,49,5,54,18,22,40,0,0,0,0,0,0
2014,2000,72,3,75,3,31,34,0,0,0,0,0,0
2014,2001,16,1,17,2,5,7,0,0,0,0,0,0
2014,2002,47,4,51,2,16,18,0,0,0,0,0,0
2014,2100,100,17,117,17,56,73,53,17,70,7,15,22
2014,2101,5,2,7,0,1,1,0,0,0,0,0,0
2014,2103,10,1,11,2,3,5,0,0,0,0,0,0
2014,2105,18,2,20,0,6,6,0,0,0,0,0,0
2014,2106,43,9,52,7,18,25,0,0,0,0,0,0
2014,2107,8,0,8,0,0,0,0,0,0,0,0,0
2014,2109,54,9,63,3,17,20,0,0,0,0,0,0
2014,2110,16,2,18,0,5,5,0,0,0,0,0,0
2014,2111,12,1,13,0,3,3,0,0,0,0,0,0
2014,2113,7,0,7,1,0,1,0,0,0,0,0,0
2014,2117,38,6,44,0,13,13,0,0,0,0,0,0
2014,2200,36,3,39,3,11,14,10,9,19,0,0,0
2014,2300,67,3,70,9,24,33,42,14,56,1,8,9
2014,2301,14,1,15,1,5,6,0,0,0,0,0,0
2014,2303,28,2,30,4,13,17,0,0,0,0,0,0
2014,2304,11,1,12,2,5,7,0,0,0,0,0,0
2014,2400,92,3,95,6,26,32,2,0,2,61,31,92
2014,2401,28,1,29,2,7,9,0,0,0,0,0,0
2014,2402,6,2,8,0,1,1,0,0,0,0,0,0
2014,2403,9,1,10,0,2,2,0,0,0,0,0,0
2014,2404,17,0,17,0,8,8,0,0,0,0,0,0
2014,2405,37,3,40,2,14,16,0,0,0,4,1,5
2014,2406,81,3,84,7,25,32,0,0,0,0,0,0
2014,2412,8,4,12,2,10,12,0,0,0,0,0,0
2014,2500,13,0,13,2,6,8,0,0,0,0,0,0
2014,2501,8,0,8,0,1,1,0,0,0,0,0,0
2014,2600,26,0,26,2,2,4,0,0,0,11,8,19
2014,2601,11,0,11,0,3,3,0,0,0,0,0,0
2014,2700,138,13,151,9,52,61,113,36,149,18,35,53
2014,2701,13,1,14,1,6,7,0,0,0,0,0,0
2014,2702,6,0,6,0,0,0,0,0,0,0,0,0
2014,2703,10,1,11,1,2,3,0,0,0,0,0,0
2014,2704,12,2,14,0,2,2,0,0,0,0,0,0
2014,2705,10,1,11,0,2,2,0,0,0,0,0,0
2014,2706,41,3,44,1,4,5,0,0,0,5,5,10
2014,2707,7,7,14,3,5,8,0,0,0,0,0,0
2014,2708,127,8,135,10,36,46,0,0,0,0,0,0
2014,2709,7,1,8,0,1,1,0,0,0,0,0,0
2014,2710,31,3,34,2,8,10,0,0,0,0,0,0
2014,2711,14,0,14,1,2,3,0,0,0,0,0,0
2014,2712,27,2,29,1,6,7,0,0,0,0,0,0
2014,2714,6,0,6,0,0,0,0,0,0,0,0,0
2014,2719,9,4,13,1,5,6,0,0,0,0,0,0
2014,2800,105,6,111,9,21,30,1,0,1,0,0,0
2014,2801,7,3,10,1,3,4,0,0,0,0,0,0
2014,2802,63,7,70,9,38,47,0,0,0,0,0,0
2014,2803,11,1,12,0,5,5,0,0,0,0,0,0
2014,2808,104,5,109,2,8,10,0,0,0,0,0,0
2014,2900,47,2,49,6,23,29,9,1,10,33,32,65
2014,2901,22,1,23,0,3,3,0,0,0,0,0,0
2014,2902,10,0,10,0,1,1,0,0,0,0,0,0
2014,2908,22,2,24,5,7,12,0,0,0,0,0,0
2014,3000,946,117,1063,604,660,1264,673,92,765,310,199,509
2014,3001,323,33,356,48,121,169,11,7,18,0,7,7
2014,3002,55,4,59,3,30,33,0,0,0,0,0,0
2014,3003,73,5,78,7,31,38,0,0,0,0,0,0
2014,3004,99,13,112,14,54,68,0,1,1,2,2,4
2014,3005,48,5,53,2,10,12,0,0,0,4,0,4
2014,3006,21,1,22,0,8,8,0,0,0,0,0,0
2014,3007,52,5,57,1,18,19,0,0,0,0,0,0
2014,3008,124,13,137,6,53,59,0,0,0,3,1,4
2014,3009,146,6,152,14,48,62,0,0,0,0,0,0
2014,3010,195,12,207,19,77,96,0,0,0,12,6,18
2014,3011,41,4,45,7,30,37,0,0,0,0,0,0
2014,3012,64,2,66,6,29,35,0,0,0,0,0,0
2014,3013,16,6,22,0,4,4,0,0,0,0,0,0
2014,3014,130,9,139,23,48,71,0,0,0,5,2,7
2014,3015,137,13,150,13,46,59,0,0,0,0,0,0
2014,3016,43,2,45,5,14,19,0,0,0,0,0,0
2014,3019,241,23,264,33,100,133,0,0,0,49,50,99
2014,3020,29,2,31,6,3,9,0,0,0,2,3,5
2014,3022,83,9,92,10,39,49,0,0,0,0,0,0
2014,3024,80,9,89,2,29,31,0,0,0,2,1,3
2014,3026,162,38,200,23,66,89,0,0,0,0,0,0
2014,3027,23,4,27,4,7,11,0,0,0,0,0,0
2014,3097,28,2,30,7,8,15,0,0,0,0,0,0
2014,3100,161,11,172,22,69,91,56,8,64,80,58,138
2014,3101,19,1,20,2,5,7,0,0,0,0,0,0
2014,3103,19,0,19,2,6,8,0,0,0,0,0,0
2014,3104,47,5,52,3,25,28,0,0,0,0,0,0
2014,3105,112,7,119,11,46,57,0,0,0,3,5,8
2014,3200,29,2,31,1,10,11,1,0,1,10,8,18
2014,3300,1460,151,1611,222,681,903,350,48,398,738,370,1108
2014,3301,22,3,25,1,14,15,0,0,0,0,0,0
2014,3302,40,1,41,1,15,16,0,0,0,0,0,0
2014,3303,19,0,19,5,5,10,0,0,0,0,0,0
2014,3306,21,3,24,3,1,4,0,0,0,0,0,0
2014,3308,56,3,59,3,21,24,0,0,0,0,0,0
2014,3309,60,4,64,8,27,35,0,0,0,0,0,0
2014,3311,74,9,83,5,32,37,0,0,0,0,0,0
2014,3313,324,40,364,34,122,156,0,0,0,0,0,0
2014,3315,139,15,154,5,51,56,0,0,0,2,2,4
2014,3325,45,2,47,5,16,21,0,0,0,0,0,0
2014,3342,76,7,83,3,36,39,0,0,0,0,0,0
2014,3344,17,1,18,1,4,5,0,0,0,0,0,0
2014,3397,26,2,28,3,10,13,0,0,0,0,0,0
2014,3400,536,103,639,123,227,350,461,113,574,106,231,337
2014,3401,60,9,69,4,20,24,0,0,0,0,0,0
2014,3402,34,4,38,1,10,11,0,0,0,0,0,0
2014,3404,513,110,623,104,194,298,0,0,0,0,0,0
2014,3408,20,2,22,6,9,15,0,0,0,0,0,0
2014,3414,20,3,23,2,3,5,0,0,0,0,0,0
2014,3420,2,0,2,3,1,4,0,0,0,0,0,0
2014,3422,428,108,536,5,37,42,0,0,0,0,0,0
2014,3477,76,9,85,12,12,24,0,0,0,0,0,0
2014,3496,76,14,90,8,35,43,0,0,0,0,0,0
2014,3499,6775,500,7275,1399,1877,3276,0,0,0,0,0,0
2014,3500,18,0,18,0,4,4,0,0,0,11,9,20
2014,3501,22,3,25,0,6,6,0,0,0,0,0,0
2014,3600,1080,160,1240,257,603,860,473,96,569,190,451,641
2014,3601,36,1,37,0,17,17,0,0,0,0,0,0
2014,3602,95,3,98,3,47,50,0,0,0,0,0,0
2014,3603,42,1,43,10,21,31,0,0,0,0,0,0
2014,3604,165,18,183,13,84,97,0,0,0,0,0,0
2014,3605,45,3,48,0,17,17,0,0,0,0,0,0
2014,3607,219,9,228,14,80,94,0,0,0,0,0,0
2014,3608,67,9,76,8,26,34,0,0,0,0,0,0
2014,3609,89,11,100,3,35,38,0,0,0,0,0,0
2014,3610,206,19,225,27,106,133,0,0,0,0,0,0
2014,3611,63,3,66,2,21,23,0,0,0,0,0,0
2014,3614,10,4,14,2,7,9,0,0,0,0,0,0
2014,3623,23,2,25,35,17,52,0,0,0,0,0,0
2014,3639,6,1,7,7,6,13,0,0,0,0,0,0
2014,3650,11,3,14,33,17,50,0,0,0,0,0,0
2014,3657,52,13,65,6,12,18,0,0,0,0,0,0
2014,3700,1109,159,1268,294,497,791,993,254,1247,330,487,817
2014,3701,96,14,110,11,37,48,0,0,0,0,0,0
2014,3702,184,28,212,7,67,74,0,0,0,6,6,12
2014,3703,38,5,43,2,18,20,0,0,0,0,0,0
2014,3705,114,8,122,11,54,65,0,0,0,0,0,0
2014,3706,137,16,153,6,46,52,0,0,0,0,0,0
2014,3708,62,4,66,3,24,27,0,0,0,0,0,0
2014,3709,77,6,83,4,25,29,0,0,0,0,0,0
2014,3710,184,19,203,13,61,74,0,0,0,0,0,0
2014,3711,1586,290,1876,228,416,644,0,0,0,0,0,0
2014,3714,23,5,28,4,16,20,0,0,0,0,0,0
2014,3715,105,16,121,9,19,28,0,0,0,0,0,0
2014,3732,14,1,15,5,11,16,0,0,0,0,0,0
2014,3797,29,6,35,18,13,31,0,0,0,0,0,0
2014,3800,264,54,318,52,82,134,431,78,509,24,5,29
2014,3801,1806,331,2137,195,256,451,0,0,0,0,0,0
2014,3803,26,3,29,14,12,26,0,0,0,0,0,0
2014,3816,8,1,9,0,0,0,0,0,0,0,0,0
2014,3897,46,6,52,55,17,72,0,0,0,0,0,0
2014,3900,243,19,262,35,111,146,26,2,28,186,99,285
2014,3901,10,0,10,0,1,1,0,0,0,0,0,0
2014,3902,66,4,70,0,11,11,0,0,0,3,16,19
2014,3903,59,4,63,5,17,22,0,0,0,0,0,0
2014,3904,22,1,23,1,7,8,0,0,0,0,0,0
2014,3905,337,34,371,45,136,181,0,0,0,0,0,0
2014,3906,77,7,84,6,33,39,0,0,0,0,0,0
2014,3915,16,4,20,1,6,7,0,0,0,0,0,0
2014,4000,146,5,151,8,54,62,0,0,0,108,58,166
2014,4001,24,1,25,1,2,3,0,0,0,0,0,0
2014,4002,14,2,16,3,6,9,0,0,0,0,0,0
2014,4003,12,5,17,0,2,2,0,0,0,0,0,0
2014,4004,32,1,33,0,13,13,0,0,0,0,0,0
2014,4005,18,3,21,0,9,9,0,0,0,0,0,0
2014,4006,51,8,59,2,21,23,0,0,0,0,0,0
2014,4007,16,1,17,5,13,18,0,0,0,0,0,0
2014,4008,24,3,27,1,9,10,0,0,0,0,0,0
2014,4016,92,25,117,0,12,12,0,0,0,0,0,0
2014,4019,6,0,6,2,4,6,0,0,0,0,0,0
2014,4100,230,20,250,47,84,131,172,40,212,10,35,45
2014,4101,20,1,21,1,5,6,0,0,0,0,0,0
2014,4102,27,2,29,6,7,13,0,0,0,0,0,0
2014,4103,10,3,13,0,2,2,0,0,0,0,0,0
2014,4104,33,3,36,4,15,19,0,0,0,0,0,0
2014,4105,17,2,19,0,6,6,0,0,0,0,0,0
2014,4106,98,13,111,11,28,39,0,0,0,0,0,0
2014,4108,21,2,23,2,5,7,0,0,0,0,0,0
2014,4109,40,6,46,7,14,21,0,0,0,0,0,0
2014,4111,30,3,33,1,3,4,0,0,0,0,0,0
2014,4113,84,11,95,3,19,22,0,0,0,0,0,0
2014,4114,41,5,46,3,13,16,0,0,0,0,0,0
2014,4116,92,14,106,6,28,34,0,0,0,0,0,0
2014,4117,68,9,77,8,22,30,0,0,0,0,0,0
2014,4119,8,1,9,0,1,1,0,0,0,0,0,0
2014,4120,30,4,34,2,11,13,0,0,0,0,0,0
2014,4127,28,5,33,2,7,9,0,0,0,0,0,0
2014,4200,252,13,265,23,82,105,147,34,181,28,33,61
2014,4201,10,1,11,0,1,1,0,0,0,0,0,0
2014,4202,45,2,47,1,16,17,0,0,0,4,1,5
2014,4203,121,23,144,15,47,62,0,0,0,0,0,0
2014,4204,104,6,110,3,43,46,0,0,0,0,0,0
2014,4211,4,1,5,4,3,7,0,0,0,0,0,0
2014,4297,30,4,34,8,8,16,0,0,0,0,0,0
2014,4300,419,71,490,64,127,191,542,134,676,111,148,259
2014,4302,35,4,39,2,20,22,0,0,0,0,0,0
2014,4304,53,5,58,5,25,30,0,0,0,2,2,4
2014,4305,24,5,29,3,12,15,0,0,0,0,0,0
2014,4307,38,2,40,4,16,20,0,0,0,0,0,0
2014,4308,72,9,81,4,20,24,0,0,0,0,0,0
2014,4310,34,4,38,4,15,19,0,0,0,0,0,0
2014,4311,84,8,92,9,33,42,0,0,0,0,0,0
2014,4312,77,12,89,22,37,59,0,0,0,0,0,0
2014,4313,875,91,966,132,279,411,0,0,0,0,0,0
2014,4314,129,12,141,12,45,57,0,0,0,3,2,5
2014,4316,190,15,205,18,58,76,0,0,0,0,0,0
2014,4317,24,4,28,26,16,42,0,0,0,0,0,0
2014,4320,2,1,3,1,2,3,0,0,0,0,0,0
2014,4321,9,0,9,5,1,6,0,0,0,0,0,0
2014,4327,9,0,9,4,1,5,0,0,0,0,0,0
2014,4400,109,16,125,6,36,42,9,1,10,87,40,127
2014,4401,20,1,21,6,3,9,0,0,0,0,0,0
2014,4402,80,12,92,4,14,18,0,0,0,0,0,0
2014,4403,58,3,61,7,15,22,0,0,0,0,0,0
2014,4404,20,0,20,2,6,8,0,0,0,0,0,0
2014,4497,14,3,17,2,11,13,0,0,0,0,0,0
2014,4500,76,10,86,8,35,43,43,16,59,12,17,29
2014,4501,12,3,15,1,5,6,0,0,0,0,0,0
2014,4502,89,7,96,7,24,31,0,0,0,0,0,0
2014,4591,18,1,19,1,4,5,0,0,0,0,0,0
2014,4600,10,0,10,0,0,0,0,0,0,4,1,5
2014,4700,48,1,49,7,9,16,23,7,30,2,3,5
2014,4703,2,0,2,1,0,1,0,0,0,0,0,0
2014,4706,7,1,8,0,3,3,0,0,0,0,0,0
2014,4707,1,0,1,0,0,0,0,0,0,0,0,0
2014,4708,9,0,9,1,4,5,0,0,0,0,0,0
2014,4709,13,0,13,1,5,6,0,0,0,0,0,0
2014,4710,3,0,3,0,0,0,0,0,0,0,0,0
2014,4800,106,9,115,22,55,77,1,0,1,187,77,264
2014,4801,29,3,32,0,15,15,0,0,0,0,0,0
2014,4802,20,2,22,0,5,5,0,0,0,0,0,0
2014,4803,104,8,112,13,49,62,0,0,0,0,0,0
2014,4804,9,2,11,0,1,1,0,0,0,0,0,0
2014,4805,18,4,22,0,10,10,0,0,0,0,0,0
2014,4806,84,10,94,2,50,52,0,0,0,0,0,0
2014,4807,95,6,101,5,28,33,0,0,0,0,0,0
2014,4900,213,15,228,25,74,99,0,0,0,188,97,285
2014,4901,11,1,12,0,7,7,0,0,0,0,0,0
2014,4902,10,1,11,0,5,5,0,0,0,0,0,0
2014,4903,13,3,16,0,8,8,0,0,0,0,0,0
2014,4904,50,4,54,1,19,20,0,0,0,0,0,0
2014,4905,151,15,166,15,57,72,0,0,0,0,0,0
2014,4906,14,0,14,1,4,5,0,0,0,0,0,0
2014,4908,53,4,57,2,19,21,0,0,0,0,0,0
2014,4909,10,3,13,7,6,13,0,0,0,0,0,0
2014,4914,13,0,13,5,7,12,0,0,0,0,0,0
2014,5000,178,6,184,25,80,105,199,26,225,10,40,50
2014,5001,44,3,47,3,12,15,0,0,0,0,0,0
2014,5002,194,13,207,8,65,73,0,0,0,0,0,0
2014,5003,10,1,11,0,3,3,0,0,0,0,0,0
2014,5004,18,1,19,1,9,10,0,0,0,0,0,0
2014,5007,64,6,70,4,32,36,0,0,0,0,0,0
2014,5010,9,2,11,3,5,8,0,0,0,0,0,0
2014,5100,47,3,50,3,18,21,44,14,58,0,3,3
2014,5102,52,5,57,3,21,24,0,0,0,0,0,0
2014,5200,39,4,43,6,14,20,30,10,40,3,9,12
2014,5201,11,2,13,3,4,7,0,0,0,0,0,0
2014,5202,22,1,23,2,8,10,0,0,0,0,0,0
2014,5300,17,1,18,0,4,4,8,7,15,0,3,3
2014,5400,239,31,270,28,83,111,222,44,266,45,57,102
2014,5401,32,3,35,3,6,9,0,0,0,0,0,0
2014,5402,14,4,18,0,2,2,0,0,0,0,0,0
2014,5403,12,1,13,0,1,1,0,0,0,0,0,0
2014,5404,17,1,18,1,3,4,0,0,0,0,0,0
2014,5405,55,7,62,10,19,29,0,0,0,0,0,0
2014,5406,65,8,73,13,24,37,0,0,0,0,0,0
2014,5407,125,14,139,9,58,67,0,0,0,0,0,0
2014,5408,11,0,11,0,1,1,0,0,0,0,0,0
2014,5411,4,2,6,0,1,1,0,0,0,0,0,0
2014,5500,57,4,61,1,20,21,0,0,0,27,17,44
2014,5501,12,1,13,0,6,6,0,0,0,0,0,0
2014,5600,479,53,532,80,204,284,177,38,215,105,95,200
2014,5604,212,29,241,31,91,122,0,0,0,3,3,6
2014,5605,18,3,21,3,5,8,0,0,0,0,0,0
2014,5606,30,0,30,4,6,10,0,0,0,0,0,0
2014,5608,118,9,127,4,31,35,0,0,0,0,0,0
2014,5609,109,9,118,13,37,50,0,0,0,0,0,0
2014,5622,14,0,14,4,8,12,0,0,0,0,0,0
2014,5680,13,1,14,0,1,1,0,0,0,0,0,0
2014,5700,72,9,81,7,30,37,6,1,7,77,52,129
2014,5701,55,4,59,6,27,33,0,0,0,0,0,0
2014,5702,9,0,9,0,2,2,0,0,0,0,0,0
2014,5703,52,9,61,0,14,14,0,0,0,0,0,0
2014,5704,58,7,65,3,18,21,0,0,0,0,0,0
2014,5797,37,8,45,27,17,44,0,0,0,0,0,0
2014,5800,55,3,58,0,23,23,45,22,67,9,11,20
2014,5801,16,0,16,4,5,9,0,0,0,0,0,0
2014,5802,6,0,6,0,1,1,0,0,0,0,0,0
2014,10M1,184,33,217,5,10,15,0,0,0,0,0,0
2014,190C,23,2,25,4,4,8,0,0,0,0,0,0
2014,190R,7,0,7,2,4,6,0,0,0,0,0,0
2014,340H,106,20,126,17,61,78,0,0,0,0,0,0
2015,100,521,67,588,123,227,350,335,55,390,98,134,232
2015,101,73,10,83,4,25,29,0,0,0,0,0,0
2015,102,23,0,23,1,6,7,0,0,0,0,0,0
2015,103,134,37,171,19,57,76,1,0,1,5,7,12
2015,104,32,2,34,3,12,15,0,0,0,0,0,0
2015,105,162,17,179,10,75,85,1,0,1,8,7,15
2015,106,156,18,174,25,70,95,0,0,0,13,6,19
2015,107,76,10,86,9,36,45,0,0,0,0,0,0
2015,108,48,7,55,6,15,21,0,0,0,0,0,0
2015,109,647,87,734,64,236,300,0,0,0,0,0,0
2015,110,14,5,19,1,7,8,0,0,0,0,0,0
2015,111,70,9,79,4,28,32,0,0,0,0,0,0
2015,112,84,7,91,9,34,43,0,0,0,0,0,0
2015,113,64,9,73,8,16,24,0,0,0,0,0,0
2015,114,53,6,59,3,19,22,0,0,0,0,0,0
2015,115,12,3,15,4,7,11,0,0,0,0,0,0
2015,197,50,15,65,56,30,86,0,0,0,0,0,0
2015,200,13,0,13,0,3,3,0,0,0,0,0,0
2015,300,52,2,54,3,14,17,1,0,1,14,14,28
2015,302,6,0,6,0,0,0,0,0,0,0,0,0
2015,303,7,2,9,0,1,1,0,0,0,0,0,0
2015,305,4,0,4,0,0,0,0,0,0,0,0,0
2015,400,99,1,100,17,40,57,1,0,1,84,46,130
2015,402,84,4,88,2,35,37,0,0,0,7,3,10
2015,403,13,1,14,0,4,4,0,0,0,0,0,0
2015,404,21,3,24,7,14,21,0,0,0,0,0,0
2015,405,17,2,19,3,9,12,0,0,0,0,0,0
2015,497,13,1,14,3,8,11,0,0,0,0,0,0
2015,500,38,4,42,4,17,21,3,0,3,15,11,26
2015,501,7,0,7,0,1,1,0,0,0,0,0,0
2015,600,22,3,25,1,18,19,3,0,3,7,5,12
2015,601,7,0,7,0,1,1,0,0,0,0,0,0
2015,602,8,2,10,0,2,2,0,0,0,0,0,0
2015,700,253,47,300,52,151,203,269,41,310,61,62,123
2015,701,84,6,90,1,23,24,0,1,1,0,0,0
2015,702,60,5,65,2,13,15,0,0,0,0,0,0
2015,703,10,0,10,0,1,1,0,0,0,0,0,0
2015,704,134,18,152,8,41,49,0,0,0,3,2,5
2015,705,37,3,40,2,6,8,0,0,0,0,0,0
2015,706,21,0,21,0,3,3,0,0,0,0,0,0
2015,707,23,0,23,1,11,12,0,0,0,0,0,0
2015,708,68,8,76,3,17,20,0,0,0,0,0,0
2015,709,36,4,40,5,10,15,0,0,0,0,0,0
2015,710,153,24,177,30,52,82,0,0,0,1,5,6
2015,711,45,3,48,3,12,15,0,0,0,1,1,2
2015,712,63,18,81,7,23,30,0,0,0,0,0,0
2015,713,9,1,10,0,0,0,0,0,0,0,0,0
2015,714,32,2,34,0,12,12,0,0,0,0,0,0
2015,716,11,1,12,0,1,1,0,0,0,0,0,0
2015,718,177,20,197,48,40,88,0,0,0,0,0,0
2015,721,18,3,21,6,7,13,0,0,0,0,0,0
2015,724,58,7,65,4,12,16,0,0,0,0,0,0
2015,800,24,0,24,4,6,10,1,0,1,12,6,18
2015,801,9,2,11,0,1,1,0,0,0,0,0,0
2015,900,142,6,148,16,51,67,15,1,16,78,40,118
2015,901,13,2,15,0,7,7,0,0,0,0,0,0
2015,902,31,4,35,2,14,16,0,0,0,0,0,0
2015,1000,358,39,397,53,125,178,8,1,9,326,133,459
2015,1001,82,14,96,13,46,59,0,0,0,0,0,0
2015,1002,19,1,20,2,9,11,0,0,0,0,0,0
2015,1003,10,1,11,0,4,4,0,0,0,0,0,0
2015,1004,12,0,12,0,1,1,0,0,0,0,0,0
2015,1005,625,77,702,81,176,257,0,0,0,0,0,0
2015,1006,4,0,4,0,2,2,0,0,0,0,0,0
2015,1007,16,3,19,1,2,3,0,0,0,0,0,0
2015,1008,13,0,13,1,5,6,0,0,0,0,0,0
2015,1009,13,1,14,0,2,2,0,0,0,0,0,0
2015,1010,10,1,11,0,1,1,0,0,0,0,0,0
2015,1011,11,1,12,0,1,1,0,0,0,0,0,0
2015,1012,25,2,27,1,14,15,0,0,0,0,0,0
2015,1013,25,3,28,3,1,4,0,0,0,0,0,0
2015,1015,30,3,33,1,8,9,0,0,0,0,0,0
2015,1017,11,1,12,13,8,21,0,0,0,0,0,0
2015,1097,18,2,20,1,10,11,0,0,0,0,0,0
2015,1100,18,1,19,2,14,16,1,0,1,10,10,20
2015,1101,11,2,13,0,0,0,0,0,0,0,0,0
2015,1102,7,1,8,0,1,1,0,0,0,0,0,0
2015,1200,74,12,86,7,30,37,70,21,91,4,6,10
2015,1201,21,4,25,1,9,10,0,0,0,0,0,0
2015,1203,44,4,48,2,21,23,0,0,0,0,0,0
2015,1204,5,0,5,0,0,0,0,0,0,0,0,0
2015,1205,14,1,15,1,7,8,0,0,0,0,0,0
2015,1207,5,0,5,0,0,0,0,0,0,0,0,0
2015,1208,10,2,12,1,6,7,0,0,0,0,0,0
2015,1300,98,5,103,11,49,60,68,19,87,12,21,33
2015,1301,32,3,35,4,10,14,0,0,0,0,0,0
2015,1302,27,1,28,5,12,17,0,0,0,0,0,0
2015,1303,5,0,5,0,0,0,0,0,0,0,0,0
2015,1304,44,5,49,6,18,24,0,0,0,0,0,0
2015,1306,13,2,15,2,1,3,0,0,0,0,0,0
2015,1307,5,0,5,0,0,0,0,0,0,0,0,0
2015,1400,25,1,26,2,9,11,11,0,11,13,10,23
2015,1401,13,0,13,2,4,6,0,0,0,0,0,0
2015,1500,376,26,402,41,180,221,363,103,466,21,71,92
2015,1501,20,2,22,3,4,7,0,0,0,0,0,0
2015,1502,358,30,388,32,122,154,0,0,0,0,0,0
2015,1503,50,1,51,9,8,17,0,0,0,0,0,0
2015,1505,13,0,13,0,3,3,0,0,0,0,0,0
2015,1506,29,3,32,4,12,16,0,0,0,0,0,0
2015,1507,19,3,22,4,7,11,0,0,0,0,0,0
2015,1508,13,2,15,0,8,8,34,23,57,0,0,0
2015,1509,13,2,15,1,2,3,0,0,0,0,0,0
2015,1511,20,1,21,2,9,11,0,0,0,0,0,0
2015,1514,3,0,3,0,0,0,0,0,0,0,0,0
2015,1515,4,1,5,1,7,8,0,0,0,1,0,1
2015,1597,12,2,14,1,6,7,0,0,0,0,0,0
2015,1600,72,5,77,2,41,43,0,0,0,80,58,138
2015,1601,14,2,16,4,8,12,0,0,0,0,0,0
2015,1602,51,4,55,1,25,26,0,0,0,0,0,0
2015,1603,29,2,31,1,6,7,0,0,0,0,0,0
2015,1607,12,3,15,0,1,1,0,0,0,0,0,0
2015,1700,46,5,51,1,18,19,0,0,0,43,22,65
2015,1701,10,0,10,0,1,1,0,0,0,0,0,0
2015,1702,20,1,21,0,6,6,0,0,0,0,0,0
2015,1800,26,2,28,3,12,15,20,11,31,2,6,8
2015,1801,14,1,15,1,1,2,0,0,0,0,0,0
2015,1900,5469,1153,6622,1629,2553,4182,2012,512,2524,1237,2017,3254
2015,1901,77,8,85,6,37,43,0,0,0,0,0,0
2015,1902,66,2,68,2,22,24,0,0,0,0,1,1
2015,1905,52,7,59,5,21,26,0,0,0,4,4,8
2015,1906,61,4,65,0,21,21,0,0,0,4,2,6
2015,1907,27,2,29,1,7,8,0,0,0,0,0,0
2015,1909,47,3,50,6,8,14,0,0,0,0,0,0
2015,1910,109,8,117,12,45,57,0,0,0,1,0,1
2015,1912,127,19,146,16,55,71,0,0,0,5,4,9
2015,1913,32,6,38,5,14,19,0,0,0,2,3,5
2015,1916,55,1,56,5,16,21,0,0,0,2,2,4
2015,1918,97,6,103,20,23,43,0,0,0,2,1,3
2015,1920,93,16,109,8,30,38,0,0,0,0,0,0
2015,1922,99,8,107,9,26,35,0,0,0,5,1,6
2015,1923,54,3,57,1,10,11,0,0,0,5,2,7
2015,1924,83,9,92,1,17,18,0,0,0,5,2,7
2015,1925,211,25,236,20,65,85,0,0,0,10,8,18
2015,1926,45,3,48,6,22,28,0,0,0,2,3,5
2015,1928,86,7,93,6,22,28,1,0,1,5,5,10
2015,1929,33,5,38,11,6,17,0,0,0,1,7,8
2015,1931,52,4,56,10,18,28,0,0,0,4,2,6
2015,1933,151,22,173,5,37,42,0,0,0,1,9,10
2015,1934,24,1,25,0,8,8,0,0,0,0,0,0
2015,1938,35,5,40,5,16,21,0,0,0,0,0,0
2015,1941,689,74,763,95,196,291,7,1,8,42,19,61
2015,1942,7904,1846,9750,927,1544,2471,105,8,113,213,118,331
2015,1944,50,14,64,12,21,33,0,0,0,3,4,7
2015,1946,42,5,47,4,20,24,0,0,0,1,3,4
2015,1947,61,7,68,3,26,29,0,0,0,4,2,6
2015,1948,59,10,69,4,18,22,0,0,0,2,3,5
2015,1951,21,2,23,1,5,6,2,4,6,0,0,0
2015,1953,190,31,221,27,63,90,0,0,0,11,11,22
2015,1955,144,10,154,13,69,82,0,0,0,9,8,17
2015,1956,78,7,85,12,32,44,0,0,0,4,6,10
2015,1961,25,3,28,0,4,4,0,0,0,0,0,0
2015,1962,48,2,50,2,13,15,0,0,0,0,0,0
2015,1963,20,5,25,0,4,4,0,0,0,0,0,0
2015,1965,183,19,202,78,76,154,0,1,1,10,6,16
2015,1966,13,2,15,0,3,3,0,0,0,0,0,0
2015,1967,29,3,32,2,4,6,0,0,0,2,4,6
2015,1969,73,5,78,4,29,33,0,0,0,4,3,7
2015,1970,31,0,31,1,11,12,0,0,0,0,0,0
2015,1972,197,14,211,20,67,87,1,0,1,6,9,15
2015,1973,35,2,37,1,11,12,0,0,0,0,0,0
2015,1975,85,4,89,12,43,55,0,0,0,3,3,6
2015,1976,105,13,118,15,36,51,0,0,0,0,0,0
2015,1978,16,3,19,1,7,8,0,0,0,0,0,0
2015,1981,18,2,20,4,2,6,0,0,0,0,0,0
2015,1982,21,3,24,6,8,14,0,0,0,0,0,0
2015,1983,15,2,17,6,5,11,0,0,0,0,0,0
2015,1984,19,3,22,7,7,14,0,0,0,0,0,0
2015,1997,54,6,60,16,22,38,0,0,0,0,0,0
2015,2000,71,4,75,3,26,29,0,0,0,0,0,0
2015,2001,15,1,16,2,5,7,0,0,0,0,0,0
2015,2002,54,2,56,4,14,18,0,0,0,0,0,0
2015,2100,104,14,118,16,58,74,55,21,76,9,16,25
2015,2101,6,1,7,0,1,1,0,0,0,0,0,0
2015,2103,10,1,11,3,2,5,0,0,0,0,0,0
2015,2105,19,2,21,0,6,6,0,0,0,0,0,0
2015,2106,48,9,57,6,18,24,0,0,0,0,0,0
2015,2107,8,0,8,0,0,0,0,0,0,0,0,0
2015,2109,54,9,63,4,19,23,0,0,0,0,0,0
2015,2110,16,2,18,1,4,5,0,0,0,0,0,0
2015,2111,12,1,13,0,3,3,0,0,0,0,0,0
2015,2113,6,0,6,1,0,1,0,0,0,0,0,0
2015,2117,37,6,43,0,3,3,0,0,0,0,0,0
2015,2200,36,3,39,3,11,14,10,9,19,0,0,0
2015,2300,61,1,62,12,24,36,42,13,55,1,8,9
2015,2301,14,1,15,0,5,5,0,0,0,0,0,0
2015,2303,30,2,32,4,13,17,0,0,0,0,0,0
2015,2304,10,1,11,1,4,5,0,0,0,0,0,0
2015,2400,76,4,80,5,23,28,2,0,2,63,37,100
2015,2401,30,0,30,1,6,7,0,0,0,0,0,0
2015,2402,5,2,7,0,1,1,0,0,0,0,0,0
2015,2403,8,1,9,0,2,2,0,0,0,0,0,0
2015,2404,19,0,19,0,8,8,0,0,0,0,0,0
2015,2405,35,3,38,2,15,17,0,0,0,3,2,5
2015,2406,76,4,80,8,27,35,0,0,0,0,0,0
2015,2412,10,2,12,1,7,8,0,0,0,0,0,0
2015,2500,13,0,13,1,2,3,1,0,1,4,2,6
2015,2501,5,0,5,0,1,1,0,0,0,0,0,0
2015,2600,21,1,22,2,2,4,0,0,0,7,7,14
2015,2601,11,0,11,0,3,3,0,0,0,0,0,0
2015,2700,108,12,120,8,51,59,135,36,171,25,28,53
2015,2701,14,1,15,3,7,10,0,0,0,0,0,0
2015,2702,6,0,6,0,0,0,0,0,0,0,0,0
2015,2703,10,0,10,1,2,3,0,0,0,0,0,0
2015,2704,13,3,16,0,2,2,0,0,0,0,0,0
2015,2705,14,1,15,0,2,2,0,0,0,0,0,0
2015,2706,40,4,44,1,4,5,0,0,0,4,4,8
2015,2707,8,6,14,4,6,10,0,0,0,0,0,0
2015,2708,114,8,122,17,36,53,0,0,0,0,0,0
2015,2709,8,1,9,0,1,1,0,0,0,0,0,0
2015,2710,33,4,37,2,8,10,0,0,0,0,0,0
2015,2711,16,1,17,1,1,2,0,0,0,0,0,0
2015,2712,27,2,29,0,6,6,0,0,0,0,0,0
2015,2714,7,0,7,0,0,0,0,0,0,0,0,0
2015,2719,9,5,14,3,6,9,0,0,0,0,0,0
2015,2800,98,4,102,9,20,29,1,0,1,0,0,0
2015,2801,5,3,8,1,3,4,0,0,0,0,0,0
2015,2802,65,7,72,8,34,42,0,0,0,0,0,0
2015,2803,12,0,12,0,5,5,0,0,0,0,0,0
2015,2808,101,6,107,2,5,7,0,0,0,0,0,0
2015,2900,47,2,49,5,24,29,9,1,10,36,31,67
2015,2901,23,1,24,0,3,3,0,0,0,0,0,0
2015,2902,9,0,9,0,2,2,0,0,0,0,0,0
2015,2908,22,2,24,4,6,10,0,0,0,0,0,0
2015,3000,913,105,1018,550,626,1176,670,90,760,393,255,648
2015,3001,341,38,379,37,133,170,15,5,20,0,8,8
2015,3002,58,5,63,3,30,33,0,0,0,0,0,0
2015,3003,76,7,83,8,28,36,0,0,0,0,0,0
2015,3004,99,15,114,11,52,63,0,0,0,0,0,0
2015,3005,47,5,52,2,10,12,0,0,0,4,0,4
2015,3006,20,1,21,0,6,6,0,0,0,0,0,0
2015,3007,54,6,60,1,18,19,0,0,0,0,0,0
2015,3008,128,12,140,6,52,58,0,0,0,4,1,5
2015,3009,148,6,154,13,50,63,0,0,0,0,0,0
2015,3010,199,11,210,21,81,102,0,0,0,12,6,18
2015,3011,41,5,46,8,28,36,0,0,0,0,0,0
2015,3012,65,2,67,6,26,32,0,0,0,0,0,0
2015,3013,16,6,22,0,3,3,0,0,0,0,0,0
2015,3014,130,9,139,23,48,71,0,0,0,5,2,7
2015,3015,137,13,150,10,43,53,0,0,0,0,0,0
2015,3016,44,2,46,3,13,16,0,0,0,0,0,0
2015,3019,276,26,302,28,99,127,0,0,0,47,51,98
2015,3020,28,3,31,6,4,10,0,0,0,2,3,5
2015,3022,81,10,91,10,39,49,0,0,0,0,0,0
2015,3024,80,6,86,2,29,31,0,0,0,2,0,2
2015,3026,165,38,203,28,67,95,0,0,0,0,0,0
2015,3027,23,4,27,3,7,10,0,0,0,0,0,0
2015,3097,31,2,33,9,12,21,0,0,0,0,0,0
2015,3100,157,14,171,29,64,93,54,8,62,73,72,145
2015,3101,17,2,19,1,6,7,0,0,0,0,0,0
2015,3103,17,2,19,1,6,7,0,0,0,0,0,0
2015,3104,49,5,54,2,25,27,0,0,0,0,0,0
2015,3105,120,8,128,14,45,59,0,0,0,0,0,0
2015,3200,29,2,31,1,9,10,1,0,1,9,9,18
2015,3300,1490,157,1647,198,690,888,351,51,402,758,393,1151
2015,3301,22,3,25,1,13,14,0,0,0,0,0,0
2015,3302,35,1,36,5,15,20,0,0,0,0,0,0
2015,3303,20,0,20,5,5,10,0,0,0,0,0,0
2015,3306,19,3,22,3,1,4,0,0,0,0,0,0
2015,3308,63,2,65,3,21,24,0,0,0,0,0,0
2015,3309,58,4,62,7,31,38,0,0,0,0,0,0
2015,3311,73,8,81,8,28,36,0,0,0,0,0,0
2015,3313,326,42,368,32,115,147,0,0,0,0,0,0
2015,3315,142,15,157,7,52,59,0,0,0,4,2,6
2015,3325,44,2,46,5,16,21,0,0,0,0,0,0
2015,3342,78,7,85,3,38,41,0,0,0,0,0,0
2015,3344,17,1,18,1,4,5,0,0,0,0,0,0
2015,3397,28,3,31,3,10,13,0,0,0,0,0,0
2015,3400,569,100,669,116,219,335,473,107,580,94,228,322
2015,3401,58,9,67,1,21,22,0,0,0,0,0,0
2015,3402,32,4,36,1,11,12,0,0,0,0,0,0
2015,3404,539,107,646,102,201,303,0,0,0,0,0,0
2015,3408,20,2,22,7,9,16,0,0,0,0,0,0
2015,3414,19,3,22,3,2,5,0,0,0,0,0,0
2015,3420,3,0,3,0,0,0,0,0,0,0,0,0
2015,3422,428,102,530,5,25,30,0,0,0,0,0,0
2015,3477,71,7,78,10,11,21,0,0,0,0,0,0
2015,3496,74,12,86,6,40,46,0,0,0,0,0,0
2015,3499,6747,479,7226,1344,1844,3188,0,0,0,0,0,0
2015,3500,25,0,25,2,3,5,0,0,0,14,9,23
2015,3501,24,3,27,0,6,6,0,0,0,0,0,0
2015,3600,1089,150,1239,217,602,819,486,99,585,166,438,604
2015,3601,36,1,37,0,17,17,0,0,0,0,0,0
2015,3602,99,6,105,5,45,50,0,0,0,0,0,0
2015,3603,50,1,51,6,21,27,0,0,0,0,0,0
2015,3604,168,17,185,8,81,89,0,0,0,0,0,0
2015,3605,43,4,47,2,19,21,0,0,0,0,0,0
2015,3607,224,10,234,18,69,87,0,0,0,0,0,0
2015,3608,70,9,79,8,28,36,0,0,0,0,0,0
2015,3609,93,12,105,3,31,34,0,0,0,0,0,0
2015,3610,195,19,214,39,141,180,0,0,0,0,0,0
2015,3611,63,4,67,2,22,24,0,0,0,0,0,0
2015,3614,10,5,15,2,8,10,0,0,0,0,0,0
2015,3623,21,2,23,35,14,49,0,0,0,0,0,0
2015,3639,6,1,7,7,6,13,0,0,0,0,0,0
2015,3650,12,4,16,34,18,52,0,0,0,0,0,0
2015,3657,53,16,69,5,11,16,0,0,0,0,0,0
2015,3700,1207,166,1373,303,500,803,931,254,1185,292,474,766
2015,3701,93,12,105,8,39,47,0,0,0,0,0,0
2015,3702,187,30,217,11,62,73,0,0,0,5,8,13
2015,3703,36,6,42,2,18,20,0,0,0,0,0,0
2015,3705,109,9,118,10,53,63,0,0,0,0,0,0
2015,3706,135,13,148,6,44,50,0,0,0,0,0,0
2015,3708,58,5,63,5,24,29,0,0,0,0,0,0
2015,3709,75,6,81,3,28,31,0,0,0,0,0,0
2015,3710,185,21,206,11,59,70,0,0,0,0,0,0
2015,3711,1582,305,1887,245,413,658,0,0,0,0,0,0
2015,3714,20,4,24,6,17,23,0,0,0,0,0,0
2015,3715,105,17,122,10,20,30,0,0,0,0,0,0
2015,3732,19,2,21,2,5,7,0,0,0,0,0,0
2015,3797,31,6,37,14,13,27,0,0,0,0,0,0
2015,3800,254,51,305,52,79,131,424,78,502,17,5,22
2015,3801,1981,255,2236,212,263,475,0,0,0,0,0,0
2015,3803,24,3,27,15,11,26,0,0,0,0,0,0
2015,3816,6,1,7,0,0,0,0,0,0,0,0,0
2015,3897,41,4,45,56,17,73,0,0,0,0,0,0
2015,3900,234,19,253,38,105,143,24,3,27,182,97,279
2015,3901,10,0,10,0,1,1,0,0,0,0,0,0
2015,3902,66,5,71,1,12,13,0,0,0,3,15,18
2015,3903,57,3,60,5,19,24,0,0,0,0,0,0
2015,3904,22,1,23,1,8,9,0,0,0,0,0,0
2015,3905,348,41,389,55,127,182,0,0,0,0,0,0
2015,3906,76,7,83,6,33,39,0,0,0,0,0,0
2015,3915,16,4,20,1,6,7,0,0,0,0,0,0
2015,4000,149,4,153,10,59,69,95,34,129,7,27,34
2015,4001,22,1,23,1,3,4,0,0,0,0,0,0
2015,4002,12,2,14,2,6,8,0,0,0,0,0,0
2015,4003,13,4,17,0,2,2,0,0,0,0,0,0
2015,4004,32,0,32,1,13,14,0,0,0,0,0,0
2015,4005,16,3,19,1,11,12,0,0,0,0,0,0
2015,4006,52,7,59,2,22,24,0,0,0,0,0,0
2015,4007,16,1,17,4,12,16,0,0,0,0,0,0
2015,4008,24,3,27,1,9,10,0,0,0,0,0,0
2015,4016,99,29,128,0,11,11,0,0,0,0,0,0
2015,4019,7,0,7,2,3,5,0,0,0,0,0,0
2015,4100,221,20,241,58,85,143,58,9,67,141,70,211
2015,4101,18,1,19,1,6,7,0,0,0,0,0,0
2015,4102,29,2,31,6,7,13,0,0,0,0,0,0
2015,4103,13,3,16,1,2,3,0,0,0,0,0,0
2015,4104,34,3,37,4,14,18,0,0,0,0,0,0
2015,4105,16,2,18,0,6,6,0,0,0,0,0,0
2015,4106,100,12,112,12,27,39,0,0,0,0,0,0
2015,4108,21,2,23,3,5,8,0,0,0,0,0,0
2015,4109,39,6,45,5,15,20,0,0,0,0,0,0
2015,4111,30,3,33,0,2,2,0,0,0,0,0,0
2015,4113,78,10,88,4,21,25,0,0,0,0,0,0
2015,4114,43,4,47,3,12,15,0,0,0,0,0,0
2015,4116,97,12,109,6,28,34,0,0,0,0,0,0
2015,4117,72,9,81,7,22,29,0,0,0,0,0,0
2015,4119,9,1,10,0,1,1,0,0,0,0,0,0
2015,4120,31,5,36,3,11,14,0,0,0,0,0,0
2015,4127,28,5,33,4,7,11,0,0,0,0,0,0
2015,4200,227,28,255,22,85,107,153,34,187,29,32,61
2015,4201,11,0,11,0,2,2,0,0,0,0,0,0
2015,4202,41,1,42,1,14,15,0,0,0,4,0,4
2015,4203,108,20,128,21,50,71,0,0,0,0,0,0
2015,4204,108,6,114,5,44,49,0,0,0,0,0,0
2015,4211,4,1,5,3,2,5,0,0,0,0,0,0
2015,4297,32,5,37,6,7,13,0,0,0,0,0,0
2015,4300,411,70,481,57,123,180,581,144,725,87,140,227
2015,4302,36,4,40,2,21,23,0,0,0,0,0,0
2015,4304,55,6,61,4,22,26,0,0,0,2,2,4
2015,4305,25,5,30,3,12,15,0,0,0,0,0,0
2015,4307,35,4,39,3,16,19,0,0,0,0,0,0
2015,4308,75,10,85,5,19,24,0,0,0,0,0,0
2015,4310,36,4,40,5,15,20,0,0,0,0,0,0
2015,4311,82,8,90,8,35,43,0,0,0,0,0,0
2015,4312,74,11,85,22,35,57,0,0,0,0,0,0
2015,4313,847,92,939,107,279,386,0,0,0,0,0,0
2015,4314,133,10,143,10,42,52,0,0,0,3,2,5
2015,4316,192,22,214,16,54,70,0,0,0,0,0,0
2015,4317,23,6,29,31,17,48,0,0,0,0,0,0
2015,4320,3,1,4,5,2,7,0,0,0,0,0,0
2015,4321,9,0,9,3,1,4,0,0,0,0,0,0
2015,4327,10,0,10,4,1,5,0,0,0,0,0,0
2015,4400,114,21,135,10,40,50,8,0,8,64,42,106
2015,4401,20,1,21,5,3,8,0,0,0,0,0,0
2015,4402,80,11,91,2,18,20,0,0,0,0,0,0
2015,4403,60,6,66,8,14,22,0,0,0,0,0,0
2015,4404,20,0,20,2,6,8,0,0,0,0,0,0
2015,4497,15,3,18,4,8,12,0,0,0,0,0,0
2015,4500,76,4,80,10,37,47,45,17,62,9,12,21
2015,4501,16,2,18,0,6,6,0,0,0,0,0,0
2015,4502,92,6,98,6,25,31,0,0,0,0,0,0
2015,4591,17,3,20,1,3,4,0,0,0,0,0,0
2015,4600,10,0,10,0,0,0,0,0,0,3,1,4
2015,4700,47,2,49,5,11,16,23,6,29,2,3,5
2015,4703,3,0,3,0,0,0,0,0,0,0,0,0
2015,4706,7,1,8,0,3,3,0,0,0,0,0,0
2015,4707,3,0,3,0,0,0,0,0,0,0,0,0
2015,4708,9,0,9,3,2,5,0,0,0,0,0,0
2015,4709,13,0,13,1,5,6,0,0,0,0,0,0
2015,4710,3,0,3,0,0,0,0,0,0,0,0,0
2015,4800,113,9,122,24,66,90,1,0,1,189,79,268
2015,4801,24,4,28,0,16,16,0,0,0,0,0,0
2015,4802,19,2,21,0,5,5,0,0,0,0,0,0
2015,4803,106,10,116,10,52,62,0,0,0,0,0,0
2015,4804,8,3,11,0,1,1,0,0,0,0,0,0
2015,4805,16,3,19,0,10,10,0,0,0,0,0,0
2015,4806,87,9,96,4,49,53,0,0,0,0,0,0
2015,4807,102,6,108,7,30,37,0,0,0,0,0,0
2015,4900,216,15,231,25,72,97,0,0,0,188,77,265
2015,4901,12,0,12,0,7,7,0,0,0,0,0,0
2015,4902,10,1,11,0,6,6,0,0,0,0,0,0
2015,4903,13,2,15,0,7,7,0,0,0,0,0,0
2015,4904,54,5,59,1,19,20,0,0,0,0,0,0
2015,4905,150,13,163,22,56,78,0,0,0,0,0,0
2015,4906,14,0,14,1,4,5,0,0,0,0,0,0
2015,4908,56,3,59,2,19,21,0,0,0,0,0,0
2015,4909,10,3,13,7,7,14,0,0,0,0,0,0
2015,4914,14,0,14,6,6,12,0,0,0,0,0,0
2015,5000,195,16,211,17,81,98,191,30,221,10,42,52
2015,5001,45,2,47,5,11,16,0,0,0,0,0,0
2015,5002,203,13,216,12,67,79,0,0,0,0,0,0
2015,5003,10,1,11,0,3,3,0,0,0,0,0,0
2015,5004,21,1,22,0,10,10,0,0,0,0,0,0
2015,5007,68,6,74,5,32,37,0,0,0,0,0,0
2015,5010,9,2,11,3,3,6,0,0,0,0,0,0
2015,5100,49,3,52,2,17,19,39,20,59,0,0,0
2015,5102,49,5,54,3,21,24,0,0,0,0,0,0
2015,5200,40,3,43,7,20,27,28,12,40,3,2,5
2015,5201,13,0,13,3,4,7,0,0,0,0,0,0
2015,5202,20,2,22,1,9,10,0,0,0,0,0,0
2015,5300,16,1,17,0,5,5,11,6,17,0,3,3
2015,5400,249,33,282,35,93,128,219,43,262,43,64,107
2015,5401,34,3,37,3,8,11,0,0,0,0,0,0
2015,5402,12,3,15,0,2,2,0,0,0,0,0,0
2015,5403,13,2,15,0,1,1,0,0,0,0,0,0
2015,5404,13,1,14,1,4,5,0,0,0,0,0,0
2015,5405,50,6,56,8,16,24,0,0,0,0,0,0
2015,5406,63,8,71,14,24,38,0,0,0,0,0,0
2015,5407,123,15,138,8,56,64,0,0,0,0,0,0
2015,5408,11,1,12,0,1,1,0,0,0,0,0,0
2015,5411,4,0,4,0,1,1,0,0,0,0,0,0
2015,5500,60,2,62,1,21,22,0,0,0,27,18,45
2015,5501,12,1,13,0,6,6,0,0,0,0,0,0
2015,5600,446,52,498,98,194,292,196,38,234,118,100,218
2015,5604,212,25,237,32,83,115,0,0,0,4,2,6
2015,5605,19,2,21,2,6,8,0,0,0,0,0,0
2015,5606,27,1,28,2,6,8,0,0,0,0,0,0
2015,5608,117,9,126,4,35,39,0,0,0,0,0,0
2015,5609,113,9,122,16,40,56,0,0,0,0,0,0
2015,5622,13,1,14,6,8,14,0,0,0,0,0,0
2015,5680,15,0,15,0,1,1,0,0,0,0,0,0
2015,5700,76,9,85,5,32,37,6,0,6,78,56,134
2015,5701,52,4,56,5,31,36,0,0,0,0,0,0
2015,5702,10,1,11,0,2,2,0,0,0,0,0,0
2015,5703,53,9,62,0,15,15,0,0,0,0,0,0
2015,5704,51,7,58,4,14,18,0,0,0,0,0,0
2015,5797,36,7,43,24,16,40,0,0,0,0,0,0
2015,5800,60,3,63,2,20,22,43,20,63,9,11,20
2015,5801,15,1,16,4,4,8,0,0,0,0,0,0
2015,5802,7,0,7,0,0,0,0,0,0,0,0,0
2015,10M1,182,28,210,7,11,18,0,0,0,0,0,0
2015,190C,23,2,25,3,4,7,0,0,0,0,0,0
2015,190R,6,0,6,2,3,5,0,0,0,0,0,0
2015,340H,106,18,124,20,61,81,0,0,0,0,0,0
2016,100,499,60,559,104,221,325,371,73,444,94,142,236
2016,101,70,11,81,4,25,29,0,0,0,0,0,0
2016,102,24,0,24,1,7,8,0,0,0,0,0,0
2016,103,140,34,174,18,57,75,1,0,1,6,7,13
2016,104,35,3,38,3,10,13,0,0,0,0,0,0
2016,105,164,15,179,12,72,84,1,0,1,9,9,18
2016,106,171,23,194,17,81,98,0,0,0,13,5,18
2016,107,78,11,89,8,36,44,0,0,0,0,0,0
2016,108,46,9,55,7,15,22,0,0,0,0,0,0
2016,109,655,95,750,60,236,296,0,0,0,0,0,0
2016,110,14,5,19,1,7,8,0,0,0,0,0,0
2016,111,67,10,77,3,30,33,0,0,0,0,0,0
2016,112,85,5,90,3,28,31,0,0,0,5,5,10
2016,113,65,10,75,15,14,29,0,0,0,0,0,0
2016,114,55,7,62,6,19,25,0,0,0,0,0,0
2016,115,10,3,13,5,6,11,0,0,0,0,0,0
2016,197,46,12,58,47,20,67,0,0,0,0,0,0
2016,200,13,0,13,1,3,4,0,0,0,0,0,0
2016,300,42,2,44,3,14,17,1,0,1,15,9,24
2016,302,6,0,6,0,0,0,0,0,0,0,0,0
2016,303,8,2,10,0,1,1,0,0,0,0,0,0
2016,305,4,0,4,0,0,0,0,0,0,0,0,0
2016,400,88,5,93,18,37,55,1,0,1,78,42,120
2016,402,81,5,86,9,35,44,0,0,0,5,2,7
2016,403,13,1,14,0,5,5,0,0,0,0,0,0
2016,404,22,2,24,7,13,20,0,0,0,0,0,0
2016,405,18,1,19,3,11,14,0,0,0,0,0,0
2016,497,15,1,16,3,8,11,0,0,0,0,0,0
2016,500,42,5,47,7,19,26,2,0,2,16,10,26
2016,501,6,0,6,0,1,1,0,0,0,0,0,0
2016,600,26,2,28,1,18,19,5,0,5,7,6,13
2016,601,8,0,8,0,1,1,0,0,0,0,0,0
2016,602,6,1,7,0,2,2,0,0,0,0,0,0
2016,700,255,44,299,51,151,202,282,52,334,60,62,122
2016,701,90,5,95,2,25,27,0,0,0,0,1,1
2016,702,57,5,62,2,19,21,0,0,0,0,0,0
2016,703,9,1,10,0,2,2,0,0,0,0,0,0
2016,704,131,19,150,3,44,47,0,0,0,3,1,4
2016,705,37,3,40,1,6,7,0,0,0,0,0,0
2016,706,19,1,20,0,2,2,0,0,0,0,0,0
2016,707,21,1,22,1,10,11,0,0,0,0,0,0
2016,708,68,9,77,3,16,19,0,0,0,0,0,0
2016,709,37,4,41,4,12,16,0,0,0,0,0,0
2016,710,147,30,177,15,44,59,0,0,0,1,5,6
2016,711,44,2,46,3,16,19,0,0,0,1,1,2
2016,712,67,18,85,7,26,33,0,0,0,0,0,0
2016,713,9,1,10,0,0,0,0,0,0,0,0,0
2016,714,31,2,33,0,12,12,0,0,0,0,0,0
2016,716,10,1,11,0,1,1,0,0,0,0,0,0
2016,718,172,17,189,48,40,88,0,0,0,0,0,0
2016,721,19,3,22,5,7,12,0,0,0,0,0,0
2016,724,58,7,65,4,12,16,0,0,0,0,0,0
2016,800,22,1,23,3,6,9,1,0,1,12,10,22
2016,801,8,1,9,0,1,1,0,0,0,0,0,0
2016,900,133,4,137,20,54,74,16,1,17,77,44,121
2016,901,16,2,18,0,8,8,0,0,0,0,0,0
2016,902,34,3,37,3,16,19,0,0,0,0,0,0
2016,1000,354,41,395,61,131,192,10,1,11,359,147,506
2016,1001,86,14,100,14,47,61,0,0,0,1,0,1
2016,1002,21,0,21,2,9,11,0,0,0,0,0,0
2016,1003,10,1,11,0,4,4,0,0,0,0,0,0
2016,1004,12,0,12,0,1,1,0,0,0,0,0,0
2016,1005,670,78,748,93,172,265,0,0,0,0,0,0
2016,1006,8,2,10,0,7,7,0,0,0,0,0,0
2016,1007,16,3,19,1,2,3,0,0,0,0,0,0
2016,1008,14,0,14,0,3,3,0,0,0,0,0,0
2016,1009,13,1,14,0,2,2,0,0,0,0,0,0
2016,1010,10,1,11,0,1,1,0,0,0,0,0,0
2016,1011,10,0,10,1,0,1,0,0,0,0,0,0
2016,1012,24,3,27,2,11,13,0,0,0,0,0,0
2016,1013,29,4,33,3,1,4,0,0,0,0,0,0
2016,1015,27,3,30,1,7,8,0,0,0,0,0,0
2016,1017,10,1,11,2,4,6,0,0,0,0,0,0
2016,1097,20,3,23,2,12,14,0,0,0,0,0,0
2016,1100,20,1,21,1,12,13,1,0,1,11,9,20
2016,1101,11,0,11,0,2,2,0,0,0,0,0,0
2016,1102,8,1,9,0,1,1,0,0,0,0,0,0
2016,1200,79,12,91,8,35,43,68,23,91,4,6,10
2016,1201,22,3,25,2,11,13,0,0,0,0,0,0
2016,1203,43,4,47,4,20,24,0,0,0,0,0,0
2016,1204,4,0,4,0,0,0,0,0,0,0,0,0
2016,1205,14,1,15,0,7,7,0,0,0,0,0,0
2016,1207,4,1,5,0,0,0,0,0,0,0,0,0
2016,1208,10,2,12,2,6,8,0,0,0,0,0,0
2016,1300,99,5,104,10,51,61,68,18,86,14,21,35
2016,1301,34,2,36,3,11,14,0,0,0,0,0,0
2016,1302,22,1,23,3,9,12,0,0,0,0,0,0
2016,1303,3,0,3,0,0,0,0,0,0,0,0,0
2016,1304,44,4,48,5,18,23,0,0,0,0,0,0
2016,1306,16,2,18,2,2,4,0,0,0,0,0,0
2016,1307,5,0,5,0,0,0,0,0,0,0,0,0
2016,1400,23,1,24,2,10,12,11,0,11,11,13,24
2016,1401,10,0,10,1,5,6,0,0,0,0,0,0
2016,1500,338,22,360,50,172,222,369,97,466,23,66,89
2016,1501,20,2,22,2,6,8,0,0,0,0,0,0
2016,1502,358,32,390,22,118,140,0,0,0,0,0,0
2016,1503,49,1,50,8,11,19,0,0,0,0,0,0
2016,1505,12,1,13,0,3,3,0,0,0,0,0,0
2016,1506,28,4,32,5,13,18,0,0,0,0,0,0
2016,1507,21,5,26,4,8,12,0,0,0,0,0,0
2016,1508,14,2,16,1,9,10,0,0,0,0,0,0
2016,1509,13,2,15,3,6,9,0,0,0,0,0,0
2016,1511,16,0,16,2,8,10,0,0,0,0,0,0
2016,1514,3,0,3,0,0,0,0,0,0,0,0,0
2016,1515,6,0,6,0,6,6,0,0,0,0,0,0
2016,1597,11,2,13,1,7,8,0,0,0,0,0,0
2016,1600,69,6,75,2,47,49,0,0,0,89,58,147
2016,1601,15,2,17,3,9,12,0,0,0,0,0,0
2016,1602,51,2,53,1,23,24,0,0,0,0,0,0
2016,1603,30,1,31,1,6,7,0,0,0,0,0,0
2016,1607,13,2,15,0,2,2,0,0,0,0,0,0
2016,1700,48,5,53,1,19,20,0,0,0,41,21,62
2016,1701,12,0,12,0,1,1,0,0,0,0,0,0
2016,1702,22,1,23,0,5,5,0,0,0,0,0,0
2016,1800,25,4,29,1,13,14,22,8,30,2,6,8
2016,1801,16,1,17,1,1,2,0,0,0,0,0,0
2016,1900,5478,1161,6639,1648,2610,4258,2145,532,2677,1216,1931,3147
2016,1901,75,9,84,8,33,41,0,0,0,0,0,0
2016,1902,63,3,66,2,22,24,0,0,0,0,1,1
2016,1905,51,6,57,6,24,30,0,0,0,3,4,7
2016,1906,61,4,65,3,22,25,0,0,0,5,3,8
2016,1907,26,3,29,4,8,12,3,1,4,0,0,0
2016,1909,48,2,50,5,16,21,0,0,0,1,0,1
2016,1910,108,9,117,13,53,66,0,0,0,1,0,1
2016,1912,137,17,154,15,57,72,0,0,0,5,3,8
2016,1913,31,6,37,5,14,19,0,0,0,2,3,5
2016,1916,59,0,59,4,20,24,0,0,0,2,2,4
2016,1918,95,5,100,26,24,50,0,0,0,2,1,3
2016,1920,90,16,106,14,30,44,0,0,0,0,0,0
2016,1922,100,8,108,10,29,39,0,0,0,4,1,5
2016,1923,54,2,56,0,11,11,0,0,0,5,1,6
2016,1924,86,9,95,2,16,18,0,0,0,2,4,6
2016,1925,211,21,232,19,58,77,0,0,0,10,9,19
2016,1926,48,3,51,8,22,30,0,0,0,2,3,5
2016,1928,79,8,87,9,29,38,1,0,1,6,4,10
2016,1929,29,5,34,12,6,18,0,0,0,2,8,10
2016,1931,48,3,51,12,17,29,0,0,0,4,2,6
2016,1933,153,22,175,4,33,37,0,0,0,2,5,7
2016,1934,25,3,28,0,7,7,0,0,0,0,0,0
2016,1938,35,5,40,4,16,20,0,0,0,0,0,0
2016,1941,720,80,800,115,195,310,5,1,6,37,20,57
2016,1942,7938,1806,9744,940,1559,2499,91,15,106,221,122,343
2016,1944,53,13,66,9,23,32,0,0,0,3,4,7
2016,1946,46,5,51,5,22,27,0,0,0,1,3,4
2016,1947,58,8,66,3,24,27,0,0,0,4,2,6
2016,1948,60,9,69,5,19,24,0,0,0,2,3,5
2016,1951,21,2,23,1,5,6,2,4,6,0,0,0
2016,1953,203,31,234,33,67,100,0,0,0,12,11,23
2016,1955,140,14,154,19,71,90,0,0,0,9,8,17
2016,1956,86,6,92,14,28,42,0,0,0,3,6,9
2016,1961,24,3,27,2,4,6,0,0,0,4,4,8
2016,1962,47,2,49,2,13,15,0,0,0,0,0,0
2016,1963,20,5,25,0,5,5,0,0,0,0,0,0
2016,1965,185,18,203,80,74,154,1,0,1,9,7,16
2016,1966,13,2,15,0,3,3,0,0,0,0,0,0
2016,1967,31,3,34,1,4,5,0,0,0,2,6,8
2016,1969,74,5,79,4,28,32,0,0,0,4,3,7
2016,1970,35,0,35,13,1,14,0,0,0,0,0,0
2016,1972,193,14,207,25,62,87,1,0,1,6,8,14
2016,1973,37,2,39,1,11,12,0,0,0,0,0,0
2016,1975,88,5,93,15,42,57,0,0,0,3,3,6
2016,1976,114,6,120,13,34,47,0,0,0,0,0,0
2016,1978,15,3,18,8,15,23,0,0,0,0,0,0
2016,1981,17,2,19,4,2,6,0,0,0,0,0,0
2016,1982,23,3,26,6,10,16,0,0,0,0,0,0
2016,1983,15,2,17,5,6,11,0,0,0,0,0,0
2016,1984,17,3,20,6,9,15,0,0,0,0,0,0
2016,1997,53,5,58,18,23,41,0,0,0,0,0,0
2016,2000,75,4,79,3,25,28,0,0,0,0,0,0
2016,2001,15,1,16,2,6,8,0,0,0,0,0,0
2016,2002,57,3,60,4,14,18,0,0,0,0,0,0
2016,2100,101,16,117,17,59,76,56,18,74,8,16,24
2016,2101,6,1,7,0,1,1,0,0,0,0,0,0
2016,2103,11,0,11,5,0,5,0,0,0,0,0,0
2016,2105,17,3,20,0,6,6,0,0,0,0,0,0
2016,2106,47,9,56,5,19,24,0,0,0,0,0,0
2016,2107,8,0,8,0,0,0,0,0,0,0,0,0
2016,2109,56,9,65,3,18,21,0,0,0,0,0,0
2016,2110,16,3,19,0,5,5,0,0,0,0,0,0
2016,2111,11,2,13,1,2,3,0,0,0,0,0,0
2016,2113,4,0,4,1,1,2,0,0,0,0,0,0
2016,2117,35,6,41,0,5,5,0,0,0,0,0,0
2016,2200,36,3,39,3,12,15,8,9,17,0,0,0
2016,2300,63,1,64,10,22,32,45,14,59,2,8,10
2016,2301,13,2,15,0,6,6,0,0,0,0,0,0
2016,2303,30,2,32,4,13,17,0,0,0,0,0,0
2016,2304,11,0,11,1,4,5,0,0,0,0,0,0
2016,2400,79,6,85,5,24,29,3,0,3,67,39,106
2016,2401,27,0,27,1,6,7,0,0,0,0,0,0
2016,2402,5,2,7,0,1,1,0,0,0,0,0,0
2016,2403,9,1,10,0,2,2,0,0,0,0,0,0
2016,2404,16,1,17,0,8,8,0,0,0,0,0,0
2016,2405,34,3,37,2,18,20,0,0,0,3,2,5
2016,2406,82,7,89,10,26,36,0,0,0,0,0,0
2016,2412,10,2,12,3,6,9,0,0,0,0,0,0
2016,2500,11,0,11,2,7,9,5,3,8,0,0,0
2016,2501,7,0,7,0,0,0,0,0,0,0,0,0
2016,2600,20,1,21,2,2,4,0,0,0,9,4,13
2016,2601,10,0,10,0,3,3,0,0,0,0,0,0
2016,2700,100,10,110,9,51,60,145,40,185,29,32,61
2016,2701,13,1,14,2,8,10,0,0,0,0,0,0
2016,2702,6,0,6,0,0,0,0,0,0,0,0,0
2016,2703,9,1,10,1,2,3,0,0,0,0,0,0
2016,2704,16,2,18,1,2,3,0,0,0,0,0,0
2016,2705,12,1,13,0,4,4,0,0,0,0,0,0
2016,2706,40,3,43,2,5,7,0,0,0,6,5,11
2016,2707,9,5,14,3,7,10,0,0,0,0,0,0
2016,2708,127,7,134,18,39,57,0,0,0,0,0,0
2016,2709,9,0,9,1,0,1,0,0,0,0,0,0
2016,2710,34,3,37,1,8,9,0,0,0,0,0,0
2016,2711,16,1,17,2,2,4,0,0,0,0,0,0
2016,2712,26,2,28,1,6,7,0,0,0,0,0,0
2016,2714,5,0,5,0,0,0,0,0,0,0,0,0
2016,2719,9,6,15,4,8,12,0,0,0,0,0,0
2016,2800,93,6,99,15,24,39,1,0,1,0,0,0
2016,2801,7,2,9,1,4,5,0,0,0,0,0,0
2016,2802,63,6,69,4,37,41,0,0,0,0,0,0
2016,2803,12,1,13,0,5,5,0,0,0,0,0,0
2016,2808,111,6,117,2,6,8,0,0,0,0,0,0
2016,2900,51,3,54,6,23,29,7,2,9,32,31,63
2016,2901,20,1,21,0,3,3,0,0,0,0,0,0
2016,2902,10,0,10,0,2,2,0,0,0,0,0,0
2016,2908,20,2,22,4,8,12,0,0,0,0,0,0
2016,3000,925,107,1032,648,673,1321,616,97,713,332,224,556
2016,3001,356,31,387,39,108,147,16,5,21,0,7,7
2016,3002,56,5,61,1,32,33,0,0,0,1,0,1
2016,3003,73,8,81,9,31,40,0,0,0,0,0,0
2016,3004,101,11,112,10,50,60,0,0,0,0,0,0
2016,3005,48,5,53,1,11,12,0,0,0,3,1,4
2016,3006,16,3,19,1,5,6,0,0,0,0,0,0
2016,3007,53,6,59,1,20,21,0,0,0,0,0,0
2016,3008,127,14,141,12,52,64,0,0,0,4,1,5
2016,3009,152,7,159,11,48,59,0,0,0,0,0,0
2016,3010,202,12,214,21,81,102,0,0,0,12,6,18
2016,3011,43,6,49,7,10,17,0,0,0,2,15,17
2016,3012,66,3,69,6,24,30,0,0,0,0,0,0
2016,3013,18,5,23,0,3,3,0,0,0,0,0,0
2016,3014,129,11,140,32,48,80,0,0,0,5,3,8
2016,3015,130,13,143,21,49,70,0,0,0,0,0,0
2016,3016,43,2,45,7,16,23,0,0,0,0,0,0
2016,3019,284,26,310,30,89,119,0,0,0,47,47,94
2016,3020,26,4,30,6,4,10,0,0,0,2,3,5
2016,3022,77,10,87,8,36,44,0,0,0,0,0,0
2016,3024,72,7,79,4,30,34,0,0,0,2,0,2
2016,3026,175,38,213,25,63,88,0,0,0,0,0,0
2016,3027,22,4,26,5,9,14,0,0,0,0,0,0
2016,3097,36,5,41,6,12,18,0,0,0,0,0,0
2016,3100,165,15,180,26,70,96,55,9,64,89,84,173
2016,3101,18,2,20,1,6,7,0,0,0,0,0,0
2016,3103,20,0,20,2,5,7,0,0,0,0,0,0
2016,3104,48,7,55,1,23,24,0,0,0,0,0,0
2016,3105,117,8,125,13,45,58,0,0,0,0,0,0
2016,3200,30,2,32,1,10,11,1,0,1,11,10,21
2016,3300,1471,149,1620,177,685,862,325,58,383,715,359,1074
2016,3301,23,4,27,2,14,16,0,0,0,0,0,0
2016,3302,36,2,38,4,14,18,0,0,0,0,0,0
2016,3303,21,0,21,5,5,10,0,0,0,0,0,0
2016,3306,20,4,24,3,3,6,0,0,0,0,0,0
2016,3308,60,2,62,5,25,30,0,0,0,0,0,0
2016,3309,57,6,63,7,29,36,0,0,0,0,0,0
2016,3311,81,7,88,10,29,39,0,0,0,0,0,0
2016,3313,312,38,350,33,120,153,0,0,0,0,0,0
2016,3315,143,15,158,8,53,61,0,0,0,4,2,6
2016,3325,46,3,49,5,20,25,0,0,0,0,0,0
2016,3342,81,8,89,3,36,39,0,0,0,0,0,0
2016,3344,17,1,18,1,5,6,0,0,0,0,0,0
2016,3397,28,3,31,4,9,13,0,0,0,0,0,0
2016,3400,595,105,700,131,229,360,445,102,547,90,226,316
2016,3401,59,11,70,0,25,25,0,0,0,0,0,0
2016,3402,29,4,33,4,12,16,0,0,0,0,0,0
2016,3404,547,105,652,101,201,302,0,0,0,0,0,0
2016,3408,21,1,22,7,7,14,0,0,0,0,0,0
2016,3414,18,4,22,3,1,4,0,0,0,0,0,0
2016,3420,3,1,4,0,1,1,0,0,0,0,0,0
2016,3422,408,95,503,8,26,34,0,0,0,0,0,0
2016,3477,66,6,72,9,14,23,0,0,0,0,0,0
2016,3496,76,12,88,7,39,46,0,0,0,0,0,0
2016,3499,6732,465,7197,1529,1865,3394,0,0,0,0,0,0
2016,3500,26,0,26,0,4,4,0,0,0,15,9,24
2016,3501,24,3,27,0,6,6,0,0,0,0,0,0
2016,3600,1043,151,1194,225,619,844,550,111,661,118,242,360
2016,3601,35,1,36,0,18,18,0,0,0,0,0,0
2016,3602,99,8,107,4,48,52,0,0,0,0,0,0
2016,3603,45,1,46,5,21,26,0,0,0,0,0,0
2016,3604,169,16,185,10,80,90,0,0,0,0,0,0
2016,3605,43,4,47,3,18,21,0,0,0,0,0,0
2016,3607,242,12,254,14,71,85,0,0,0,0,0,0
2016,3608,72,8,80,10,28,38,0,0,0,0,0,0
2016,3609,94,11,105,4,33,37,0,0,0,0,0,0
2016,3610,196,19,215,35,110,145,0,0,0,0,0,0
2016,3611,65,4,69,2,25,27,0,0,0,0,0,0
2016,3614,10,4,14,2,10,12,0,0,0,0,0,0
2016,3623,21,3,24,38,13,51,0,0,0,0,0,0
2016,3639,7,1,8,5,5,10,0,0,0,0,0,0
2016,3650,11,4,15,35,13,48,0,0,0,0,0,0
2016,3657,52,16,68,5,12,17,0,0,0,0,0,0
2016,3700,1191,179,1370,331,547,878,935,264,1199,304,503,807
2016,3701,93,10,103,14,33,47,0,0,0,0,0,0
2016,3702,196,29,225,10,60,70,0,0,0,5,5,10
2016,3703,35,7,42,4,17,21,0,0,0,0,0,0
2016,3705,111,10,121,11,47,58,0,0,0,0,0,0
2016,3706,141,15,156,6,49,55,0,0,0,0,0,0
2016,3708,63,5,68,6,23,29,0,0,0,0,0,0
2016,3709,80,6,86,5,29,34,0,0,0,0,0,0
2016,3710,183,21,204,11,63,74,0,0,0,0,0,0
2016,3711,1529,286,1815,260,447,707,0,0,0,0,0,0
2016,3714,19,5,24,6,19,25,0,0,0,0,0,0
2016,3715,112,18,130,15,23,38,0,0,0,0,0,0
2016,3732,19,2,21,1,4,5,0,0,0,0,0,0
2016,3797,30,6,36,18,15,33,0,0,0,0,0,0
2016,3800,290,63,353,76,94,170,408,69,477,20,7,27
2016,3801,1950,346,2296,284,312,596,0,0,0,0,0,0
2016,3803,22,2,24,12,11,23,0,0,0,0,0,0
2016,3816,0,0,0,0,0,0,0,0,0,0,0,0
2016,3897,50,3,53,65,21,86,0,0,0,0,0,0
2016,3900,228,18,246,47,102,149,26,2,28,178,98,276
2016,3901,10,0,10,0,1,1,0,0,0,0,0,0
2016,3902,62,5,67,4,26,30,0,0,0,0,0,0
2016,3903,57,2,59,4,22,26,0,0,0,1,0,1
2016,3904,21,1,22,1,8,9,0,0,0,0,0,0
2016,3905,370,42,412,52,146,198,0,0,0,0,0,0
2016,3906,78,7,85,7,34,41,0,0,0,0,0,0
2016,3915,24,9,33,1,7,8,0,0,0,0,0,0
2016,4000,153,3,156,12,48,60,103,36,139,8,33,41
2016,4001,25,1,26,1,3,4,0,0,0,0,0,0
2016,4002,16,2,18,2,6,8,0,0,0,0,0,0
2016,4003,15,2,17,0,2,2,0,0,0,0,0,0
2016,4004,30,1,31,1,12,13,0,0,0,0,0,0
2016,4005,17,2,19,0,12,12,0,0,0,0,0,0
2016,4006,49,6,55,2,21,23,0,0,0,0,0,0
2016,4007,17,2,19,4,12,16,0,0,0,0,0,0
2016,4008,25,3,28,1,9,10,0,0,0,0,0,0
2016,4016,100,25,125,0,9,9,0,0,0,0,0,0
2016,4019,7,0,7,2,3,5,0,0,0,0,0,0
2016,4100,224,19,243,54,89,143,74,13,87,133,75,208
2016,4101,18,1,19,1,7,8,0,0,0,0,0,0
2016,4102,28,2,30,7,7,14,0,0,0,0,0,0
2016,4103,12,3,15,0,3,3,0,0,0,0,0,0
2016,4104,32,4,36,5,15,20,0,0,0,0,0,0
2016,4105,16,2,18,0,6,6,0,0,0,0,0,0
2016,4106,90,10,100,13,20,33,0,0,0,0,0,0
2016,4108,23,2,25,3,5,8,0,0,0,0,0,0
2016,4109,39,8,47,6,14,20,0,0,0,0,0,0
2016,4111,31,2,33,0,2,2,0,0,0,0,0,0
2016,4113,82,9,91,4,21,25,0,0,0,0,0,0
2016,4114,45,4,49,3,13,16,0,0,0,0,0,0
2016,4116,98,13,111,6,31,37,0,0,0,0,0,0
2016,4117,70,10,80,8,22,30,0,0,0,0,0,0
2016,4119,9,1,10,0,1,1,0,0,0,0,0,0
2016,4120,30,6,36,2,12,14,0,0,0,0,0,0
2016,4127,28,5,33,1,6,7,0,0,0,0,0,0
2016,4200,240,14,254,25,80,105,162,36,198,32,28,60
2016,4201,11,0,11,0,2,2,0,0,0,0,0,0
2016,4202,42,3,45,0,18,18,0,0,0,5,0,5
2016,4203,116,24,140,21,44,65,0,0,0,0,0,0
2016,4204,105,6,111,11,44,55,0,0,0,0,0,0
2016,4211,4,1,5,4,1,5,0,0,0,0,0,0
2016,4297,32,7,39,8,7,15,0,0,0,0,0,0
2016,4300,427,68,495,52,112,164,605,157,762,86,148,234
2016,4302,39,3,42,4,21,25,0,0,0,0,0,0
2016,4304,55,7,62,3,18,21,0,0,0,4,0,4
2016,4305,22,5,27,3,12,15,0,0,0,0,0,0
2016,4307,33,4,37,2,15,17,0,0,0,0,0,0
2016,4308,75,10,85,5,19,24,0,0,0,0,0,0
2016,4310,35,4,39,5,15,20,0,0,0,0,0,0
2016,4311,78,8,86,11,32,43,0,0,0,0,0,0
2016,4312,69,10,79,20,38,58,0,0,0,0,0,0
2016,4313,841,98,939,116,297,413,0,0,0,0,0,0
2016,4314,131,13,144,14,52,66,0,0,0,3,2,5
2016,4316,187,22,209,16,53,69,0,0,0,0,0,0
2016,4317,22,4,26,27,17,44,0,0,0,0,0,0
2016,4320,5,2,7,5,3,8,0,0,0,0,0,0
2016,4321,9,0,9,3,1,4,0,0,0,0,0,0
2016,4327,10,0,10,3,0,3,0,0,0,0,0,0
2016,4400,107,27,134,12,44,56,8,0,8,91,43,134
2016,4401,19,2,21,5,3,8,0,0,0,0,0,0
2016,4402,82,11,93,4,18,22,0,0,0,0,0,0
2016,4403,62,6,68,3,15,18,0,0,0,0,0,0
2016,4404,19,0,19,2,5,7,0,0,0,0,0,0
2016,4497,15,2,17,4,8,12,0,0,0,0,0,0
2016,4500,83,3,86,7,36,43,54,13,67,9,11,20
2016,4501,16,1,17,0,6,6,0,0,0,0,0,0
2016,4502,90,8,98,9,24,33,0,0,0,0,0,0
2016,4591,15,4,19,2,1,3,0,0,0,0,0,0
2016,4600,11,0,11,0,0,0,0,0,0,5,1,6
2016,4700,50,2,52,3,13,16,27,7,34,3,3,6
2016,4703,3,0,3,0,0,0,0,0,0,0,0,0
2016,4706,8,1,9,1,2,3,0,0,0,0,0,0
2016,4707,1,0,1,0,0,0,0,0,0,0,0,0
2016,4708,8,0,8,2,3,5,0,0,0,0,0,0
2016,4709,14,0,14,1,5,6,0,0,0,0,0,0
2016,4710,3,0,3,0,0,0,0,0,0,0,0,0
2016,4800,112,11,123,42,84,126,1,0,1,195,81,276
2016,4801,28,5,33,0,16,16,0,0,0,0,0,0
2016,4802,17,2,19,0,5,5,0,0,0,0,0,0
2016,4803,100,14,114,12,43,55,0,0,0,0,0,0
2016,4804,9,3,12,0,2,2,0,0,0,0,0,0
2016,4805,16,5,21,0,12,12,0,0,0,0,0,0
2016,4806,89,10,99,5,46,51,0,0,0,0,0,0
2016,4807,102,8,110,8,32,40,0,0,0,0,0,0
2016,4900,217,15,232,26,73,99,0,0,0,0,0,0
2016,4901,14,1,15,0,7,7,0,0,0,0,0,0
2016,4902,9,1,10,0,5,5,0,0,0,0,0,0
2016,4903,14,3,17,1,8,9,0,0,0,0,0,0
2016,4904,53,6,59,5,21,26,0,0,0,0,0,0
2016,4905,159,13,172,21,58,79,0,0,0,0,0,0
2016,4906,13,1,14,1,4,5,0,0,0,0,0,0
2016,4908,55,3,58,2,22,24,0,0,0,0,0,0
2016,4909,11,3,14,1,6,7,0,0,0,0,0,0
2016,4914,13,0,13,6,7,13,0,0,0,0,0,0
2016,5000,196,9,205,15,86,101,212,39,251,11,43,54
2016,5001,45,1,46,4,12,16,0,0,0,0,0,0
2016,5002,199,15,214,16,70,86,0,0,0,0,0,0
2016,5003,11,1,12,0,3,3,0,0,0,0,0,0
2016,5004,20,2,22,1,9,10,0,0,0,0,0,0
2016,5007,71,7,78,6,33,39,0,0,0,0,0,0
2016,5010,8,3,11,3,5,8,0,0,0,0,0,0
2016,5100,43,4,47,3,21,24,40,18,58,0,4,4
2016,5102,48,4,52,6,20,26,0,0,0,0,0,0
2016,5200,37,4,41,8,20,28,27,11,38,3,3,6
2016,5201,12,0,12,2,5,7,0,0,0,0,0,0
2016,5202,22,2,24,3,11,14,0,0,0,0,0,0
2016,5300,19,1,20,0,5,5,10,5,15,0,4,4
2016,5400,234,33,267,25,87,112,218,46,264,40,64,104
2016,5401,35,3,38,3,8,11,0,0,0,0,0,0
2016,5402,12,4,16,0,2,2,0,0,0,0,0,0
2016,5403,11,2,13,1,1,2,0,0,0,0,0,0
2016,5404,13,1,14,0,5,5,0,0,0,0,0,0
2016,5405,52,8,60,10,16,26,0,0,0,0,0,0
2016,5406,64,8,72,21,16,37,0,0,0,0,0,0
2016,5407,121,14,135,9,56,65,0,0,0,0,0,0
2016,5408,8,0,8,0,1,1,0,0,0,0,0,0
2016,5411,5,0,5,0,1,1,0,0,0,0,0,0
2016,5500,60,2,62,2,19,21,0,0,0,25,18,43
2016,5501,9,1,10,1,6,7,0,0,0,0,0,0
2016,5600,494,56,550,82,211,293,175,31,206,107,91,198
2016,5604,200,27,227,20,84,104,0,0,0,3,3,6
2016,5605,19,2,21,2,4,6,0,0,0,0,0,0
2016,5606,29,1,30,2,6,8,0,0,0,0,0,0
2016,5608,114,11,125,5,35,40,0,0,0,0,0,0
2016,5609,112,10,122,14,41,55,0,0,0,0,0,0
2016,5622,14,1,15,6,8,14,0,0,0,0,0,0
2016,5680,16,0,16,0,1,1,0,0,0,0,0,0
2016,5700,74,9,83,5,30,35,6,0,6,81,58,139
2016,5701,55,5,60,5,26,31,0,0,0,0,0,0
2016,5702,10,1,11,0,2,2,0,0,0,0,0,0
2016,5703,53,8,61,0,14,14,0,0,0,0,0,0
2016,5704,62,7,69,3,17,20,0,0,0,0,0,0
2016,5797,38,8,46,12,15,27,0,0,0,0,0,0
2016,5800,51,4,55,2,20,22,43,20,63,9,13,22
2016,5801,17,1,18,1,6,7,0,0,0,0,0,0
2016,5802,8,0,8,0,1,1,0,0,0,0,0,0
2016,10M1,188,26,214,7,10,17,0,0,0,0,0,0
2016,190C,21,2,23,4,5,9,0,0,0,0,0,0
2016,190R,6,0,6,2,3,5,0,0,0,0,0,0
2016,340H,112,16,128,20,63,83,0,0,0,0,0,0
2017,100,495,64,559,103,231,334,365,74,439,95,140,235
2017,101,69,10,79,4,28,32,0,0,0,0,0,0
2017,102,24,0,24,1,7,8,0,0,0,0,0,0
2017,103,133,28,161,16,57,73,0,1,1,6,6,12
2017,104,38,3,41,3,11,14,0,0,0,0,0,0
2017,105,161,16,177,14,70,84,1,0,1,8,8,16
2017,106,166,23,189,15,73,88,0,0,0,15,9,24
2017,107,81,9,90,8,40,48,0,0,0,0,0,0
2017,108,45,11,56,6,16,22,0,0,0,0,0,0
2017,109,647,97,744,62,231,293,0,0,0,0,0,0
2017,110,14,4,18,1,6,7,0,0,0,0,0,0
2017,111,66,10,76,3,30,33,0,0,0,0,0,0
2017,112,86,7,93,3,29,32,0,0,0,5,5,10
2017,113,68,8,76,9,15,24,0,0,0,0,0,0
2017,114,53,6,59,8,25,33,0,0,0,0,0,0
2017,115,12,3,15,9,6,15,0,0,0,0,0,0
2017,197,44,13,57,42,24,66,0,0,0,0,0,0
2017,200,12,0,12,2,3,5,0,0,0,0,0,0
2017,300,44,2,46,3,14,17,1,0,1,14,7,21
2017,302,7,0,7,0,0,0,0,0,0,0,0,0
2017,303,6,2,8,0,1,1,0,0,0,0,0,0
2017,305,4,0,4,0,0,0,0,0,0,0,0,0
2017,400,93,5,98,17,38,55,0,0,0,69,41,110
2017,402,84,5,89,8,34,42,0,0,0,5,2,7
2017,403,14,0,14,0,5,5,0,0,0,0,0,0
2017,404,18,1,19,6,10,16,0,0,0,0,0,0
2017,405,18,1,19,3,10,13,0,0,0,0,0,0
2017,497,14,1,15,3,6,9,0,0,0,0,0,0
2017,500,45,5,50,6,19,25,2,0,2,16,13,29
2017,501,5,1,6,0,1,1,0,0,0,0,0,0
2017,600,24,2,26,2,17,19,10,3,13,0,1,1
2017,601,9,0,9,0,1,1,0,0,0,0,0,0
2017,602,9,2,11,0,2,2,0,0,0,0,0,0
2017,700,257,40,297,51,157,208,275,56,331,59,61,120
2017,701,91,5,96,3,30,33,0,0,0,2,1,3
2017,702,59,5,64,3,27,30,0,0,0,0,0,0
2017,703,10,1,11,0,2,2,0,0,0,0,0,0
2017,704,135,17,152,2,47,49,0,0,0,3,1,4
2017,705,37,3,40,1,6,7,0,0,0,0,0,0
2017,706,19,1,20,0,2,2,0,0,0,0,0,0
2017,707,20,2,22,2,11,13,0,0,0,0,0,0
2017,708,69,10,79,2,17,19,0,0,0,0,0,0
2017,709,38,6,44,4,11,15,0,0,0,0,0,0
2017,710,149,28,177,12,50,62,0,0,0,1,4,5
2017,711,41,1,42,8,14,22,0,0,0,1,1,2
2017,712,66,17,83,10,29,39,0,0,0,0,0,0
2017,713,6,1,7,0,0,0,0,0,0,0,0,0
2017,714,30,2,32,1,9,10,0,0,0,0,0,0
2017,716,10,2,12,0,2,2,0,0,0,0,0,0
2017,718,169,18,187,53,42,95,0,0,0,0,0,0
2017,721,18,3,21,5,6,11,0,0,0,0,0,0
2017,724,58,7,65,6,12,18,0,0,0,0,0,0
2017,800,21,1,22,3,6,9,1,0,1,11,10,21
2017,801,9,1,10,0,1,1,0,0,0,0,0,0
2017,900,137,8,145,16,56,72,14,2,16,76,45,121
2017,901,16,2,18,0,8,8,0,0,0,0,0,0
2017,902,32,4,36,3,17,20,0,0,0,0,0,0
2017,1000,359,43,402,53,121,174,9,1,10,375,150,525
2017,1001,87,13,100,15,50,65,0,0,0,2,0,2
2017,1002,17,0,17,2,6,8,0,0,0,0,0,0
2017,1003,10,1,11,0,4,4,0,0,0,0,0,0
2017,1004,14,0,14,0,1,1,0,0,0,0,0,0
2017,1005,700,86,786,99,174,273,0,0,0,0,0,0
2017,1006,11,2,13,1,6,7,0,0,0,0,0,0
2017,1007,17,4,21,1,2,3,0,0,0,0,0,0
2017,1008,15,0,15,0,3,3,0,0,0,0,0,0
2017,1009,10,1,11,0,2,2,0,0,0,0,0,0
2017,1010,10,1,11,0,1,1,0,0,0,0,0,0
2017,1011,1,3,4,0,0,0,12,0,12,0,0,0
2017,1012,26,2,28,2,12,14,0,0,0,0,0,0
2017,1013,33,4,37,3,1,4,0,0,0,0,0,0
2017,1015,29,3,32,1,8,9,0,0,0,0,0,0
2017,1017,17,1,18,1,3,4,0,0,0,0,0,0
2017,1097,22,5,27,2,11,13,0,0,0,0,0,0
2017,1100,23,3,26,1,12,13,1,0,1,14,8,22
2017,1101,10,0,10,1,2,3,0,0,0,0,0,0
2017,1102,0,0,0,0,0,0,0,0,0,0,0,0
2017,1200,80,12,92,14,33,47,61,28,89,6,8,14
2017,1201,20,3,23,2,11,13,0,0,0,0,0,0
2017,1203,43,4,47,2,19,21,0,0,0,0,0,0
2017,1204,3,2,5,0,0,0,0,0,0,0,0,0
2017,1205,16,1,17,0,10,10,0,0,0,0,0,0
2017,1207,4,1,5,0,0,0,0,0,0,0,0,0
2017,1208,10,2,12,2,6,8,0,0,0,0,0,0
2017,1300,93,6,99,14,38,52,73,17,90,13,27,40
2017,1301,33,2,35,2,12,14,0,0,0,0,0,0
2017,1302,18,2,20,3,10,13,0,0,0,0,0,0
2017,1304,45,2,47,5,14,19,0,0,0,0,0,0
2017,1306,13,2,15,2,1,3,0,0,0,0,0,0
2017,1307,6,0,6,0,0,0,0,0,0,0,0,0
2017,1400,24,0,24,2,8,10,12,0,12,9,8,17
2017,1401,12,0,12,1,4,5,0,0,0,0,0,0
2017,1500,305,20,325,71,168,239,401,86,487,30,70,100
2017,1501,16,2,18,2,6,8,0,0,0,0,0,0
2017,1502,332,32,364,32,118,150,0,0,0,0,0,0
2017,1503,47,1,48,9,12,21,0,0,0,0,0,0
2017,1505,12,1,13,0,7,7,0,0,0,0,0,0
2017,1506,29,3,32,5,13,18,0,0,0,0,0,0
2017,1507,21,4,25,4,6,10,0,0,0,0,0,0
2017,1508,15,2,17,0,8,8,0,0,0,0,0,0
2017,1509,12,3,15,2,7,9,0,0,0,0,0,0
2017,1511,16,0,16,2,8,10,0,0,0,0,0,0
2017,1514,4,0,4,0,0,0,0,0,0,0,0,0
2017,1515,5,0,5,0,1,1,0,0,0,0,0,0
2017,1597,11,2,13,2,7,9,0,0,0,0,0,0
2017,1600,65,8,73,4,43,47,0,0,0,91,67,158
2017,1601,15,1,16,4,9,13,0,0,0,0,0,0
2017,1602,51,3,54,3,25,28,0,0,0,0,0,0
2017,1603,31,2,33,1,6,7,0,0,0,0,0,0
2017,1607,12,5,17,0,2,2,0,0,0,0,0,0
2017,1700,42,5,47,1,20,21,0,0,0,39,24,63
2017,1701,11,1,12,0,1,1,0,0,0,0,0,0
2017,1702,16,1,17,0,6,6,0,0,0,0,0,0
2017,1800,28,4,32,3,7,10,23,9,32,4,7,11
2017,1801,13,1,14,0,3,3,0,0,0,0,0,0
2017,1900,5391,1150,6541,1668,2634,4302,2337,535,2872,951,1055,2006
2017,1901,69,8,77,7,32,39,0,0,0,0,0,0
2017,1902,62,4,66,2,24,26,0,0,0,0,1,1
2017,1905,53,6,59,5,22,27,0,0,0,1,0,1
2017,1906,66,3,69,2,23,25,0,0,0,0,0,0
2017,1907,23,4,27,4,8,12,0,0,0,3,1,4
2017,1909,48,2,50,5,16,21,0,0,0,1,0,1
2017,1910,121,12,133,27,55,82,0,0,0,1,0,1
2017,1912,136,21,157,24,49,73,0,0,0,6,3,9
2017,1913,32,5,37,5,13,18,0,0,0,1,4,5
2017,1916,57,0,57,4,22,26,0,0,0,2,2,4
2017,1918,99,6,105,14,22,36,0,0,0,3,1,4
2017,1920,94,16,110,10,29,39,0,0,0,5,0,5
2017,1922,108,10,118,10,29,39,0,0,0,5,2,7
2017,1923,55,3,58,1,9,10,0,0,0,5,2,7
2017,1924,83,9,92,2,16,18,0,0,0,1,5,6
2017,1925,209,24,233,16,59,75,0,0,0,11,8,19
2017,1926,48,4,52,5,21,26,0,0,0,2,3,5
2017,1928,80,10,90,9,28,37,1,0,1,7,4,11
2017,1929,33,4,37,12,6,18,0,0,0,2,7,9
2017,1931,49,3,52,10,13,23,0,0,0,4,2,6
2017,1933,155,20,175,5,33,38,0,0,0,1,5,6
2017,1934,24,2,26,0,6,6,0,0,0,0,0,0
2017,1938,35,5,40,4,16,20,0,0,0,0,0,0
2017,1941,711,83,794,115,206,321,5,0,5,38,22,60
2017,1942,8084,1836,9920,938,1548,2486,62,6,68,253,130,383
2017,1944,48,11,59,11,21,32,0,0,0,3,4,7
2017,1946,44,6,50,3,22,25,0,0,0,1,3,4
2017,1947,58,7,65,3,20,23,0,0,0,2,4,6
2017,1948,60,10,70,7,20,27,0,0,0,2,3,5
2017,1951,22,3,25,0,4,4,3,5,8,0,0,0
2017,1953,202,27,229,27,56,83,0,0,0,11,11,22
2017,1955,134,13,147,21,71,92,0,0,0,7,7,14
2017,1956,92,7,99,11,38,49,0,0,0,4,6,10
2017,1961,25,3,28,1,3,4,0,0,0,4,4,8
2017,1962,52,2,54,2,13,15,0,0,0,0,0,0
2017,1963,20,5,25,0,6,6,0,0,0,0,0,0
2017,1965,183,22,205,77,75,152,1,0,1,10,5,15
2017,1966,12,4,16,0,4,4,0,0,0,0,0,0
2017,1967,30,3,33,2,5,7,0,0,0,1,6,7
2017,1969,72,7,79,4,27,31,0,0,0,4,2,6
2017,1970,32,0,32,1,10,11,0,0,0,0,0,0
2017,1972,200,12,212,25,76,101,1,0,1,8,7,15
2017,1973,35,3,38,3,11,14,0,0,0,0,0,0
2017,1975,89,5,94,15,37,52,0,0,0,3,3,6
2017,1976,107,13,120,10,36,46,0,0,0,0,0,0
2017,1978,15,4,19,15,17,32,0,0,0,0,0,0
2017,1981,17,2,19,4,3,7,0,0,0,0,0,0
2017,1982,22,2,24,6,9,15,0,0,0,0,0,0
2017,1983,17,4,21,8,7,15,0,0,0,0,0,0
2017,1984,17,5,22,7,9,16,0,0,0,0,0,0
2017,1997,52,4,56,16,19,35,0,0,0,0,0,0
2017,2000,78,5,83,2,29,31,0,0,0,0,0,0
2017,2001,16,2,18,2,7,9,0,0,0,0,0,0
2017,2002,51,4,55,3,17,20,0,0,0,0,0,0
2017,2100,94,22,116,22,56,78,55,18,73,8,16,24
2017,2101,6,1,7,0,1,1,0,0,0,0,0,0
2017,2103,11,0,11,5,0,5,0,0,0,0,0,0
2017,2105,18,3,21,1,5,6,0,0,0,0,0,0
2017,2106,46,8,54,8,18,26,0,0,0,0,0,0
2017,2107,8,0,8,0,0,0,0,0,0,0,0,0
2017,2109,58,8,66,2,20,22,0,0,0,0,0,0
2017,2110,17,3,20,1,5,6,0,0,0,0,0,0
2017,2111,9,1,10,1,3,4,0,0,0,0,0,0
2017,2113,6,0,6,1,1,2,0,0,0,0,0,0
2017,2117,32,8,40,1,4,5,0,0,0,0,0,0
2017,2200,37,4,41,2,13,15,10,9,19,0,0,0
2017,2300,74,1,75,18,35,53,42,11,53,2,6,8
2017,2301,13,2,15,0,6,6,0,0,0,0,0,0
2017,2303,31,2,33,4,14,18,0,0,0,0,0,0
2017,2304,9,0,9,2,3,5,0,0,0,0,0,0
2017,2400,96,7,103,3,22,25,3,0,3,79,32,111
2017,2401,25,0,25,2,8,10,0,0,0,0,0,0
2017,2402,4,2,6,0,1,1,0,0,0,0,0,0
2017,2403,8,1,9,1,1,2,0,0,0,0,0,0
2017,2404,19,1,20,0,9,9,0,0,0,0,0,0
2017,2405,37,3,40,2,17,19,0,0,0,3,2,5
2017,2406,80,7,87,10,24,34,0,0,0,0,0,0
2017,2412,11,3,14,5,6,11,0,0,0,0,0,0
2017,2500,10,0,10,2,7,9,4,6,10,0,0,0
2017,2501,7,0,7,0,0,0,0,0,0,0,0,0
2017,2600,21,1,22,2,1,3,0,0,0,9,6,15
2017,2601,10,0,10,0,3,3,0,0,0,0,0,0
2017,2700,101,7,108,16,54,70,150,38,188,39,41,80
2017,2701,12,1,13,1,7,8,0,0,0,0,0,0
2017,2702,6,0,6,0,0,0,0,0,0,0,0,0
2017,2703,9,1,10,1,2,3,0,0,0,0,0,0
2017,2704,20,0,20,0,3,3,0,0,0,0,0,0
2017,2705,16,1,17,0,3,3,0,0,0,0,0,0
2017,2706,45,5,50,3,4,7,0,0,0,7,5,12
2017,2707,14,5,19,2,9,11,0,0,0,0,0,0
2017,2708,136,10,146,23,42,65,0,0,0,0,0,0
2017,2709,13,0,13,1,0,1,0,0,0,0,0,0
2017,2710,28,3,31,4,8,12,0,0,0,0,0,0
2017,2711,14,1,15,2,2,4,0,0,0,0,0,0
2017,2712,23,4,27,1,5,6,0,0,0,0,0,0
2017,2714,5,0,5,0,0,0,0,0,0,0,0,0
2017,2719,9,5,14,5,7,12,0,0,0,0,0,0
2017,2800,94,6,100,12,20,32,1,0,1,0,0,0
2017,2801,9,2,11,1,4,5,0,0,0,0,0,0
2017,2802,68,4,72,6,42,48,0,0,0,0,0,0
2017,2803,10,2,12,0,5,5,0,0,0,0,0,0
2017,2808,109,6,115,3,8,11,0,0,0,0,0,0
2017,2900,54,5,59,7,25,32,3,0,3,32,30,62
2017,2901,23,1,24,0,3,3,0,0,0,0,0,0
2017,2902,11,0,11,0,2,2,0,0,0,0,0,0
2017,2908,22,1,23,4,9,13,0,0,0,0,0,0
2017,3000,952,127,1079,660,666,1326,663,101,764,362,224,586
2017,3001,364,33,397,40,135,175,14,8,22,0,8,8
2017,3002,55,3,58,3,30,33,0,0,0,1,0,1
2017,3003,73,11,84,11,33,44,0,0,0,0,0,0
2017,3004,109,10,119,11,53,64,0,0,0,0,0,0
2017,3005,46,4,50,1,9,10,0,0,0,3,2,5
2017,3006,16,2,18,1,5,6,0,0,0,0,0,0
2017,3007,48,5,53,0,18,18,0,0,0,0,0,0
2017,3008,127,14,141,14,53,67,0,0,0,4,1,5
2017,3009,154,8,162,11,49,60,0,0,0,0,0,0
2017,3010,196,12,208,22,80,102,0,0,0,12,5,17
2017,3011,42,6,48,10,28,38,0,0,0,1,1,2
2017,3012,63,4,67,6,25,31,0,0,0,0,0,0
2017,3013,18,5,23,0,3,3,0,0,0,0,0,0
2017,3014,122,13,135,29,45,74,0,0,0,5,3,8
2017,3015,140,13,153,16,50,66,0,0,0,0,0,0
2017,3016,43,2,45,4,16,20,0,0,0,3,1,4
2017,3019,298,27,325,32,99,131,0,0,0,40,41,81
2017,3020,28,3,31,6,4,10,0,0,0,2,4,6
2017,3022,84,10,94,8,36,44,0,0,0,0,0,0
2017,3024,68,8,76,4,31,35,0,0,0,2,0,2
2017,3026,176,35,211,25,66,91,0,0,0,0,0,0
2017,3027,24,6,30,5,9,14,0,0,0,0,0,0
2017,3096,9,0,9,2,3,5,0,0,0,0,0,0
2017,3097,34,4,38,4,13,17,0,0,0,0,0,0
2017,3100,166,14,180,25,73,98,62,8,70,93,97,190
2017,3101,16,2,18,1,6,7,0,0,0,0,0,0
2017,3103,21,0,21,2,5,7,0,0,0,0,0,0
2017,3104,47,4,51,1,26,27,0,0,0,0,0,0
2017,3105,116,9,125,16,50,66,0,0,0,0,0,0
2017,3200,32,1,33,1,9,10,1,0,1,15,7,22
2017,3300,1335,131,1466,185,646,831,310,55,365,665,316,981
2017,3301,22,3,25,1,12,13,0,0,0,0,0,0
2017,3302,36,3,39,6,11,17,0,0,0,0,0,0
2017,3303,21,0,21,5,5,10,0,0,0,0,0,0
2017,3306,20,4,24,3,5,8,0,0,0,0,0,0
2017,3308,73,4,77,9,22,31,0,0,0,0,0,0
2017,3309,57,6,63,8,28,36,0,0,0,0,0,0
2017,3311,86,8,94,10,26,36,0,0,0,3,0,3
2017,3313,310,40,350,29,117,146,0,0,0,0,0,0
2017,3315,139,15,154,8,50,58,0,0,0,3,2,5
2017,3325,47,4,51,5,18,23,0,0,0,0,0,0
2017,3342,79,6,85,3,39,42,0,0,0,0,0,0
2017,3344,18,2,20,2,5,7,0,0,0,0,0,0
2017,3397,30,4,34,2,10,12,0,0,0,0,0,0
2017,3400,587,101,688,130,225,355,482,109,591,98,223,321
2017,3401,61,11,72,0,32,32,0,0,0,0,0,0
2017,3402,25,5,30,7,14,21,0,0,0,0,0,0
2017,3404,543,101,644,78,203,281,0,0,0,0,0,0
2017,3408,21,1,22,8,8,16,0,0,0,0,0,0
2017,3414,18,4,22,2,4,6,0,0,0,0,0,0
2017,3420,3,1,4,0,1,1,0,0,0,0,0,0
2017,3422,427,96,523,6,18,24,0,0,0,0,0,0
2017,3477,73,6,79,15,15,30,0,0,0,0,0,0
2017,3496,76,12,88,9,35,44,0,0,0,0,0,0
2017,3499,6934,467,7401,1478,1858,3336,0,0,0,0,0,0
2017,3500,24,0,24,3,4,7,1,0,1,14,10,24
2017,3501,28,3,31,0,6,6,0,0,0,0,0,0
2017,3600,1092,159,1251,216,629,845,601,105,706,200,507,707
2017,3601,36,1,37,0,17,17,0,0,0,0,0,0
2017,3602,97,10,107,4,47,51,0,0,0,0,0,0
2017,3603,48,2,50,7,27,34,0,0,0,0,0,0
2017,3604,164,15,179,15,87,102,0,0,0,0,0,0
2017,3605,42,4,46,2,16,18,0,0,0,0,0,0
2017,3607,256,17,273,13,87,100,0,0,0,0,0,0
2017,3608,70,8,78,10,28,38,0,0,0,0,0,0
2017,3609,92,10,102,2,33,35,0,0,0,0,0,0
2017,3610,214,22,236,32,110,142,0,0,0,0,0,0
2017,3611,55,6,61,1,26,27,0,0,0,0,0,0
2017,3614,14,4,18,2,9,11,0,0,0,0,0,0
2017,3623,23,2,25,42,19,61,0,0,0,0,0,0
2017,3639,6,1,7,6,7,13,0,0,0,0,0,0
2017,3650,14,3,17,38,20,58,0,0,0,0,0,0
2017,3657,65,18,83,5,11,16,0,0,0,0,0,0
2017,3700,1210,190,1400,323,572,895,932,269,1201,293,501,794
2017,3701,104,11,115,12,33,45,0,0,0,0,0,0
2017,3702,193,30,223,10,63,73,0,0,0,9,4,13
2017,3703,33,10,43,3,17,20,0,0,0,0,0,0
2017,3705,106,10,116,9,47,56,0,0,0,0,0,0
2017,3706,145,14,159,6,49,55,0,0,0,0,0,0
2017,3708,63,4,67,7,22,29,0,0,0,0,0,0
2017,3709,78,7,85,5,29,34,0,0,0,0,0,0
2017,3710,186,18,204,13,65,78,0,0,0,0,0,0
2017,3711,1474,278,1752,169,361,530,0,0,0,0,0,0
2017,3714,22,4,26,7,16,23,0,0,0,0,0,0
2017,3715,106,19,125,20,22,42,0,0,0,0,0,0
2017,3732,17,2,19,1,4,5,0,0,0,0,0,0
2017,3797,32,6,38,20,15,35,0,0,0,0,0,0
2017,3800,328,71,399,72,92,164,397,66,463,21,7,28
2017,3801,1980,352,2332,276,327,603,0,0,0,0,0,0
2017,3803,25,2,27,13,11,24,0,0,0,0,0,0
2017,3897,47,3,50,70,21,91,0,0,0,0,0,0
2017,3900,251,20,271,41,103,144,26,2,28,181,100,281
2017,3901,10,0,10,0,1,1,0,0,0,0,0,0
2017,3902,60,5,65,5,25,30,0,0,0,0,0,0
2017,3903,60,2,62,5,21,26,0,0,0,2,0,2
2017,3904,21,1,22,1,8,9,0,0,0,0,0,0
2017,3905,397,44,441,59,145,204,0,0,0,0,0,0
2017,3906,78,7,85,6,36,42,0,0,0,0,0,0
2017,3915,22,9,31,2,10,12,0,0,0,0,0,0
2017,4000,150,1,151,14,54,68,84,35,119,9,28,37
2017,4001,24,1,25,1,3,4,0,0,0,0,0,0
2017,4002,16,2,18,2,6,8,0,0,0,0,0,0
2017,4003,15,2,17,0,4,4,0,0,0,0,0,0
2017,4004,31,2,33,1,11,12,0,0,0,0,0,0
2017,4005,19,3,22,0,11,11,0,0,0,0,0,0
2017,4006,50,7,57,2,21,23,0,0,0,0,0,0
2017,4007,18,2,20,4,12,16,0,0,0,0,0,0
2017,4008,25,3,28,1,8,9,0,0,0,0,0,0
2017,4016,124,27,151,1,13,14,0,0,0,0,0,0
2017,4019,7,0,7,2,3,5,0,0,0,0,0,0
2017,4100,226,24,250,55,96,151,82,9,91,149,69,218
2017,4101,16,2,18,0,7,7,0,0,0,0,0,0
2017,4102,27,2,29,6,8,14,0,0,0,0,0,0
2017,4103,12,3,15,0,3,3,0,0,0,0,0,0
2017,4104,34,5,39,5,15,20,0,0,0,0,0,0
2017,4105,17,2,19,0,6,6,0,0,0,0,0,0
2017,4106,88,10,98,12,16,28,0,0,0,0,0,0
2017,4108,24,3,27,3,4,7,0,0,0,0,0,0
2017,4109,38,5,43,5,13,18,0,0,0,0,0,0
2017,4111,31,2,33,0,3,3,0,0,0,0,0,0
2017,4113,77,8,85,4,24,28,0,0,0,0,0,0
2017,4114,44,3,47,3,14,17,0,0,0,0,0,0
2017,4116,94,13,107,8,31,39,0,0,0,0,0,0
2017,4117,70,10,80,9,25,34,0,0,0,0,0,0
2017,4119,6,2,8,0,1,1,0,0,0,0,0,0
2017,4120,30,6,36,5,9,14,0,0,0,0,0,0
2017,4127,30,5,35,3,8,11,0,0,0,0,0,0
2017,4200,240,14,254,27,83,110,164,40,204,29,29,58
2017,4201,11,1,12,0,2,2,0,0,0,0,0,0
2017,4202,38,3,41,3,17,20,0,0,0,4,0,4
2017,4203,116,24,140,17,47,64,0,0,0,0,0,0
2017,4204,107,8,115,11,45,56,0,0,0,0,0,0
2017,4211,3,1,4,4,1,5,0,0,0,0,0,0
2017,4297,31,8,39,12,7,19,0,0,0,0,0,0
2017,4300,397,58,455,59,123,182,635,174,809,90,148,238
2017,4302,41,3,44,3,21,24,0,0,0,0,0,0
2017,4304,56,6,62,6,26,32,0,0,0,3,2,5
2017,4305,27,4,31,3,12,15,0,0,0,0,0,0
2017,4307,32,4,36,1,16,17,0,0,0,0,0,0
2017,4308,73,8,81,2,16,18,0,0,0,0,0,0
2017,4310,35,4,39,4,17,21,0,0,0,0,0,0
2017,4311,76,11,87,17,30,47,0,0,0,0,0,0
2017,4312,65,12,77,27,38,65,0,0,0,0,0,0
2017,4313,842,98,940,110,296,406,0,0,0,0,0,0
2017,4314,136,17,153,16,52,68,0,0,0,4,2,6
2017,4316,190,22,212,14,47,61,0,0,0,0,0,0
2017,4317,23,4,27,25,17,42,0,0,0,0,0,0
2017,4320,5,2,7,5,5,10,0,0,0,0,0,0
2017,4321,9,0,9,3,1,4,0,0,0,0,0,0
2017,4327,13,0,13,8,1,9,0,0,0,0,0,0
2017,4400,106,26,132,13,40,53,8,1,9,85,47,132
2017,4401,19,2,21,4,3,7,0,0,0,0,0,0
2017,4402,78,12,90,8,19,27,0,0,0,0,0,0
2017,4403,68,5,73,4,15,19,0,0,0,0,0,0
2017,4404,18,1,19,2,6,8,0,0,0,0,0,0
2017,4497,17,3,20,3,8,11,0,0,0,0,0,0
2017,4500,65,1,66,6,38,44,50,13,63,7,4,11
2017,4501,19,1,20,0,6,6,0,0,0,0,0,0
2017,4502,93,10,103,7,24,31,0,0,0,0,0,0
2017,4591,16,4,20,4,2,6,0,0,0,0,0,0
2017,4600,8,0,8,0,0,0,0,0,0,3,2,5
2017,4700,43,1,44,3,14,17,27,4,31,3,3,6
2017,4703,3,0,3,0,0,0,0,0,0,0,0,0
2017,4706,7,1,8,0,3,3,0,0,0,0,0,0
2017,4707,2,0,2,0,0,0,0,0,0,0,0,0
2017,4708,9,0,9,1,4,5,0,0,0,0,0,0
2017,4709,14,0,14,3,4,7,0,0,0,0,0,0
2017,4710,4,0,4,0,0,0,0,0,0,0,0,0
2017,4800,112,10,122,43,82,125,2,0,2,203,82,285
2017,4801,24,6,30,0,16,16,0,0,0,0,0,0
2017,4802,19,2,21,0,5,5,0,0,0,0,0,0
2017,4803,99,12,111,13,43,56,0,0,0,0,0,0
2017,4804,10,2,12,0,2,2,0,0,0,0,0,0
2017,4805,19,6,25,0,12,12,0,0,0,0,0,0
2017,4806,91,11,102,4,49,53,0,0,0,0,0,0
2017,4807,100,7,107,5,36,41,0,0,0,0,0,0
2017,4900,216,13,229,22,75,97,0,0,0,201,87,288
2017,4901,12,1,13,1,7,8,0,0,0,0,0,0
2017,4902,9,1,10,0,5,5,0,0,0,0,0,0
2017,4903,15,3,18,0,9,9,0,0,0,0,0,0
2017,4904,52,6,58,4,21,25,0,0,0,0,0,0
2017,4905,160,13,173,21,57,78,0,0,0,0,0,0
2017,4906,13,1,14,1,5,6,0,0,0,0,0,0
2017,4908,55,3,58,4,21,25,0,0,0,0,0,0
2017,4909,11,1,12,0,4,4,0,0,0,0,0,0
2017,4914,13,0,13,5,8,13,0,0,0,0,0,0
2017,5000,181,9,190,14,91,105,252,42,294,16,47,63
2017,5001,45,2,47,3,10,13,0,0,0,0,0,0
2017,5002,194,19,213,24,74,98,0,0,0,0,0,0
2017,5003,9,2,11,0,3,3,0,0,0,0,0,0
2017,5004,20,2,22,1,10,11,0,0,0,0,0,0
2017,5007,72,6,78,2,37,39,0,0,0,0,0,0
2017,5010,9,3,12,3,5,8,0,0,0,0,0,0
2017,5100,43,4,47,3,18,21,41,18,59,0,4,4
2017,5102,51,4,55,5,25,30,0,0,0,0,0,0
2017,5200,39,4,43,6,22,28,29,12,41,3,3,6
2017,5201,11,0,11,4,5,9,0,0,0,0,0,0
2017,5202,23,2,25,5,10,15,0,0,0,0,0,0
2017,5300,18,1,19,0,8,8,11,5,16,1,3,4
2017,5400,260,37,297,13,84,97,202,48,250,33,70,103
2017,5401,33,3,36,2,8,10,0,0,0,0,0,0
2017,5402,12,4,16,0,2,2,0,0,0,0,0,0
2017,5403,12,2,14,0,1,1,0,0,0,0,0,0
2017,5404,14,1,15,0,4,4,0,0,0,0,0,0
2017,5405,50,6,56,11,18,29,0,0,0,0,0,0
2017,5406,64,8,72,21,16,37,0,0,0,0,0,0
2017,5407,123,16,139,15,53,68,0,0,0,0,0,0
2017,5408,9,0,9,0,1,1,0,0,0,0,0,0
2017,5411,6,0,6,0,1,1,0,0,0,0,0,0
2017,5500,62,2,64,2,20,22,0,0,0,29,18,47
2017,5501,9,0,9,0,7,7,0,0,0,0,0,0
2017,5600,411,51,462,101,197,298,263,42,305,84,98,182
2017,5604,207,31,238,22,82,104,0,0,0,3,5,8
2017,5605,19,3,22,2,5,7,0,0,0,0,0,0
2017,5606,26,1,27,2,5,7,0,0,0,0,0,0
2017,5608,119,15,134,4,39,43,0,0,0,0,0,0
2017,5609,114,9,123,15,43,58,0,0,0,0,0,0
2017,5622,14,0,14,6,8,14,0,0,0,0,0,0
2017,5680,14,0,14,0,1,1,0,0,0,0,0,0
2017,5700,76,10,86,4,31,35,1,0,1,78,57,135
2017,5701,51,7,58,8,25,33,0,0,0,0,0,0
2017,5702,11,0,11,0,2,2,0,0,0,0,0,0
2017,5703,56,8,64,0,15,15,0,0,0,0,0,0
2017,5704,65,6,71,3,18,21,0,0,0,0,0,0
2017,5797,36,9,45,9,16,25,0,0,0,0,0,0
2017,5800,51,4,55,3,25,28,41,21,62,6,5,11
2017,5801,17,1,18,2,5,7,0,0,0,0,0,0
2017,5802,8,0,8,0,1,1,0,0,0,0,0,0
2017,10M1,186,24,210,7,10,17,0,0,0,0,0,0
2017,190C,19,3,22,4,5,9,0,0,0,0,0,0
2017,190R,9,0,9,1,3,4,0,0,0,0,0,0
2017,340H,118,19,137,20,65,85,0,0,0,0,0,0
2018,100,460,55,515,129,229,358,355,69,424,104,136,240
2018,101,69,11,80,5,28,33,0,0,0,0,0,0
2018,102,22,0,22,2,6,8,0,0,0,0,0,0
2018,103,130,23,153,26,54,80,0,0,0,7,7,14
2018,104,35,3,38,3,11,14,0,0,0,0,0,0
2018,105,162,19,181,12,72,84,0,0,0,6,7,13
2018,106,156,21,177,13,80,93,0,0,0,15,7,22
2018,107,81,11,92,8,41,49,0,0,0,0,0,0
2018,108,42,12,54,5,16,21,0,0,0,0,0,0
2018,109,633,98,731,60,219,279,0,0,0,0,0,0
2018,110,13,4,17,1,9,10,0,0,0,0,0,0
2018,111,66,10,76,3,31,34,0,0,0,0,0,0
2018,112,80,7,87,3,28,31,0,0,0,4,5,9
2018,113,67,7,74,6,12,18,0,0,0,0,0,0
2018,114,52,10,62,8,19,27,0,0,0,0,0,0
2018,115,11,3,14,7,5,12,0,0,0,0,0,0
2018,197,38,12,50,41,19,60,0,0,0,0,0,0
2018,200,12,0,12,0,3,3,0,0,0,0,0,0
2018,300,43,2,45,3,15,18,1,0,1,18,8,26
2018,302,7,0,7,0,0,0,0,0,0,0,0,0
2018,303,7,1,8,0,1,1,0,0,0,0,0,0
2018,305,5,0,5,0,0,0,0,0,0,0,0,0
2018,400,93,5,98,17,38,55,0,0,0,69,41,110
2018,402,86,5,91,4,38,42,0,0,0,5,3,8
2018,403,13,0,13,0,5,5,0,0,0,0,0,0
2018,404,18,1,19,3,13,16,0,0,0,0,0,0
2018,405,19,1,20,3,11,14,0,0,0,0,0,0
2018,497,14,1,15,1,9,10,0,0,0,0,0,0
2018,500,41,6,47,3,18,21,1,0,1,13,17,30
2018,501,3,1,4,0,1,1,0,0,0,0,0,0
2018,600,26,2,28,2,15,17,8,4,12,0,1,1
2018,601,8,0,8,0,1,1,0,0,0,0,0,0
2018,602,9,2,11,0,2,2,0,0,0,0,0,0
2018,700,245,47,292,49,151,200,308,47,355,55,59,114
2018,701,91,6,97,4,29,33,0,0,0,2,1,3
2018,702,57,6,63,4,24,28,0,0,0,0,0,0
2018,703,8,3,11,0,2,2,0,0,0,0,0,0
2018,704,127,18,145,5,43,48,0,0,0,3,1,4
2018,705,36,4,40,2,5,7,0,0,0,0,0,0
2018,706,22,1,23,0,3,3,0,0,0,0,0,0
2018,707,24,2,26,3,13,16,0,0,0,0,0,0
2018,708,67,11,78,2,20,22,0,0,0,0,0,0
2018,709,35,6,41,5,10,15,0,0,0,0,0,0
2018,710,151,30,181,16,51,67,0,0,0,1,4,5
2018,711,46,3,49,5,14,19,0,0,0,0,4,4
2018,712,65,17,82,8,28,36,0,0,0,0,0,0
2018,713,5,1,6,0,0,0,0,0,0,0,0,0
2018,714,29,2,31,0,11,11,0,0,0,0,0,0
2018,716,9,2,11,0,1,1,0,0,0,0,0,0
2018,718,201,28,229,59,49,108,0,0,0,0,0,0
2018,721,18,3,21,6,5,11,0,0,0,0,0,0
2018,724,58,7,65,6,11,17,0,0,0,0,0,0
2018,800,20,2,22,1,9,10,1,0,1,13,7,20
2018,801,10,1,11,0,1,1,0,0,0,0,0,0
2018,900,126,9,135,18,52,70,14,1,15,79,42,121
2018,901,16,3,19,0,6,6,0,0,0,0,0,0
2018,902,29,3,32,7,17,24,0,0,0,0,0,0
2018,1000,382,38,420,55,115,170,9,1,10,393,159,552
2018,1001,88,13,101,16,47,63,0,0,0,2,0,2
2018,1002,15,0,15,1,7,8,0,0,0,0,0,0
2018,1003,10,1,11,0,5,5,0,0,0,0,0,0
2018,1004,11,0,11,0,1,1,0,0,0,0,0,0
2018,1005,728,83,811,80,172,252,0,0,0,0,0,0
2018,1006,9,3,12,1,7,8,0,0,0,0,0,0
2018,1007,16,4,20,1,2,3,0,0,0,0,0,0
2018,1008,17,0,17,0,3,3,0,0,0,0,0,0
2018,1009,12,0,12,0,2,2,0,0,0,0,0,0
2018,1010,10,1,11,0,1,1,0,0,0,0,0,0
2018,1011,18,0,18,1,4,5,0,0,0,0,0,0
2018,1012,28,2,30,2,14,16,0,0,0,0,0,0
2018,1013,32,5,37,3,1,4,0,0,0,0,0,0
2018,1015,31,3,34,2,9,11,0,0,0,0,0,0
2018,1017,14,1,15,1,4,5,0,0,0,0,0,0
2018,1097,20,5,25,3,10,13,0,0,0,0,0,0
2018,1100,27,4,31,2,13,15,2,0,2,12,8,20
2018,1101,9,1,10,1,1,2,0,0,0,0,0,0
2018,1200,89,12,101,9,31,40,58,27,85,7,7,14
2018,1201,23,2,25,1,11,12,0,0,0,0,0,0
2018,1203,42,4,46,2,20,22,0,0,0,0,0,0
2018,1204,3,2,5,0,0,0,0,0,0,0,0,0
2018,1205,18,1,19,0,6,6,0,0,0,0,0,0
2018,1207,3,0,3,0,0,0,0,0,0,0,0,0
2018,1208,10,2,12,2,6,8,0,0,0,0,0,0
2018,1300,88,6,94,13,37,50,77,16,93,13,25,38
2018,1301,31,3,34,2,12,14,0,0,0,0,0,0
2018,1302,20,1,21,4,9,13,0,0,0,0,0,0
2018,1303,5,0,5,0,0,0,0,0,0,0,0,0
2018,1304,41,2,43,6,18,24,0,0,0,0,0,0
2018,1306,14,2,16,2,2,4,0,0,0,0,0,0
2018,1307,5,0,5,0,0,0,0,0,0,0,0,0
2018,1400,26,0,26,3,18,21,10,0,10,11,9,20
2018,1401,12,0,12,1,7,8,0,0,0,0,0,0
2018,1500,314,23,337,41,164,205,391,78,469,52,100,152
2018,1501,13,2,15,2,5,7,0,0,0,0,0,0
2018,1502,360,38,398,21,118,139,0,0,0,0,0,0
2018,1503,47,2,49,6,12,18,0,0,0,0,0,0
2018,1505,9,2,11,0,5,5,0,0,0,0,0,0
2018,1506,28,4,32,2,16,18,0,0,0,0,0,0
2018,1507,21,4,25,2,7,9,0,0,0,0,0,0
2018,1508,14,1,15,0,10,10,0,0,0,0,0,0
2018,1509,16,3,19,1,6,7,0,0,0,0,0,0
2018,1511,9,0,9,3,5,8,2,1,3,0,0,0
2018,1514,4,0,4,0,0,0,0,0,0,0,0,0
2018,1515,4,0,4,0,1,1,0,0,0,0,0,0
2018,1521,27,1,28,0,3,3,0,0,0,0,0,0
2018,1597,10,3,13,1,7,8,0,0,0,0,0,0
2018,1600,74,9,83,4,41,45,0,0,0,93,65,158
2018,1601,15,0,15,3,8,11,0,0,0,0,0,0
2018,1602,53,4,57,1,24,25,0,0,0,0,0,0
2018,1603,31,2,33,1,7,8,0,0,0,0,0,0
2018,1607,12,5,17,0,2,2,0,0,0,0,0,0
2018,1700,45,4,49,2,17,19,0,0,0,0,0,0
2018,1701,10,1,11,0,1,1,0,0,0,0,0,0
2018,1702,17,2,19,3,9,12,0,0,0,0,0,0
2018,1800,26,3,29,4,11,15,18,10,28,4,8,12
2018,1801,12,1,13,0,2,2,0,0,0,0,0,0
2018,1900,5352,1150,6502,1673,2636,4309,2389,535,2924,951,1068,2019
2018,1901,70,7,77,9,36,45,0,0,0,0,0,0
2018,1902,64,4,68,2,23,25,0,0,0,0,1,1
2018,1905,53,7,60,6,22,28,0,0,0,0,0,0
2018,1906,66,2,68,3,23,26,0,0,0,7,0,7
2018,1907,21,6,27,4,5,9,0,0,0,0,0,0
2018,1909,46,2,48,5,14,19,0,0,0,1,0,1
2018,1910,118,15,133,27,54,81,0,0,0,1,0,1
2018,1912,128,20,148,18,57,75,0,0,0,5,3,8
2018,1913,32,7,39,5,14,19,0,0,0,2,2,4
2018,1916,56,1,57,5,17,22,0,0,0,3,1,4
2018,1918,97,6,103,10,21,31,0,0,0,3,1,4
2018,1920,99,17,116,14,30,44,0,0,0,5,0,5
2018,1922,109,10,119,8,28,36,0,0,0,5,2,7
2018,1923,49,2,51,8,13,21,0,0,0,5,2,7
2018,1924,83,11,94,3,16,19,0,0,0,4,4,8
2018,1925,203,20,223,19,63,82,0,0,0,10,8,18
2018,1926,43,5,48,11,16,27,0,0,0,3,1,4
2018,1928,77,8,85,10,28,38,1,0,1,6,4,10
2018,1929,31,4,35,14,4,18,0,0,0,3,6,9
2018,1931,57,3,60,16,9,25,0,0,0,4,1,5
2018,1933,164,21,185,5,36,41,0,0,0,2,7,9
2018,1934,23,3,26,0,7,7,0,0,0,0,0,0
2018,1938,35,5,40,1,16,17,0,0,0,0,0,0
2018,1941,734,85,819,82,199,281,5,0,5,36,23,59
2018,1942,8087,1836,9923,996,1633,2629,46,5,51,267,140,407
2018,1944,52,7,59,10,21,31,0,0,0,3,4,7
2018,1946,44,4,48,4,23,27,0,0,0,1,3,4
2018,1947,54,7,61,3,21,24,0,0,0,0,0,0
2018,1948,62,8,70,8,23,31,0,0,0,2,3,5
2018,1951,19,2,21,0,2,2,0,0,0,3,5,8
2018,1953,195,27,222,26,62,88,0,0,0,11,12,23
2018,1955,134,12,146,29,79,108,0,0,0,9,6,15
2018,1956,90,6,96,9,34,43,0,0,0,4,6,10
2018,1961,23,3,26,2,4,6,0,0,0,4,4,8
2018,1962,46,2,48,2,13,15,0,0,0,0,0,0
2018,1963,20,4,24,0,7,7,0,0,0,0,0,0
2018,1965,195,22,217,82,80,162,1,0,1,11,6,17
2018,1966,12,4,16,0,3,3,0,0,0,0,0,0
2018,1967,28,3,31,2,6,8,0,0,0,0,7,7
2018,1969,72,6,78,11,28,39,0,0,0,4,3,7
2018,1970,31,0,31,1,14,15,0,0,0,0,0,0
2018,1972,197,14,211,22,67,89,1,0,1,7,8,15
2018,1973,35,3,38,2,9,11,0,0,0,0,0,0
2018,1975,90,5,95,10,42,52,0,0,0,4,2,6
2018,1976,105,12,117,12,35,47,0,0,0,0,0,0
2018,1978,17,2,19,14,17,31,0,0,0,0,0,0
2018,1981,20,2,22,5,3,8,0,0,0,0,0,0
2018,1982,20,2,22,7,9,16,0,0,0,0,0,0
2018,1983,17,3,20,8,8,16,0,0,0,0,0,0
2018,1984,15,4,19,6,10,16,0,0,0,0,0,0
2018,1997,55,6,61,14,21,35,0,0,0,0,0,0
2018,2000,78,7,85,3,28,31,0,0,0,0,0,0
2018,2001,16,3,19,2,6,8,0,0,0,0,0,0
2018,2002,57,6,63,9,22,31,0,0,0,0,0,0
2018,2100,97,21,118,19,52,71,60,18,78,10,14,24
2018,2101,6,1,7,0,1,1,0,0,0,0,0,0
2018,2103,11,0,11,5,0,5,0,0,0,0,0,0
2018,2105,17,2,19,1,5,6,0,0,0,0,0,0
2018,2106,50,9,59,5,20,25,0,0,0,0,0,0
2018,2107,8,0,8,0,0,0,0,0,0,0,0,0
2018,2109,53,10,63,3,21,24,0,0,0,0,0,0
2018,2110,16,3,19,0,6,6,0,0,0,0,0,0
2018,2111,12,1,13,1,3,4,0,0,0,0,0,0
2018,2113,6,0,6,1,1,2,0,0,0,0,0,0
2018,2117,34,8,42,0,4,4,0,0,0,0,0,0
2018,2200,37,4,41,2,12,14,11,8,19,0,0,0
2018,2300,75,2,77,18,35,53,44,14,58,1,8,9
2018,2301,10,2,12,1,5,6,0,0,0,0,0,0
2018,2303,26,1,27,6,13,19,0,0,0,0,0,0
2018,2304,10,0,10,2,3,5,0,0,0,0,0,0
2018,2400,104,6,110,2,24,26,7,0,7,74,32,106
2018,2401,23,0,23,3,7,10,0,0,0,0,0,0
2018,2402,7,1,8,2,3,5,0,0,0,0,0,0
2018,2403,6,0,6,0,1,1,0,0,0,0,0,0
2018,2404,19,0,19,0,10,10,0,0,0,0,0,0
2018,2405,37,3,40,3,18,21,0,0,0,2,3,5
2018,2406,84,8,92,10,27,37,0,0,0,0,0,0
2018,2412,12,3,15,4,7,11,0,0,0,0,0,0
2018,2500,10,1,11,3,6,9,6,2,8,0,0,0
2018,2501,8,0,8,1,0,1,0,0,0,0,0,0
2018,2600,19,2,21,3,2,5,0,0,0,9,6,15
2018,2601,13,0,13,0,3,3,0,0,0,0,0,0
2018,2700,105,11,116,10,47,57,150,38,188,29,36,65
2018,2701,14,1,15,0,8,8,0,0,0,0,0,0
2018,2702,9,1,10,0,0,0,0,0,0,0,0,0
2018,2703,11,1,12,1,2,3,0,0,0,0,0,0
2018,2704,20,2,22,0,4,4,0,0,0,0,0,0
2018,2705,15,0,15,0,2,2,0,0,0,0,0,0
2018,2706,43,5,48,1,4,5,0,0,0,7,4,11
2018,2707,16,6,22,3,8,11,0,0,0,0,0,0
2018,2708,136,15,151,16,37,53,0,0,0,0,0,0
2018,2709,10,0,10,1,0,1,0,0,0,0,0,0
2018,2710,31,2,33,2,8,10,0,0,0,0,0,0
2018,2711,16,1,17,1,3,4,0,0,0,0,0,0
2018,2712,19,3,22,1,6,7,0,0,0,0,0,0
2018,2719,9,6,15,2,8,10,0,0,0,0,0,0
2018,2800,92,6,98,14,22,36,1,0,1,0,0,0
2018,2801,6,2,8,1,3,4,0,0,0,0,0,0
2018,2802,67,4,71,6,42,48,0,0,0,0,0,0
2018,2803,9,3,12,0,5,5,0,0,0,0,0,0
2018,2808,111,7,118,3,8,11,0,0,0,0,0,0
2018,2900,53,6,59,5,23,28,3,0,3,32,29,61
2018,2901,25,1,26,0,3,3,0,0,0,0,0,0
2018,2902,10,1,11,0,1,1,0,0,0,0,0,0
2018,2908,22,1,23,2,11,13,0,0,0,0,0,0
2018,3000,950,127,1077,602,673,1275,691,112,803,350,230,580
2018,3001,366,30,396,40,130,170,15,8,23,0,8,8
2018,3002,58,3,61,1,28,29,0,0,0,0,0,0
2018,3003,76,10,86,5,34,39,0,0,0,0,0,0
2018,3004,116,12,128,11,49,60,0,0,0,0,0,0
2018,3005,50,4,54,1,9,10,0,0,0,3,1,4
2018,3006,19,2,21,2,5,7,0,0,0,0,0,0
2018,3007,48,9,57,1,17,18,0,0,0,0,0,0
2018,3008,107,17,124,15,46,61,0,0,0,3,1,4
2018,3009,147,8,155,14,44,58,0,0,0,0,0,0
2018,3010,203,12,215,29,88,117,0,0,0,12,5,17
2018,3011,46,9,55,10,26,36,0,0,0,2,1,3
2018,3012,58,5,63,9,25,34,0,0,0,0,0,0
2018,3013,13,4,17,0,3,3,0,0,0,0,0,0
2018,3014,124,13,137,26,41,67,0,0,0,5,4,9
2018,3015,140,12,152,21,45,66,0,0,0,0,0,0
2018,3016,39,2,41,4,14,18,0,0,0,2,1,3
2018,3019,285,28,313,38,93,131,0,0,0,48,41,89
2018,3020,31,3,34,7,2,9,0,0,0,3,3,6
2018,3022,83,9,92,11,36,47,0,0,0,0,0,0
2018,3024,70,9,79,4,33,37,0,0,0,2,0,2
2018,3026,179,37,216,26,68,94,0,0,0,0,0,0
2018,3027,23,6,29,2,8,10,0,0,0,0,0,0
2018,3096,8,0,8,2,4,6,0,0,0,0,0,0
2018,3097,35,4,39,5,14,19,0,0,0,0,0,0
2018,3100,173,15,188,23,71,94,65,7,72,94,95,189
2018,3101,16,2,18,0,7,7,0,0,0,0,0,0
2018,3103,20,1,21,2,6,8,0,0,0,0,0,0
2018,3104,52,5,57,1,24,25,0,0,0,0,0,0
2018,3105,111,11,122,14,49,63,0,0,0,0,0,0
2018,3200,31,1,32,0,10,10,1,0,1,11,8,19
2018,3300,1304,134,1438,163,632,795,300,57,357,631,309,940
2018,3301,22,2,24,1,12,13,0,0,0,0,0,0
2018,3302,40,3,43,4,13,17,0,0,0,0,0,0
2018,3303,21,0,21,4,5,9,0,0,0,0,0,0
2018,3306,22,3,25,2,6,8,0,0,0,0,0,0
2018,3308,68,3,71,7,26,33,0,0,0,0,0,0
2018,3309,59,5,64,9,30,39,0,0,0,0,0,0
2018,3311,84,11,95,20,27,47,0,0,0,3,0,3
2018,3313,321,49,370,26,126,152,0,0,0,0,0,0
2018,3315,135,13,148,6,50,56,0,0,0,2,3,5
2018,3325,44,4,48,5,19,24,0,0,0,0,0,0
2018,3342,81,7,88,3,38,41,0,0,0,0,0,0
2018,3344,20,2,22,2,3,5,0,0,0,0,0,0
2018,3397,28,4,32,3,6,9,0,0,0,0,0,0
2018,3400,733,138,871,152,282,434,348,83,431,53,109,162
2018,3401,61,9,70,3,28,31,0,0,0,0,0,0
2018,3402,27,4,31,3,13,16,0,0,0,0,0,0
2018,3404,549,102,651,93,204,297,0,0,0,0,0,0
2018,3408,21,2,23,9,10,19,0,0,0,0,0,0
2018,3414,15,3,18,3,4,7,0,0,0,0,0,0
2018,3420,3,1,4,0,1,1,0,0,0,0,0,0
2018,3422,405,88,493,6,15,21,0,0,0,0,0,0
2018,3477,71,8,79,13,11,24,0,0,0,0,0,0
2018,3496,74,12,86,12,35,47,0,0,0,0,0,0
2018,3499,6832,454,7286,1392,1851,3243,0,0,0,0,0,0
2018,3500,23,0,23,2,4,6,1,0,1,14,10,24
2018,3501,27,5,32,0,8,8,0,0,0,0,0,0
2018,3600,1136,176,1312,152,580,732,592,114,706,186,471,657
2018,3601,33,2,35,0,16,16,0,0,0,0,0,0
2018,3602,92,10,102,3,48,51,0,0,0,0,0,0
2018,3603,48,3,51,5,21,26,0,0,0,0,0,0
2018,3604,171,12,183,16,91,107,0,0,0,0,0,0
2018,3605,41,3,44,1,15,16,0,0,0,0,0,0
2018,3607,260,20,280,14,87,101,0,0,0,0,0,0
2018,3608,74,8,82,7,34,41,0,0,0,0,0,0
2018,3609,86,10,96,1,28,29,0,0,0,0,0,0
2018,3610,215,23,238,35,121,156,0,0,0,0,0,0
2018,3611,58,7,65,1,33,34,0,0,0,0,0,0
2018,3614,12,5,17,2,13,15,0,0,0,0,0,0
2018,3623,25,4,29,46,23,69,0,0,0,0,0,0
2018,3626,13,0,13,0,0,0,0,0,0,0,0,0
2018,3639,6,1,7,4,6,10,0,0,0,0,0,0
2018,3650,13,3,16,40,20,60,0,0,0,0,0,0
2018,3657,83,23,106,7,10,17,0,0,0,0,0,0
2018,3700,1188,196,1384,345,552,897,908,280,1188,299,515,814
2018,3701,104,13,117,12,33,45,0,0,0,0,0,0
2018,3702,187,34,221,9,65,74,0,0,0,8,2,10
2018,3703,34,8,42,3,17,20,0,0,0,0,0,0
2018,3705,110,9,119,15,48,63,0,0,0,0,0,0
2018,3706,142,13,155,6,48,54,0,0,0,0,0,0
2018,3708,64,4,68,5,23,28,0,0,0,0,0,0
2018,3709,77,6,83,7,32,39,0,0,0,0,0,0
2018,3710,188,19,207,16,70,86,0,0,0,0,0,0
2018,3711,1448,283,1731,227,374,601,0,0,0,0,0,0
2018,3714,24,3,27,6,17,23,0,0,0,0,0,0
2018,3715,108,17,125,24,21,45,0,0,0,0,0,0
2018,3732,17,2,19,1,6,7,0,0,0,0,0,0
2018,3797,34,4,38,20,16,36,0,0,0,0,0,0
2018,3800,300,53,353,76,84,160,432,75,507,9,16,25
2018,3801,1966,340,2306,280,327,607,0,0,0,0,0,0
2018,3803,21,1,22,15,11,26,0,0,0,0,0,0
2018,3897,46,4,50,78,23,101,0,0,0,0,0,0
2018,3900,251,22,273,41,113,154,28,1,29,187,97,284
2018,3901,10,0,10,0,1,1,0,0,0,0,0,0
2018,3902,59,7,66,5,27,32,0,0,0,0,0,0
2018,3903,65,3,68,4,25,29,0,0,0,2,0,2
2018,3904,23,0,23,7,0,7,0,0,0,0,0,0
2018,3905,419,50,469,57,145,202,0,0,0,0,0,0
2018,3906,81,8,89,7,40,47,0,0,0,0,0,0
2018,3915,27,7,34,3,6,9,0,0,0,0,0,0
2018,4000,157,5,162,13,58,71,106,37,143,9,24,33
2018,4001,20,1,21,1,3,4,0,0,0,0,0,0
2018,4002,13,2,15,2,7,9,0,0,0,0,0,0
2018,4003,14,2,16,0,2,2,0,0,0,0,0,0
2018,4004,30,2,32,2,13,15,0,0,0,0,0,0
2018,4005,19,4,23,0,12,12,0,0,0,0,0,0
2018,4006,48,9,57,3,20,23,0,0,0,0,0,0
2018,4007,18,2,20,7,15,22,0,0,0,0,0,0
2018,4008,21,3,24,3,9,12,0,0,0,0,0,0
2018,4016,143,30,173,1,13,14,0,0,0,0,0,0
2018,4019,6,0,6,1,3,4,0,0,0,0,0,0
2018,4100,233,18,251,53,94,147,84,13,97,159,80,239
2018,4101,17,2,19,0,8,8,0,0,0,0,0,0
2018,4102,27,2,29,6,7,13,0,0,0,0,0,0
2018,4103,12,3,15,0,4,4,0,0,0,0,0,0
2018,4104,29,6,35,5,14,19,0,0,0,0,0,0
2018,4105,17,2,19,0,6,6,0,0,0,0,0,0
2018,4106,90,8,98,12,14,26,0,0,0,0,0,0
2018,4108,26,2,28,1,7,8,0,0,0,0,0,0
2018,4109,40,5,45,6,15,21,0,0,0,0,0,0
2018,4111,30,1,31,0,3,3,0,0,0,0,0,0
2018,4113,75,7,82,7,29,36,0,0,0,0,0,0
2018,4114,42,4,46,3,13,16,0,0,0,0,0,0
2018,4116,90,17,107,10,31,41,0,0,0,0,0,0
2018,4117,67,8,75,12,25,37,0,0,0,0,0,0
2018,4119,8,1,9,0,1,1,0,0,0,0,0,0
2018,4120,33,6,39,4,10,14,0,0,0,0,0,0
2018,4127,28,7,35,1,7,8,0,0,0,0,0,0
2018,4200,228,17,245,25,88,113,172,37,209,25,32,57
2018,4201,12,1,13,0,2,2,0,0,0,0,0,0
2018,4202,39,4,43,1,11,12,0,0,0,4,0,4
2018,4203,111,23,134,16,49,65,0,0,0,0,0,0
2018,4204,112,9,121,5,44,49,0,0,0,0,0,0
2018,4211,2,1,3,3,1,4,0,0,0,0,0,0
2018,4297,34,10,44,11,11,22,0,0,0,0,0,0
2018,4300,418,57,475,59,110,169,638,166,804,89,157,246
2018,4302,38,3,41,3,24,27,0,0,0,0,0,0
2018,4304,55,6,61,4,28,32,0,0,0,3,2,5
2018,4305,25,6,31,1,12,13,0,0,0,0,0,0
2018,4307,34,4,38,1,18,19,0,0,0,0,0,0
2018,4308,75,10,85,3,20,23,0,0,0,0,0,0
2018,4310,34,4,38,4,17,21,0,0,0,0,0,0
2018,4311,75,10,85,10,36,46,0,0,0,0,0,0
2018,4312,66,11,77,22,38,60,0,0,0,0,0,0
2018,4313,1002,111,1113,122,315,437,0,0,0,0,0,0
2018,4314,136,14,150,13,53,66,0,0,0,4,2,6
2018,4316,194,23,217,13,52,65,0,0,0,0,0,0
2018,4317,24,4,28,29,17,46,0,0,0,0,0,0
2018,4320,5,2,7,6,5,11,0,0,0,0,0,0
2018,4321,8,0,8,2,3,5,0,0,0,0,0,0
2018,4327,12,0,12,4,0,4,0,0,0,0,0,0
2018,4400,111,21,132,15,43,58,7,1,8,84,46,130
2018,4401,18,1,19,4,3,7,0,0,0,0,0,0
2018,4402,83,10,93,12,18,30,0,0,0,0,0,0
2018,4403,64,5,69,7,17,24,0,0,0,0,0,0
2018,4404,18,2,20,0,8,8,0,0,0,0,0,0
2018,4497,16,3,19,5,12,17,0,0,0,0,0,0
2018,4500,67,2,69,7,39,46,55,14,69,5,9,14
2018,4501,21,0,21,0,8,8,0,0,0,0,0,0
2018,4502,95,9,104,6,25,31,0,0,0,0,0,0
2018,4591,17,2,19,4,2,6,0,0,0,0,0,0
2018,4600,9,0,9,0,0,0,0,0,0,3,1,4
2018,4700,43,1,44,3,13,16,0,0,0,29,10,39
2018,4703,3,0,3,0,0,0,0,0,0,0,0,0
2018,4706,7,0,7,0,3,3,0,0,0,0,0,0
2018,4707,2,0,2,0,0,0,0,0,0,0,0,0
2018,4708,10,0,10,1,3,4,0,0,0,0,0,0
2018,4709,14,0,14,3,4,7,0,0,0,0,0,0
2018,4710,4,1,5,0,0,0,0,0,0,0,0,0
2018,4800,111,10,121,37,87,124,2,0,2,189,71,260
2018,4801,25,6,31,0,18,18,0,0,0,0,0,0
2018,4802,22,2,24,0,5,5,0,0,0,0,0,0
2018,4803,108,11,119,7,51,58,0,0,0,0,0,0
2018,4804,10,3,13,0,2,2,0,0,0,0,0,0
2018,4805,17,5,22,0,11,11,0,0,0,0,0,0
2018,4806,92,11,103,3,51,54,0,0,0,0,0,0
2018,4807,98,9,107,6,37,43,0,0,0,0,0,0
2018,4900,217,14,231,32,68,100,1,0,1,185,91,276
2018,4901,13,1,14,1,7,8,0,0,0,0,0,0
2018,4902,9,1,10,0,5,5,0,0,0,0,0,0
2018,4903,15,2,17,0,8,8,0,0,0,0,0,0
2018,4904,51,10,61,3,21,24,0,0,0,0,0,0
2018,4905,157,13,170,18,58,76,0,0,0,0,0,0
2018,4906,13,1,14,2,5,7,0,0,0,0,0,0
2018,4908,57,3,60,4,21,25,0,0,0,0,0,0
2018,4909,10,1,11,0,2,2,0,0,0,0,0,0
2018,4914,12,0,12,4,8,12,0,0,0,0,0,0
2018,5000,199,10,209,22,92,114,251,48,299,10,49,59
2018,5001,45,2,47,4,11,15,0,0,0,0,0,0
2018,5002,201,16,217,16,68,84,0,0,0,0,0,0
2018,5003,9,2,11,0,3,3,0,0,0,0,0,0
2018,5004,16,2,18,2,9,11,0,0,0,0,0,0
2018,5007,65,7,72,2,40,42,0,0,0,0,0,0
2018,5010,8,3,11,3,5,8,0,0,0,0,0,0
2018,5100,46,3,49,3,18,21,40,18,58,0,4,4
2018,5102,54,4,58,5,25,30,0,0,0,0,0,0
2018,5200,36,3,39,3,22,25,31,9,40,6,4,10
2018,5201,12,0,12,3,6,9,0,0,0,0,0,0
2018,5202,24,2,26,4,10,14,0,0,0,0,0,0
2018,5300,16,1,17,0,8,8,10,3,13,1,3,4
2018,5400,229,33,262,28,106,134,215,59,274,36,55,91
2018,5401,30,2,32,2,8,10,0,0,0,0,0,0
2018,5402,13,4,17,0,2,2,0,0,0,0,0,0
2018,5403,11,2,13,0,1,1,0,0,0,0,0,0
2018,5404,14,1,15,0,3,3,0,0,0,0,0,0
2018,5405,49,9,58,12,19,31,0,0,0,0,0,0
2018,5406,59,7,66,23,19,42,0,0,0,0,0,0
2018,5407,131,15,146,15,51,66,0,0,0,0,0,0
2018,5408,11,0,11,0,1,1,0,0,0,0,0,0
2018,5411,6,0,6,0,1,1,0,0,0,0,0,0
2018,5500,60,2,62,2,21,23,0,0,0,28,18,46
2018,5501,8,2,10,1,6,7,0,0,0,0,0,0
2018,5600,409,58,467,104,203,307,253,40,293,77,88,165
2018,5604,207,32,239,26,84,110,0,0,0,4,4,8
2018,5605,17,3,20,2,7,9,0,0,0,0,0,0
2018,5606,28,1,29,4,8,12,0,0,0,0,0,0
2018,5608,121,15,136,4,36,40,0,0,0,0,0,0
2018,5609,101,8,109,13,40,53,0,0,0,0,0,0
2018,5622,14,0,14,7,8,15,0,0,0,0,0,0
2018,5680,14,0,14,0,1,1,0,0,0,0,0,0
2018,5700,74,9,83,4,37,41,1,0,1,78,56,134
2018,5701,47,10,57,7,27,34,0,0,0,0,0,0
2018,5702,10,1,11,0,2,2,0,0,0,0,0,0
2018,5703,56,8,64,0,14,14,0,0,0,0,0,0
2018,5704,64,8,72,2,20,22,0,0,0,0,0,0
2018,5797,35,8,43,7,15,22,0,0,0,0,0,0
2018,5800,50,3,53,3,23,26,40,25,65,7,4,11
2018,5801,17,1,18,2,5,7,0,0,0,0,0,0
2018,5802,8,0,8,0,1,1,0,0,0,0,0,0
2018,10M1,212,32,244,7,10,17,0,0,0,0,0,0
2018,190C,12,2,14,3,5,8,0,0,0,0,0,0
2018,190R,10,0,10,1,4,5,0,0,0,0,0,0
2018,19A9,90,21,111,4,11,15,0,0,0,0,0,0
2018,340H,117,22,139,24,63,87,0,0,0,0,0,0
2019,100,461,61,522,102,224,326,364,64,428,95,125,220
2019,101,67,7,74,5,29,34,0,0,0,0,0,0
2019,102,21,1,22,2,7,9,0,0,0,0,0,0
2019,103,133,25,158,25,53,78,1,0,1,8,8,16
2019,104,35,4,39,2,12,14,0,0,0,0,0,0
2019,105,160,21,181,12,72,84,0,0,0,8,8,16
2019,106,160,20,180,15,79,94,0,0,0,11,9,20
2019,107,82,13,95,8,41,49,0,0,0,0,0,0
2019,108,42,11,53,8,14,22,0,0,0,0,0,0
2019,109,636,104,740,63,220,283,0,0,0,0,0,0
2019,110,13,4,17,1,9,10,0,0,0,0,0,0
2019,111,66,11,77,4,29,33,0,0,0,0,0,0
2019,112,79,8,87,3,30,33,0,0,0,4,5,9
2019,113,62,9,71,5,12,17,0,0,0,0,0,0
2019,114,55,7,62,5,18,23,0,0,0,0,0,0
2019,115,10,2,12,3,5,8,0,0,0,0,0,0
2019,197,35,11,46,36,22,58,0,0,0,0,0,0
2019,200,13,0,13,0,3,3,0,0,0,0,0,0
2019,300,46,2,48,7,12,19,1,0,1,18,8,26
2019,302,9,0,9,0,0,0,0,0,0,0,0,0
2019,303,8,1,9,0,1,1,0,0,0,0,0,0
2019,305,4,0,4,0,0,0,0,0,0,0,0,0
2019,400,96,5,101,17,35,52,0,0,0,59,40,99
2019,402,87,8,95,3,40,43,0,0,0,5,3,8
2019,403,12,0,12,1,5,6,0,0,0,0,0,0
2019,404,18,3,21,6,12,18,0,0,0,0,0,0
2019,405,11,0,11,3,5,8,0,0,0,0,0,0
2019,497,16,2,18,1,9,10,0,0,0,0,0,0
2019,500,49,7,56,4,18,22,1,1,2,18,15,33
2019,501,6,1,7,0,1,1,0,0,0,0,0,0
2019,600,25,2,27,2,16,18,8,5,13,0,1,1
2019,601,6,0,6,0,1,1,0,0,0,0,0,0
2019,602,9,2,11,0,2,2,0,0,0,0,0,0
2019,700,237,46,283,47,158,205,284,45,329,56,55,111
2019,701,101,5,106,4,35,39,0,0,0,2,2,4
2019,702,54,6,60,6,24,30,0,0,0,0,0,0
2019,703,6,4,10,0,2,2,0,0,0,0,0,0
2019,704,126,20,146,6,44,50,0,0,0,3,1,4
2019,705,33,4,37,2,6,8,0,0,0,0,0,0
2019,706,22,2,24,0,3,3,0,0,0,0,0,0
2019,707,23,3,26,2,14,16,0,0,0,0,0,0
2019,708,72,10,82,3,20,23,0,0,0,0,0,0
2019,709,36,8,44,3,9,12,0,0,0,0,0,0
2019,710,134,29,163,20,38,58,0,0,0,3,3,6
2019,711,53,4,57,4,17,21,0,0,0,0,4,4
2019,712,66,16,82,8,31,39,0,0,0,0,0,0
2019,713,6,1,7,0,0,0,0,0,0,0,0,0
2019,714,29,3,32,0,11,11,0,0,0,0,0,0
2019,716,9,2,11,0,2,2,0,0,0,0,0,0
2019,718,197,19,216,60,50,110,0,0,0,0,0,0
2019,721,19,2,21,6,6,12,0,0,0,0,0,0
2019,724,59,7,66,6,13,19,0,0,0,0,0,0
2019,800,18,2,20,1,9,10,1,0,1,14,7,21
2019,801,10,1,11,0,1,1,0,0,0,0,0,0
2019,900,135,14,149,25,52,77,5,0,5,70,43,113
2019,901,15,3,18,0,7,7,0,0,0,0,0,0
2019,902,35,3,38,2,19,21,0,0,0,0,0,0
2019,1000,365,38,403,56,140,196,10,1,11,413,159,572
2019,1001,87,13,100,15,43,58,0,0,0,2,0,2
2019,1002,14,0,14,2,6,8,0,0,0,0,0,0
2019,1003,10,1,11,0,5,5,0,0,0,0,0,0
2019,1004,12,0,12,0,0,0,0,0,0,0,0,0
2019,1005,714,92,806,87,184,271,0,0,0,0,0,0
2019,1006,10,3,13,0,4,4,0,0,0,0,0,0
2019,1007,13,4,17,1,2,3,0,0,0,0,0,0
2019,1008,16,1,17,0,3,3,0,0,0,0,0,0
2019,1009,14,0,14,0,2,2,0,0,0,0,0,0
2019,1010,10,1,11,0,1,1,0,0,0,0,0,0
2019,1011,17,0,17,1,4,5,0,0,0,0,0,0
2019,1012,24,4,28,2,13,15,0,0,0,0,0,0
2019,1013,34,5,39,3,1,4,0,0,0,0,0,0
2019,1015,33,3,36,3,9,12,0,0,0,0,0,0
2019,1017,18,2,20,1,4,5,0,0,0,0,0,0
2019,1044,15,1,16,0,1,1,0,0,0,0,0,0
2019,1097,21,5,26,3,8,11,0,0,0,0,0,0
2019,1100,28,4,32,1,13,14,1,0,1,18,8,26
2019,1101,9,2,11,1,1,2,0,0,0,0,0,0
2019,1200,83,10,93,6,38,44,67,27,94,7,7,14
2019,1201,26,3,29,1,13,14,0,0,0,0,0,0
2019,1203,43,4,47,2,21,23,0,0,0,0,0,0
2019,1204,5,0,5,0,0,0,0,0,0,0,0,0
2019,1205,15,1,16,0,8,8,0,0,0,0,0,0
2019,1207,4,2,6,0,0,0,0,0,0,0,0,0
2019,1208,10,2,12,2,6,8,0,0,0,0,0,0
2019,1300,94,5,99,14,45,59,68,20,88,11,15,26
2019,1301,23,3,26,2,11,13,0,0,0,0,0,0
2019,1302,18,2,20,4,10,14,0,0,0,0,0,0
2019,1303,5,0,5,0,0,0,0,0,0,0,0,0
2019,1304,42,2,44,5,19,24,0,0,0,0,0,0
2019,1306,17,2,19,2,2,4,0,0,0,0,0,0
2019,1307,5,0,5,0,0,0,0,0,0,0,0,0
2019,1400,20,0,20,1,15,16,18,0,18,12,12,24
2019,1401,12,0,12,1,6,7,0,0,0,0,0,0
2019,1500,320,23,343,54,171,225,349,87,436,47,104,151
2019,1501,15,3,18,3,5,8,0,0,0,0,0,0
2019,1502,341,39,380,46,133,179,0,0,0,0,0,0
2019,1503,47,4,51,6,15,21,0,0,0,0,0,0
2019,1505,6,2,8,0,6,6,0,0,0,0,0,0
2019,1506,28,3,31,4,14,18,0,0,0,0,0,0
2019,1507,22,4,26,2,7,9,0,0,0,0,0,0
2019,1508,13,1,14,0,10,10,0,0,0,0,0,0
2019,1509,14,3,17,2,7,9,0,0,0,0,0,0
2019,1511,10,0,10,2,7,9,3,1,4,0,0,0
2019,1514,2,0,2,0,0,0,0,0,0,0,0,0
2019,1515,5,0,5,0,1,1,0,0,0,0,0,0
2019,1521,28,1,29,0,5,5,0,0,0,0,0,0
2019,1597,11,3,14,1,8,9,0,0,0,0,0,0
2019,1600,76,9,85,3,41,44,0,0,0,93,67,160
2019,1601,16,3,19,3,10,13,0,0,0,0,0,0
2019,1602,54,4,58,2,27,29,0,0,0,0,0,0
2019,1603,30,3,33,1,7,8,0,0,0,0,0,0
2019,1607,12,5,17,0,1,1,0,0,0,0,0,0
2019,1700,44,5,49,2,17,19,27,15,42,6,6,12
2019,1701,9,2,11,0,1,1,0,0,0,0,0,0
2019,1702,19,4,23,5,9,14,0,0,0,0,0,0
2019,1800,29,2,31,4,7,11,18,9,27,3,8,11
2019,1801,14,2,16,0,3,3,0,0,0,0,0,0
2019,1900,5477,1170,6647,1698,2651,4349,2367,551,2918,950,1066,2016
2019,1901,67,9,76,8,34,42,0,0,0,0,0,0
2019,1902,61,5,66,2,23,25,0,0,0,0,1,1
2019,1905,49,7,56,4,21,25,0,0,0,3,5,8
2019,1906,67,3,70,0,23,23,0,0,0,0,0,0
2019,1907,24,5,29,4,7,11,0,0,0,0,0,0
2019,1909,44,2,46,6,17,23,0,0,0,0,0,0
2019,1910,114,17,131,30,55,85,0,0,0,1,0,1
2019,1912,120,19,139,17,50,67,0,0,0,5,4,9
2019,1913,32,7,39,5,14,19,0,0,0,2,3,5
2019,1916,50,2,52,4,18,22,0,0,0,3,1,4
2019,1918,103,8,111,20,21,41,0,0,0,3,0,3
2019,1920,100,17,117,9,35,44,0,0,0,0,0,0
2019,1922,108,10,118,8,27,35,0,0,0,5,2,7
2019,1923,56,5,61,2,9,11,0,0,0,4,3,7
2019,1924,79,10,89,4,16,20,0,0,0,3,4,7
2019,1925,209,22,231,21,64,85,0,0,0,10,9,19
2019,1926,45,5,50,6,18,24,0,0,0,3,2,5
2019,1928,80,7,87,10,27,37,1,0,1,5,3,8
2019,1929,29,3,32,15,4,19,0,0,0,3,8,11
2019,1931,51,5,56,11,13,24,0,0,0,2,3,5
2019,1933,171,21,192,6,38,44,0,0,0,3,8,11
2019,1934,25,2,27,0,6,6,0,0,0,0,0,0
2019,1938,33,4,37,1,17,18,0,0,0,0,0,0
2019,1941,725,84,809,132,199,331,8,0,8,32,23,55
2019,1942,8121,1826,9947,963,1578,2541,45,10,55,277,134,411
2019,1944,55,7,62,11,20,31,0,0,0,3,4,7
2019,1946,42,4,46,2,22,24,0,0,0,1,3,4
2019,1947,65,7,72,1,24,25,0,0,0,0,0,0
2019,1948,61,8,69,8,18,26,0,0,0,2,2,4
2019,1951,18,2,20,2,2,4,0,0,0,3,5,8
2019,1953,193,29,222,45,59,104,0,0,0,8,9,17
2019,1955,133,14,147,15,72,87,0,0,0,12,6,18
2019,1956,85,6,91,8,36,44,0,0,0,4,3,7
2019,1961,26,5,31,2,4,6,0,0,0,3,4,7
2019,1962,47,4,51,2,13,15,0,0,0,0,0,0
2019,1963,21,5,26,2,6,8,0,0,0,0,0,0
2019,1965,191,27,218,76,80,156,1,0,1,12,7,19
2019,1966,13,2,15,0,3,3,0,0,0,0,0,0
2019,1967,27,5,32,0,5,5,0,0,0,0,7,7
2019,1969,66,6,72,8,28,36,0,0,0,4,2,6
2019,1970,32,1,33,3,15,18,0,0,0,0,0,0
2019,1972,192,13,205,22,67,89,1,0,1,8,8,16
2019,1973,38,3,41,2,12,14,0,0,0,0,0,0
2019,1975,82,6,88,8,38,46,0,0,0,4,3,7
2019,1976,102,16,118,12,37,49,0,0,0,0,0,0
2019,1978,19,2,21,17,20,37,0,0,0,0,0,0
2019,1981,20,1,21,4,3,7,0,0,0,0,0,0
2019,1982,21,3,24,5,8,13,0,0,0,0,0,0
2019,1983,14,4,18,7,8,15,0,0,0,0,0,0
2019,1984,18,3,21,6,8,14,0,0,0,0,0,0
2019,1997,50,7,57,16,22,38,0,0,0,0,0,0
2019,2000,80,6,86,32,3,35,0,0,0,0,0,0
2019,2001,16,2,18,2,7,9,0,0,0,0,0,0
2019,2002,58,8,66,5,21,26,0,0,0,0,0,0
2019,2100,95,21,116,19,58,77,58,20,78,11,16,27
2019,2101,7,0,7,0,0,0,0,0,0,0,0,0
2019,2103,11,0,11,5,0,5,0,0,0,0,0,0
2019,2105,19,2,21,1,5,6,0,0,0,0,0,0
2019,2106,49,9,58,1,18,19,0,0,0,0,0,0
2019,2107,8,0,8,0,0,0,0,0,0,0,0,0
2019,2109,50,10,60,2,20,22,0,0,0,0,0,0
2019,2110,14,3,17,0,6,6,0,0,0,0,0,0
2019,2111,13,0,13,1,3,4,0,0,0,0,0,0
2019,2113,5,0,5,1,1,2,0,0,0,0,0,0
2019,2117,35,7,42,0,4,4,0,0,0,0,0,0
2019,2200,37,5,42,2,14,16,12,8,20,0,0,0
2019,2300,67,3,70,25,33,58,45,16,61,2,11,13
2019,2301,13,2,15,2,5,7,0,0,0,0,0,0
2019,2303,25,1,26,7,12,19,0,0,0,0,0,0
2019,2304,8,0,8,2,3,5,0,0,0,0,0,0
2019,2400,103,7,110,7,28,35,12,0,12,64,34,98
2019,2401,25,0,25,3,6,9,0,0,0,0,0,0
2019,2402,8,1,9,1,3,4,0,0,0,0,0,0
2019,2403,5,1,6,0,1,1,0,0,0,0,0,0
2019,2404,20,0,20,0,10,10,0,0,0,0,0,0
2019,2405,33,3,36,4,18,22,0,0,0,1,3,4
2019,2406,85,8,93,11,29,40,0,0,0,0,0,0
2019,2412,12,4,16,6,6,12,0,0,0,0,0,0
2019,2500,10,1,11,2,8,10,8,1,9,0,0,0
2019,2501,7,0,7,1,0,1,0,0,0,0,0,0
2019,2600,18,2,20,2,3,5,0,0,0,9,7,16
2019,2601,12,0,12,0,3,3,0,0,0,0,0,0
2019,2700,106,10,116,12,45,57,144,35,179,38,40,78
2019,2701,13,1,14,0,8,8,0,0,0,0,0,0
2019,2702,9,1,10,0,0,0,0,0,0,0,0,0
2019,2703,11,1,12,1,2,3,0,0,0,0,0,0
2019,2704,20,2,22,0,6,6,0,0,0,0,0,0
2019,2705,16,1,17,1,4,5,0,0,0,0,0,0
2019,2706,43,6,49,1,3,4,0,0,0,6,6,12
2019,2707,15,6,21,2,7,9,0,0,0,0,0,0
2019,2708,130,16,146,11,35,46,0,0,0,0,0,0
2019,2709,10,0,10,0,1,1,0,0,0,0,0,0
2019,2710,30,3,33,2,9,11,0,0,0,1,0,1
2019,2711,16,0,16,2,3,5,0,0,0,0,0,0
2019,2712,22,5,27,1,6,7,0,0,0,0,0,0
2019,2719,9,5,14,1,8,9,0,0,0,0,0,0
2019,2800,91,8,99,12,22,34,1,0,1,0,0,0
2019,2801,6,2,8,1,4,5,0,0,0,0,0,0
2019,2802,67,5,72,8,40,48,0,0,0,0,0,0
2019,2803,8,3,11,0,5,5,0,0,0,0,0,0
2019,2808,114,7,121,5,7,12,0,0,0,0,0,0
2019,2900,51,6,57,5,23,28,2,0,2,36,29,65
2019,2901,28,1,29,2,5,7,0,0,0,0,0,0
2019,2902,9,1,10,0,2,2,0,0,0,0,0,0
2019,2908,23,1,24,1,13,14,0,0,0,0,0,0
2019,3000,959,131,1090,595,659,1254,689,109,798,344,237,581
2019,3001,364,31,395,43,123,166,17,6,23,0,8,8
2019,3002,53,3,56,7,23,30,0,0,0,0,0,0
2019,3003,77,12,89,9,33,42,0,0,0,0,0,0
2019,3004,115,12,127,13,52,65,0,0,0,0,0,0
2019,3005,47,4,51,1,10,11,0,0,0,2,1,3
2019,3006,18,2,20,1,6,7,0,0,0,0,0,0
2019,3007,51,8,59,2,18,20,0,0,0,0,0,0
2019,3008,118,16,134,8,47,55,0,0,0,3,1,4
2019,3009,153,10,163,24,52,76,0,0,0,0,0,0
2019,3010,185,11,196,18,74,92,0,0,0,10,5,15
2019,3011,45,9,54,12,29,41,0,0,0,2,1,3
2019,3012,60,9,69,7,25,32,0,0,0,0,0,0
2019,3013,15,2,17,0,4,4,0,0,0,0,0,0
2019,3014,130,12,142,26,50,76,0,0,0,3,4,7
2019,3015,132,11,143,26,47,73,0,0,0,0,0,0
2019,3016,40,3,43,6,15,21,0,0,0,2,1,3
2019,3019,307,32,339,39,94,133,1,0,1,49,36,85
2019,3020,34,4,38,7,2,9,0,0,0,2,4,6
2019,3022,79,11,90,13,38,51,0,0,0,0,0,0
2019,3024,71,8,79,5,34,39,2,0,2,0,0,0
2019,3026,183,41,224,27,74,101,0,0,0,0,0,0
2019,3027,19,6,25,3,11,14,0,0,0,0,0,0
2019,3096,10,0,10,2,4,6,0,0,0,0,0,0
2019,3097,37,8,45,37,18,55,0,0,0,0,0,0
2019,3100,164,16,180,21,78,99,63,5,68,93,94,187
2019,3101,19,1,20,1,7,8,0,0,0,0,0,0
2019,3103,19,2,21,2,6,8,0,0,0,0,0,0
2019,3104,52,6,58,1,25,26,0,0,0,0,0,0
2019,3105,118,12,130,14,47,61,0,0,0,0,0,0
2019,3200,33,2,35,0,10,10,1,0,1,12,8,20
2019,3300,1322,131,1453,285,675,960,279,56,335,680,322,1002
2019,3301,23,3,26,2,16,18,0,0,0,0,0,0
2019,3302,38,5,43,3,13,16,0,0,0,0,0,0
2019,3303,18,0,18,5,5,10,0,0,0,0,0,0
2019,3306,21,2,23,2,7,9,0,0,0,0,0,0
2019,3308,86,4,90,9,29,38,0,0,0,0,0,0
2019,3309,64,4,68,12,28,40,0,0,0,0,0,0
2019,3311,89,12,101,18,27,45,0,0,0,3,0,3
2019,3313,322,44,366,22,124,146,0,0,0,0,0,0
2019,3315,131,12,143,8,52,60,0,0,0,3,3,6
2019,3325,45,5,50,5,17,22,0,0,0,0,0,0
2019,3342,90,9,99,3,36,39,0,0,0,0,0,0
2019,3344,19,3,22,2,3,5,0,0,0,0,0,0
2019,3397,28,3,31,3,6,9,0,0,0,0,0,0
2019,3400,737,128,865,155,268,423,392,91,483,76,145,221
2019,3401,66,8,74,0,28,28,0,0,0,0,0,0
2019,3402,29,4,33,3,12,15,0,0,0,0,0,0
2019,3404,569,109,678,86,229,315,0,0,0,0,0,0
2019,3408,21,2,23,9,12,21,0,0,0,0,0,0
2019,3414,15,2,17,1,4,5,0,0,0,0,0,0
2019,3420,2,0,2,0,0,0,0,0,0,0,0,0
2019,3422,409,84,493,9,23,32,0,0,0,0,0,0
2019,3477,72,8,80,12,10,22,0,0,0,0,0,0
2019,3496,71,13,84,11,39,50,0,0,0,0,0,0
2019,3499,6780,450,7230,1421,1878,3299,0,0,0,0,0,0
2019,3500,22,0,22,3,4,7,1,0,1,16,13,29
2019,3501,28,5,33,0,7,7,0,0,0,0,0,0
2019,3600,1134,180,1314,160,594,754,514,99,613,190,471,661
2019,3601,36,3,39,0,18,18,0,0,0,0,0,0
2019,3602,96,13,109,3,48,51,0,0,0,0,0,0
2019,3603,46,6,52,4,24,28,0,0,0,0,0,0
2019,3604,173,15,188,12,85,97,0,0,0,0,0,0
2019,3605,41,3,44,1,19,20,0,0,0,0,0,0
2019,3607,260,23,283,17,88,105,0,0,0,0,0,0
2019,3608,77,8,85,7,32,39,0,0,0,0,0,0
2019,3609,91,11,102,1,31,32,0,0,0,0,0,0
2019,3610,217,27,244,24,100,124,0,0,0,0,0,0
2019,3611,64,7,71,2,33,35,0,0,0,0,0,0
2019,3614,13,5,18,2,11,13,0,0,0,0,0,0
2019,3623,23,2,25,42,21,63,0,0,0,0,0,0
2019,3626,11,2,13,0,2,2,0,0,0,0,0,0
2019,3639,6,3,9,3,5,8,0,0,0,0,0,0
2019,3650,14,3,17,39,22,61,0,0,0,0,0,0
2019,3657,81,20,101,7,10,17,0,0,0,0,0,0
2019,3700,1206,194,1400,345,566,911,914,287,1201,299,533,832
2019,3701,114,12,126,13,43,56,0,0,0,0,0,0
2019,3702,195,37,232,18,53,71,0,0,0,10,2,12
2019,3703,36,11,47,3,17,20,0,0,0,0,0,0
2019,3705,109,11,120,15,48,63,0,0,0,0,0,0
2019,3706,142,12,154,7,50,57,0,0,0,0,0,0
2019,3708,57,5,62,6,24,30,0,0,0,0,0,0
2019,3709,77,7,84,5,35,40,0,0,0,0,0,0
2019,3710,184,19,203,15,70,85,0,0,0,0,0,0
2019,3711,1470,294,1764,254,369,623,0,0,0,0,0,0
2019,3714,23,4,27,6,19,25,0,0,0,0,0,0
2019,3715,114,18,132,12,21,33,0,0,0,0,0,0
2019,3732,12,2,14,1,7,8,0,0,0,0,0,0
2019,3797,36,3,39,22,17,39,0,0,0,0,0,0
2019,3800,307,54,361,74,84,158,421,75,496,10,19,29
2019,3801,1940,339,2279,298,330,628,0,0,0,0,0,0
2019,3803,21,2,23,14,9,23,0,0,0,0,0,0
2019,3897,45,3,48,66,22,88,0,0,0,0,0,0
2019,3900,247,19,266,45,119,164,26,1,27,183,97,280
2019,3901,11,0,11,0,1,1,0,0,0,0,0,0
2019,3902,67,7,74,3,28,31,0,0,0,0,0,0
2019,3903,71,3,74,5,25,30,0,0,0,2,0,2
2019,3904,21,0,21,1,8,9,0,0,0,0,0,0
2019,3905,411,48,459,59,146,205,0,0,0,0,0,0
2019,3906,79,7,86,8,41,49,0,0,0,0,0,0
2019,3915,26,10,36,3,10,13,0,0,0,0,0,0
2019,4000,156,5,161,11,64,75,108,34,142,11,29,40
2019,4001,25,1,26,0,4,4,0,0,0,0,0,0
2019,4002,15,2,17,1,7,8,0,0,0,0,0,0
2019,4003,12,3,15,0,2,2,0,0,0,0,0,0
2019,4004,35,1,36,1,13,14,0,0,0,0,0,0
2019,4005,18,3,21,0,12,12,0,0,0,0,0,0
2019,4006,51,10,61,4,24,28,0,0,0,0,0,0
2019,4007,15,2,17,2,7,9,0,0,0,0,0,0
2019,4008,25,3,28,3,8,11,0,0,0,0,0,0
2019,4016,137,29,166,1,11,12,0,0,0,0,0,0
2019,4019,6,1,7,1,3,4,0,0,0,0,0,0
2019,4100,231,14,245,50,101,151,79,10,89,175,86,261
2019,4101,15,2,17,1,8,9,0,0,0,0,0,0
2019,4102,28,2,30,5,7,12,0,0,0,0,0,0
2019,4103,11,2,13,0,4,4,0,0,0,0,0,0
2019,4104,32,6,38,6,13,19,0,0,0,0,0,0
2019,4105,17,2,19,0,6,6,0,0,0,0,0,0
2019,4106,93,8,101,12,14,26,0,0,0,0,0,0
2019,4108,22,2,24,1,9,10,0,0,0,0,0,0
2019,4109,44,4,48,8,15,23,0,0,0,0,0,0
2019,4111,30,2,32,0,3,3,0,0,0,0,0,0
2019,4113,75,9,84,4,23,27,0,0,0,0,0,0
2019,4114,41,4,45,0,16,16,0,0,0,0,0,0
2019,4116,83,20,103,8,31,39,0,0,0,0,0,0
2019,4117,72,8,80,6,25,31,0,0,0,0,0,0
2019,4119,9,1,10,0,1,1,0,0,0,0,0,0
2019,4120,30,5,35,4,11,15,0,0,0,0,0,0
2019,4127,29,5,34,1,7,8,0,0,0,0,0,0
2019,4200,225,20,245,32,94,126,191,41,232,37,34,71
2019,4201,10,1,11,0,2,2,0,0,0,0,0,0
2019,4202,35,2,37,0,15,15,0,0,0,4,0,4
2019,4203,110,22,132,18,56,74,0,0,0,0,0,0
2019,4204,125,10,135,5,44,49,0,0,0,0,0,0
2019,4211,6,1,7,5,4,9,0,0,0,0,0,0
2019,4297,31,10,41,8,11,19,0,0,0,0,0,0
2019,4300,422,59,481,52,108,160,658,177,835,83,157,240
2019,4302,40,4,44,3,23,26,0,0,0,0,0,0
2019,4304,58,6,64,3,25,28,0,0,0,3,2,5
2019,4305,24,6,30,2,11,13,0,0,0,0,0,0
2019,4307,33,4,37,2,21,23,0,0,0,0,0,0
2019,4308,74,14,88,5,21,26,0,0,0,0,0,0
2019,4310,35,6,41,4,16,20,0,0,0,0,0,0
2019,4311,85,11,96,9,30,39,0,0,0,0,0,0
2019,4312,66,11,77,22,38,60,0,0,0,0,0,0
2019,4313,1020,130,1150,135,322,457,0,0,0,0,0,0
2019,4314,136,14,150,11,55,66,0,0,0,4,2,6
2019,4316,196,21,217,21,54,75,0,0,0,0,0,0
2019,4317,23,6,29,27,18,45,0,0,0,0,0,0
2019,4320,5,2,7,6,4,10,0,0,0,0,0,0
2019,4321,8,0,8,2,3,5,0,0,0,0,0,0
2019,4327,11,0,11,5,1,6,0,0,0,0,0,0
2019,4400,116,24,140,11,43,54,8,0,8,81,51,132
2019,4401,19,1,20,4,3,7,0,0,0,0,0,0
2019,4402,72,9,81,20,21,41,0,0,0,0,0,0
2019,4403,68,7,75,4,15,19,0,0,0,0,0,0
2019,4404,15,2,17,0,7,7,0,0,0,0,0,0
2019,4497,18,3,21,6,11,17,0,0,0,0,0,0
2019,4500,67,2,69,7,39,46,55,14,69,5,9,14
2019,4501,20,0,20,0,8,8,0,0,0,0,0,0
2019,4502,93,8,101,10,29,39,0,0,0,0,0,0
2019,4591,18,1,19,4,2,6,0,0,0,0,0,0
2019,4600,6,0,6,4,2,6,0,0,0,0,0,0
2019,4700,44,2,46,4,14,18,27,8,35,1,3,4
2019,4703,3,0,3,0,0,0,0,0,0,0,0,0
2019,4706,8,0,8,0,4,4,0,0,0,0,0,0
2019,4707,2,1,3,0,0,0,0,0,0,0,0,0
2019,4708,9,0,9,3,2,5,0,0,0,0,0,0
2019,4709,14,0,14,4,4,8,0,0,0,0,0,0
2019,4710,2,0,2,0,0,0,0,0,0,0,0,0
2019,4800,110,10,120,39,86,125,2,0,2,189,76,265
2019,4801,22,6,28,0,19,19,0,0,0,0,0,0
2019,4802,24,1,25,0,5,5,0,0,0,0,0,0
2019,4803,108,8,116,7,60,67,0,0,0,0,0,0
2019,4804,7,3,10,0,2,2,0,0,0,0,0,0
2019,4805,15,5,20,0,12,12,0,0,0,0,0,0
2019,4806,96,14,110,3,54,57,0,0,0,0,0,0
2019,4807,92,9,101,8,39,47,0,0,0,0,0,0
2019,4900,209,13,222,28,67,95,1,0,1,184,79,263
2019,4901,12,1,13,1,7,8,0,0,0,0,0,0
2019,4902,11,1,12,0,6,6,0,0,0,0,0,0
2019,4903,15,2,17,0,8,8,0,0,0,0,0,0
2019,4904,64,11,75,4,22,26,0,0,0,0,0,0
2019,4905,153,13,166,20,57,77,0,0,0,0,0,0
2019,4906,13,1,14,2,5,7,0,0,0,0,0,0
2019,4908,61,2,63,5,26,31,0,0,0,0,0,0
2019,4909,11,1,12,0,3,3,0,0,0,0,0,0
2019,4914,7,1,8,5,8,13,0,0,0,0,0,0
2019,5000,220,8,228,21,96,117,247,52,299,13,49,62
2019,5001,47,2,49,5,14,19,0,0,0,0,0,0
2019,5002,184,21,205,34,70,104,0,0,0,0,0,0
2019,5003,12,1,13,0,3,3,0,0,0,0,0,0
2019,5004,18,4,22,2,8,10,0,0,0,0,0,0
2019,5007,69,6,75,5,31,36,0,0,0,0,0,0
2019,5010,9,3,12,3,5,8,0,0,0,0,0,0
2019,5100,47,2,49,2,18,20,39,17,56,0,3,3
2019,5102,53,6,59,4,25,29,0,0,0,0,0,0
2019,5200,32,2,34,6,21,27,30,9,39,3,4,7
2019,5201,13,0,13,2,6,8,0,0,0,0,0,0
2019,5202,23,2,25,4,11,15,0,0,0,0,0,0
2019,5300,18,1,19,0,10,10,12,5,17,1,3,4
2019,5400,245,38,283,28,104,132,221,59,280,39,57,96
2019,5401,32,2,34,2,8,10,0,0,0,0,0,0
2019,5402,15,2,17,0,2,2,0,0,0,0,0,0
2019,5403,13,1,14,0,1,1,0,0,0,0,0,0
2019,5404,14,1,15,0,3,3,0,0,0,0,0,0
2019,5405,55,10,65,15,22,37,0,0,0,0,0,0
2019,5406,61,6,67,12,26,38,0,0,0,0,0,0
2019,5407,131,16,147,14,58,72,0,0,0,0,0,0
2019,5408,11,0,11,0,1,1,0,0,0,0,0,0
2019,5411,6,0,6,0,1,1,0,0,0,0,0,0
2019,5500,58,2,60,2,20,22,0,0,0,30,19,49
2019,5501,8,2,10,1,6,7,0,0,0,0,0,0
2019,5600,392,57,449,97,201,298,267,45,312,78,94,172
2019,5604,197,33,230,18,68,86,0,0,0,3,5,8
2019,5605,16,3,19,3,5,8,0,0,0,0,0,0
2019,5606,30,2,32,3,10,13,0,0,0,0,0,0
2019,5608,117,18,135,12,36,48,0,0,0,0,0,0
2019,5609,109,10,119,9,37,46,0,0,0,0,0,0
2019,5622,12,1,13,5,7,12,0,0,0,0,0,0
2019,5680,14,1,15,0,1,1,0,0,0,0,0,0
2019,5700,75,8,83,3,34,37,1,0,1,82,59,141
2019,5701,50,7,57,8,27,35,0,0,0,0,0,0
2019,5702,10,1,11,0,2,2,0,0,0,0,0,0
2019,5703,57,8,65,0,15,15,0,0,0,0,0,0
2019,5704,62,7,69,6,21,27,0,0,0,0,0,0
2019,5797,34,7,41,9,17,26,0,0,0,0,0,0
2019,5800,53,4,57,3,24,27,43,26,69,6,4,10
2019,5801,17,1,18,2,6,8,0,0,0,0,0,0
2019,5802,8,0,8,0,1,1,0,0,0,0,0,0
2019,10M1,205,25,230,19,11,30,0,0,0,0,0,0
2019,190C,9,1,10,2,6,8,0,0,0,0,0,0
2019,190R,10,0,10,1,4,5,0,0,0,0,0,0
2019,191N,7,1,8,1,2,3,0,0,0,0,0,0
2019,19A9,102,19,121,2,6,8,0,0,0,0,0,0
2019,340H,118,22,140,25,73,98,0,0,0,0,0,0
2020,100,472,65,537,103,219,322,362,70,432,95,134,229
2020,101,64,8,72,5,28,33,0,0,0,0,0,0
2020,102,21,1,22,2,7,9,0,0,0,0,0,0
2020,103,136,26,162,20,53,73,1,0,1,10,8,18
2020,104,34,3,37,4,13,17,0,0,0,0,0,0
2020,105,172,23,195,14,78,92,0,0,0,6,8,14
2020,106,154,20,174,15,77,92,0,0,0,13,8,21
2020,107,75,13,88,5,32,37,0,0,0,0,0,0
2020,108,38,13,51,8,16,24,0,0,0,0,0,0
2020,109,632,108,740,83,233,316,0,0,0,0,0,0
2020,110,16,4,20,2,8,10,0,0,0,0,0,0
2020,111,69,9,78,3,28,31,0,0,0,0,0,0
2020,112,81,8,89,3,29,32,0,0,0,4,5,9
2020,113,59,10,69,5,12,17,0,0,0,0,0,0
2020,114,56,5,61,11,22,33,0,0,0,0,0,0
2020,115,10,2,12,4,5,9,0,0,0,0,0,0
2020,197,33,11,44,40,20,60,0,0,0,0,0,0
2020,200,12,0,12,0,3,3,0,0,0,0,0,0
2020,300,42,2,44,7,16,23,1,0,1,13,9,22
2020,302,9,0,9,0,0,0,0,0,0,0,0,0
2020,303,7,2,9,0,1,1,0,0,0,0,0,0
2020,305,4,1,5,0,0,0,0,0,0,0,0,0
2020,400,93,7,100,21,37,58,0,0,0,61,49,110
2020,402,86,8,94,3,39,42,0,0,0,4,4,8
2020,403,10,1,11,1,5,6,0,0,0,0,0,0
2020,404,18,3,21,4,12,16,0,0,0,0,0,0
2020,405,15,1,16,2,6,8,0,0,0,0,0,0
2020,497,15,3,18,1,8,9,0,0,0,0,0,0
2020,500,52,7,59,3,20,23,1,1,2,24,15,39
2020,501,5,1,6,0,1,1,0,0,0,0,0,0
2020,600,27,2,29,3,17,20,4,7,11,0,1,1
2020,601,6,3,9,0,1,1,0,0,0,0,0,0
2020,602,9,1,10,0,2,2,0,0,0,0,0,0
2020,700,233,44,277,51,159,210,302,55,357,41,48,89
2020,701,115,5,120,4,37,41,0,0,0,2,3,5
2020,702,59,5,64,6,25,31,0,0,0,0,0,0
2020,703,6,5,11,0,2,2,0,0,0,0,0,0
2020,704,117,18,135,2,38,40,0,0,0,2,1,3
2020,705,34,4,38,2,6,8,0,0,0,0,0,0
2020,706,19,3,22,0,4,4,0,0,0,0,0,0
2020,707,24,2,26,2,15,17,0,0,0,0,0,0
2020,708,73,12,85,1,17,18,0,0,0,0,0,0
2020,709,36,7,43,3,10,13,0,0,0,0,0,0
2020,710,116,28,144,15,35,50,1,0,1,3,2,5
2020,711,52,4,56,5,18,23,0,0,0,0,4,4
2020,712,65,15,80,11,26,37,0,0,0,0,0,0
2020,713,9,1,10,0,0,0,0,0,0,0,0,0
2020,714,31,2,33,0,13,13,0,0,0,0,0,0
2020,716,9,2,11,0,2,2,0,0,0,0,0,0
2020,718,201,21,222,77,53,130,0,0,0,0,0,0
2020,721,19,2,21,5,8,13,0,0,0,0,0,0
2020,724,61,6,67,6,10,16,0,0,0,0,0,0
2020,800,17,4,21,2,8,10,0,0,0,14,8,22
2020,801,10,2,12,0,1,1,0,0,0,0,0,0
2020,900,149,13,162,26,50,76,5,0,5,74,45,119
2020,901,15,3,18,0,8,8,0,0,0,0,0,0
2020,902,34,3,37,1,15,16,0,0,0,0,0,0
2020,1000,371,39,410,55,110,165,10,1,11,418,166,584
2020,1001,83,15,98,18,47,65,0,0,0,2,0,2
2020,1002,17,0,17,2,5,7,0,0,0,0,0,0
2020,1003,11,1,12,0,5,5,0,0,0,0,0,0
2020,1004,12,0,12,0,0,0,0,0,0,0,0,0
2020,1005,698,90,788,60,178,238,0,0,0,0,0,0
2020,1006,4,2,6,0,2,2,0,0,0,0,0,0
2020,1007,18,5,23,0,4,4,0,0,0,0,0,0
2020,1008,17,1,18,0,3,3,0,0,0,0,0,0
2020,1009,14,0,14,0,2,2,0,0,0,0,0,0
2020,1010,9,1,10,0,1,1,0,0,0,0,0,0
2020,1011,18,0,18,1,3,4,0,0,0,0,0,0
2020,1012,27,3,30,2,13,15,0,0,0,0,0,0
2020,1013,31,4,35,3,2,5,0,0,0,0,0,0
2020,1015,30,2,32,3,9,12,0,0,0,0,0,0
2020,1017,19,1,20,1,5,6,0,0,0,0,0,0
2020,1044,13,1,14,0,1,1,0,0,0,0,0,0
2020,1097,20,5,25,3,9,12,0,0,0,0,0,0
2020,1100,26,4,30,1,14,15,1,0,1,10,8,18
2020,1101,10,1,11,0,3,3,0,0,0,0,0,0
2020,1200,94,10,104,10,38,48,73,28,101,6,11,17
2020,1201,22,3,25,1,12,13,0,0,0,0,0,0
2020,1203,42,4,46,3,22,25,0,0,0,0,0,0
2020,1204,8,0,8,0,0,0,0,0,0,0,0,0
2020,1205,17,1,18,0,6,6,0,0,0,0,0,0
2020,1207,4,1,5,0,0,0,0,0,0,0,0,0
2020,1208,11,1,12,1,4,5,0,0,0,0,0,0
2020,1300,97,3,100,14,33,47,73,19,92,10,27,37
2020,1301,24,2,26,2,12,14,0,0,0,0,0,0
2020,1302,22,2,24,4,11,15,0,0,0,0,0,0
2020,1304,42,1,43,4,16,20,0,0,0,0,0,0
2020,1306,16,5,21,1,2,3,0,0,0,0,0,0
2020,1307,3,0,3,0,0,0,0,0,0,0,0,0
2020,1400,29,0,29,2,17,19,8,0,8,13,11,24
2020,1401,11,0,11,2,6,8,0,0,0,0,0,0
2020,1500,311,25,336,55,168,223,340,86,426,45,92,137
2020,1501,14,2,16,3,5,8,0,0,0,0,0,0
2020,1502,360,43,403,30,155,185,0,0,0,0,0,0
2020,1503,45,5,50,5,13,18,0,0,0,0,0,0
2020,1505,9,2,11,0,3,3,0,0,0,0,0,0
2020,1506,28,3,31,6,12,18,0,0,0,0,0,0
2020,1507,25,3,28,4,9,13,0,0,0,0,0,0
2020,1508,12,0,12,0,10,10,0,0,0,0,0,0
2020,1509,15,2,17,3,7,10,0,0,0,0,0,0
2020,1511,12,0,12,2,9,11,1,1,2,0,0,0
2020,1514,4,0,4,0,0,0,0,0,0,0,0,0
2020,1515,5,0,5,0,1,1,0,0,0,0,0,0
2020,1521,28,2,30,0,5,5,0,0,0,0,0,0
2020,1597,11,3,14,1,8,9,0,0,0,0,0,0
2020,1600,82,7,89,3,42,45,0,0,0,84,74,158
2020,1601,14,3,17,3,11,14,0,0,0,0,0,0
2020,1602,55,5,60,2,24,26,0,0,0,0,0,0
2020,1603,29,3,32,1,7,8,0,0,0,0,0,0
2020,1607,11,6,17,0,2,2,0,0,0,0,0,0
2020,1700,46,4,50,3,16,19,28,14,42,4,5,9
2020,1701,9,2,11,0,1,1,0,0,0,0,0,0
2020,1702,19,2,21,7,11,18,0,0,0,0,0,0
2020,1800,29,3,32,3,13,16,13,8,21,4,8,12
2020,1801,14,2,16,0,3,3,0,0,0,0,0,0
2020,1900,5603,1232,6835,1648,2562,4210,2518,580,3098,910,1036,1946
2020,1901,72,9,81,7,36,43,0,0,0,0,0,0
2020,1902,57,6,63,2,23,25,0,0,0,0,1,1
2020,1905,48,5,53,5,22,27,0,0,0,0,0,0
2020,1906,60,3,63,0,21,21,0,0,0,0,0,0
2020,1907,25,5,30,4,7,11,0,0,0,0,0,0
2020,1909,43,2,45,5,17,22,0,0,0,0,0,0
2020,1910,120,14,134,26,65,91,0,0,0,1,0,1
2020,1912,127,20,147,23,50,73,0,0,0,4,6,10
2020,1913,31,7,38,4,15,19,0,0,0,2,3,5
2020,1916,55,3,58,3,16,19,0,0,0,2,1,3
2020,1918,101,9,110,15,16,31,0,0,0,3,0,3
2020,1920,99,17,116,7,37,44,0,0,0,0,0,0
2020,1922,106,12,118,6,25,31,0,0,0,6,2,8
2020,1923,50,3,53,2,12,14,0,0,0,4,2,6
2020,1924,71,11,82,2,13,15,0,0,0,4,3,7
2020,1925,203,22,225,31,79,110,0,0,0,11,8,19
2020,1926,45,3,48,5,21,26,0,0,0,2,2,4
2020,1928,82,9,91,9,25,34,1,0,1,5,6,11
2020,1929,33,2,35,15,4,19,0,0,0,3,7,10
2020,1931,50,4,54,11,12,23,0,0,0,3,2,5
2020,1933,169,22,191,6,41,47,0,0,0,3,8,11
2020,1934,26,1,27,0,7,7,0,0,0,0,0,0
2020,1938,33,4,37,1,14,15,0,0,0,0,0,0
2020,1941,711,91,802,111,206,317,7,0,7,29,19,48
2020,1942,8017,1793,9810,982,1603,2585,50,3,53,278,137,415
2020,1944,54,6,60,10,22,32,0,0,0,3,4,7
2020,1946,39,5,44,2,22,24,0,0,0,1,2,3
2020,1947,61,9,70,1,22,23,0,0,0,0,0,0
2020,1948,62,13,75,7,19,26,0,0,0,2,3,5
2020,1951,17,0,17,1,2,3,0,0,0,1,5,6
2020,1953,201,32,233,34,70,104,0,0,0,12,9,21
2020,1955,135,17,152,14,61,75,0,0,0,11,6,17
2020,1956,76,9,85,8,41,49,0,0,0,4,5,9
2020,1961,23,4,27,2,4,6,0,0,0,3,4,7
2020,1962,47,4,51,2,11,13,0,0,0,0,0,0
2020,1963,21,5,26,0,8,8,0,0,0,0,0,0
2020,1965,190,21,211,72,70,142,1,0,1,12,7,19
2020,1966,14,2,16,0,5,5,0,0,0,0,0,0
2020,1967,27,5,32,0,4,4,0,0,0,0,8,8
2020,1969,67,10,77,9,32,41,0,0,0,3,2,5
2020,1970,32,2,34,4,12,16,0,0,0,0,0,0
2020,1972,181,12,193,23,67,90,1,0,1,6,8,14
2020,1973,40,4,44,2,9,11,0,0,0,0,0,0
2020,1975,86,4,90,4,33,37,0,0,0,3,3,6
2020,1976,101,19,120,11,38,49,0,0,0,0,0,0
2020,1978,18,3,21,15,18,33,0,0,0,0,0,0
2020,1981,19,0,19,4,5,9,0,0,0,0,0,0
2020,1982,19,3,22,5,8,13,0,0,0,0,0,0
2020,1983,14,3,17,8,7,15,0,0,0,0,0,0
2020,1984,18,1,19,7,10,17,0,0,0,0,0,0
2020,1997,50,9,59,15,22,37,0,0,0,0,0,0
2020,2000,85,6,91,3,30,33,0,0,0,0,0,0
2020,2001,17,3,20,2,8,10,0,0,0,0,0,0
2020,2002,61,8,69,7,21,28,0,0,0,0,0,0
2020,2100,95,21,116,20,56,76,60,20,80,11,14,25
2020,2101,6,0,6,0,0,0,0,0,0,0,0,0
2020,2103,11,0,11,5,0,5,0,0,0,0,0,0
2020,2105,18,2,20,1,5,6,0,0,0,0,0,0
2020,2106,47,7,54,2,19,21,0,0,0,0,0,0
2020,2107,8,0,8,0,0,0,0,0,0,0,0,0
2020,2109,51,13,64,5,20,25,0,0,0,0,0,0
2020,2110,16,3,19,0,6,6,0,0,0,0,0,0
2020,2111,13,0,13,1,3,4,0,0,0,0,0,0
2020,2113,4,0,4,1,1,2,0,0,0,0,0,0
2020,2117,33,7,40,0,4,4,0,0,0,0,0,0
2020,2200,35,5,40,3,12,15,10,9,19,0,0,0
2020,2300,58,4,62,10,30,40,42,13,55,1,5,6
2020,2301,13,1,14,1,4,5,0,0,0,0,0,0
2020,2303,26,1,27,5,11,16,0,0,0,0,0,0
2020,2304,8,0,8,1,3,4,0,0,0,0,0,0
2020,2400,96,8,104,10,39,49,9,2,11,60,43,103
2020,2401,23,0,23,4,6,10,0,0,0,0,0,0
2020,2402,10,1,11,1,4,5,0,0,0,0,0,0
2020,2403,6,1,7,0,2,2,0,0,0,0,0,0
2020,2404,16,0,16,0,9,9,0,0,0,0,0,0
2020,2405,39,4,43,3,20,23,0,0,0,3,2,5
2020,2406,87,7,94,10,28,38,0,0,0,0,0,0
2020,2412,14,4,18,6,7,13,0,0,0,0,0,0
2020,2500,11,1,12,1,7,8,9,2,11,0,0,0
2020,2501,8,0,8,0,0,0,0,0,0,0,0,0
2020,2600,19,3,22,2,3,5,1,0,1,10,6,16
2020,2601,14,1,15,1,3,4,0,0,0,0,0,0
2020,2700,112,11,123,13,48,61,156,33,189,32,43,75
2020,2701,12,2,14,0,7,7,0,0,0,0,0,0
2020,2702,10,0,10,0,0,0,0,0,0,0,0,0
2020,2703,9,1,10,1,2,3,0,0,0,0,0,0
2020,2704,23,1,24,0,6,6,0,0,0,0,0,0
2020,2705,15,1,16,0,2,2,0,0,0,0,0,0
2020,2706,42,6,48,1,5,6,0,0,0,6,5,11
2020,2707,15,6,21,3,8,11,0,0,0,0,0,0
2020,2708,135,15,150,13,37,50,0,0,0,0,0,0
2020,2709,10,0,10,0,1,1,0,0,0,0,0,0
2020,2710,29,3,32,3,9,12,0,0,0,0,0,0
2020,2711,15,2,17,1,3,4,0,0,0,0,0,0
2020,2712,26,2,28,0,8,8,0,0,0,0,0,0
2020,2719,10,5,15,2,8,10,0,0,0,0,0,0
2020,2800,99,8,107,10,23,33,1,0,1,0,0,0
2020,2801,8,3,11,0,5,5,0,0,0,0,0,0
2020,2802,63,6,69,5,38,43,0,0,0,0,0,0
2020,2803,9,2,11,0,6,6,0,0,0,0,0,0
2020,2808,113,9,122,5,8,13,0,0,0,0,0,0
2020,2900,55,5,60,5,22,27,2,0,2,38,25,63
2020,2901,24,2,26,2,4,6,0,0,0,0,0,0
2020,2902,8,0,8,0,2,2,0,0,0,0,0,0
2020,2908,24,1,25,3,12,15,0,0,0,0,0,0
2020,3000,938,138,1076,538,650,1188,704,99,803,331,246,577
2020,3001,350,29,379,30,116,146,17,6,23,0,8,8
2020,3002,53,4,57,8,35,43,0,0,0,0,0,0
2020,3003,77,10,87,6,32,38,0,0,0,5,0,5
2020,3004,116,13,129,11,50,61,0,0,0,0,0,0
2020,3005,42,3,45,1,10,11,0,0,0,3,1,4
2020,3006,17,2,19,1,6,7,0,0,0,0,0,0
2020,3007,48,10,58,3,16,19,0,0,0,0,0,0
2020,3008,107,14,121,11,43,54,0,0,0,1,5,6
2020,3009,162,9,171,12,53,65,0,0,0,0,0,0
2020,3010,181,18,199,26,79,105,0,0,0,12,5,17
2020,3011,43,11,54,12,29,41,0,0,0,2,1,3
2020,3012,60,8,68,9,21,30,0,0,0,0,0,0
2020,3013,18,1,19,0,4,4,0,0,0,0,0,0
2020,3014,124,13,137,26,47,73,0,0,0,4,3,7
2020,3015,138,12,150,25,43,68,0,0,0,0,0,0
2020,3016,44,4,48,8,9,17,0,0,0,2,1,3
2020,3019,331,34,365,41,97,138,1,0,1,48,42,90
2020,3020,33,4,37,9,6,15,0,0,0,0,0,0
2020,3022,78,12,90,14,37,51,0,0,0,0,0,0
2020,3024,76,11,87,1,33,34,2,0,2,0,0,0
2020,3026,179,39,218,32,69,101,0,0,0,0,0,0
2020,3027,18,6,24,1,12,13,0,0,0,0,0,0
2020,3096,9,0,9,1,4,5,0,0,0,0,0,0
2020,3097,38,9,47,32,28,60,0,0,0,0,0,0
2020,3100,165,17,182,29,82,111,63,6,69,91,90,181
2020,3101,18,2,20,1,6,7,0,0,0,0,0,0
2020,3103,22,2,24,2,6,8,0,0,0,0,0,0
2020,3104,55,5,60,2,22,24,0,0,0,0,0,0
2020,3105,125,11,136,12,48,60,0,0,0,0,0,0
2020,3200,30,2,32,1,6,7,1,0,1,12,8,20
2020,3300,1306,142,1448,208,688,896,286,45,331,772,320,1092
2020,3301,23,3,26,2,14,16,0,0,0,0,0,0
2020,3302,37,4,41,3,12,15,0,0,0,0,0,0
2020,3303,19,1,20,5,5,10,0,0,0,0,0,0
2020,3306,23,3,26,1,6,7,0,0,0,0,0,0
2020,3308,67,3,70,10,24,34,0,0,0,0,0,0
2020,3309,65,5,70,13,29,42,0,0,0,0,0,0
2020,3311,85,12,97,19,28,47,0,0,0,3,0,3
2020,3313,334,45,379,23,120,143,0,0,0,0,0,0
2020,3315,126,16,142,12,49,61,0,0,0,3,3,6
2020,3325,42,5,47,5,15,20,0,0,0,0,0,0
2020,3342,92,8,100,2,49,51,0,0,0,0,0,0
2020,3344,15,3,18,2,4,6,0,0,0,0,0,0
2020,3378,53,5,58,2,20,22,0,0,0,0,0,0
2020,3397,28,3,31,4,5,9,0,0,0,0,0,0
2020,3400,713,129,842,156,276,432,399,92,491,68,135,203
2020,3401,67,8,75,0,27,27,0,0,0,0,0,0
2020,3402,27,4,31,2,11,13,0,0,0,0,0,0
2020,3404,576,108,684,94,234,328,0,0,0,0,0,0
2020,3408,17,2,19,11,12,23,0,0,0,0,0,0
2020,3414,13,3,16,0,5,5,0,0,0,0,0,0
2020,3420,2,0,2,0,1,1,0,0,0,0,0,0
2020,3422,428,88,516,12,23,35,0,0,0,0,0,0
2020,3477,76,9,85,10,11,21,0,0,0,0,0,0
2020,3496,71,12,83,9,38,47,0,0,0,0,0,0
2020,3499,6574,427,7001,1328,1875,3203,0,0,0,0,0,0
2020,3500,23,0,23,0,4,4,2,0,2,15,14,29
2020,3501,27,4,31,0,8,8,0,0,0,0,0,0
2020,3600,1120,188,1308,149,591,740,568,109,677,183,496,679
2020,3601,39,2,41,0,17,17,0,0,0,0,0,0
2020,3602,101,13,114,3,48,51,0,0,0,0,0,0
2020,3603,45,7,52,4,20,24,0,0,0,0,0,0
2020,3604,170,16,186,13,98,111,0,0,0,0,0,0
2020,3605,33,3,36,7,18,25,0,0,0,0,0,0
2020,3607,235,23,258,11,68,79,0,0,0,0,0,0
2020,3608,77,7,84,5,28,33,0,0,0,0,0,0
2020,3609,93,13,106,3,32,35,0,0,0,0,0,0
2020,3610,210,29,239,17,78,95,0,0,0,0,0,0
2020,3611,64,7,71,2,29,31,0,0,0,0,0,0
2020,3614,14,5,19,2,9,11,0,0,0,0,0,0
2020,3623,22,3,25,38,22,60,0,0,0,0,0,0
2020,3626,11,2,13,0,2,2,0,0,0,0,0,0
2020,3639,7,3,10,2,5,7,0,0,0,0,0,0
2020,3650,12,3,15,37,21,58,0,0,0,0,0,0
2020,3657,76,21,97,6,11,17,0,0,0,0,0,0
2020,3700,1173,197,1370,299,525,824,916,296,1212,275,499,774
2020,3701,116,12,128,8,44,52,0,0,0,0,0,0
2020,3702,197,46,243,13,74,87,0,0,0,10,2,12
2020,3703,38,9,47,5,18,23,0,0,0,0,0,0
2020,3705,110,10,120,10,46,56,0,0,0,0,0,0
2020,3706,140,11,151,7,50,57,0,0,0,0,0,0
2020,3708,57,9,66,5,21,26,0,0,0,0,0,0
2020,3709,75,7,82,4,28,32,0,0,0,0,0,0
2020,3710,187,21,208,15,76,91,0,0,0,0,0,0
2020,3711,1540,306,1846,228,350,578,0,0,0,0,0,0
2020,3714,23,4,27,6,19,25,0,0,0,0,0,0
2020,3715,116,16,132,9,20,29,0,0,0,0,0,0
2020,3732,13,2,15,1,6,7,0,0,0,0,0,0
2020,3797,34,2,36,23,16,39,0,0,0,0,0,0
2020,3800,356,56,412,76,83,159,372,63,435,12,21,33
2020,3801,1901,338,2239,388,365,753,0,0,0,0,0,0
2020,3803,19,2,21,15,9,24,0,0,0,0,0,0
2020,3897,48,4,52,71,24,95,0,0,0,0,0,0
2020,3900,242,22,264,47,112,159,26,0,26,187,97,284
2020,3901,12,0,12,0,1,1,0,0,0,0,0,0
2020,3902,64,7,71,3,26,29,0,0,0,0,0,0
2020,3903,72,1,73,4,23,27,0,0,0,1,0,1
2020,3904,21,1,22,1,9,10,0,0,0,0,0,0
2020,3905,412,56,468,55,140,195,0,0,0,0,0,0
2020,3906,86,6,92,6,44,50,0,0,0,0,0,0
2020,3915,25,8,33,3,10,13,0,0,0,0,0,0
2020,4000,158,8,166,14,65,79,112,25,137,11,28,39
2020,4001,21,1,22,0,3,3,0,0,0,0,0,0
2020,4002,15,4,19,2,5,7,0,0,0,0,0,0
2020,4003,15,2,17,0,2,2,0,0,0,0,0,0
2020,4004,33,2,35,1,14,15,0,0,0,0,0,0
2020,4005,16,3,19,0,12,12,0,0,0,0,0,0
2020,4006,50,9,59,4,21,25,0,0,0,0,0,0
2020,4007,15,3,18,1,4,5,0,0,0,0,0,0
2020,4008,25,3,28,3,7,10,0,0,0,0,0,0
2020,4016,140,26,166,0,13,13,0,0,0,0,0,0
2020,4019,4,1,5,1,1,2,0,0,0,0,0,0
2020,4100,169,9,178,48,98,146,122,19,141,180,79,259
2020,4101,18,2,20,0,8,8,0,0,0,0,0,0
2020,4102,30,2,32,4,8,12,0,0,0,0,0,0
2020,4103,12,2,14,0,3,3,0,0,0,0,0,0
2020,4104,32,7,39,6,14,20,0,0,0,0,0,0
2020,4105,16,2,18,0,6,6,0,0,0,0,0,0
2020,4106,90,8,98,12,17,29,0,0,0,0,0,0
2020,4108,22,4,26,2,7,9,0,0,0,0,0,0
2020,4109,39,3,42,3,12,15,0,0,0,0,0,0
2020,4111,28,3,31,0,3,3,0,0,0,0,0,0
2020,4113,76,8,84,4,28,32,0,0,0,0,0,0
2020,4114,38,4,42,0,15,15,0,0,0,0,0,0
2020,4116,85,23,108,10,33,43,0,0,0,0,0,0
2020,4117,72,7,79,7,23,30,0,0,0,0,0,0
2020,4119,5,2,7,0,1,1,0,0,0,0,0,0
2020,4120,31,6,37,4,11,15,0,0,0,0,0,0
2020,4127,32,5,37,1,7,8,0,0,0,0,0,0
2020,4200,225,21,246,29,91,120,205,38,243,36,44,80
2020,4201,12,1,13,0,2,2,0,0,0,0,0,0
2020,4202,34,1,35,5,16,21,0,0,0,4,0,4
2020,4203,105,26,131,19,49,68,0,0,0,0,0,0
2020,4204,124,9,133,5,43,48,0,0,0,0,0,0
2020,4211,5,1,6,3,3,6,0,0,0,0,0,0
2020,4297,28,8,36,9,10,19,0,0,0,0,0,0
2020,4300,404,55,459,56,103,159,655,172,827,87,145,232
2020,4302,38,4,42,6,25,31,0,0,0,0,0,0
2020,4304,52,8,60,4,22,26,0,0,0,3,1,4
2020,4305,25,7,32,2,11,13,0,0,0,0,0,0
2020,4307,33,6,39,3,17,20,0,0,0,0,0,0
2020,4308,68,14,82,11,28,39,0,0,0,0,0,0
2020,4310,33,5,38,5,15,20,0,0,0,0,0,0
2020,4311,78,10,88,11,33,44,0,0,0,0,0,0
2020,4312,71,9,80,16,27,43,0,0,0,0,0,0
2020,4313,1032,138,1170,135,326,461,0,0,0,0,0,0
2020,4314,131,14,145,13,53,66,0,0,0,4,1,5
2020,4316,197,20,217,21,51,72,0,0,0,0,0,0
2020,4317,18,7,25,22,18,40,0,0,0,0,0,0
2020,4320,5,1,6,7,6,13,0,0,0,0,0,0
2020,4321,9,0,9,3,3,6,0,0,0,0,0,0
2020,4327,10,0,10,3,1,4,0,0,0,0,0,0
2020,4400,120,25,145,3,45,48,9,0,9,84,49,133
2020,4401,19,2,21,4,2,6,0,0,0,0,0,0
2020,4402,75,8,83,13,19,32,0,0,0,0,0,0
2020,4403,64,5,69,3,15,18,0,0,0,0,0,0
2020,4404,15,2,17,0,7,7,0,0,0,0,0,0
2020,4497,19,5,24,5,13,18,0,0,0,0,0,0
2020,4500,69,3,72,7,36,43,55,14,69,6,10,16
2020,4501,19,0,19,0,8,8,0,0,0,0,0,0
2020,4502,95,6,101,13,28,41,0,0,0,0,0,0
2020,4591,20,1,21,3,1,4,0,0,0,0,0,0
2020,4600,8,1,9,4,2,6,0,0,0,0,0,0
2020,4700,35,2,37,3,15,18,23,5,28,2,9,11
2020,4703,4,0,4,0,0,0,0,0,0,0,0,0
2020,4706,8,0,8,0,4,4,0,0,0,0,0,0
2020,4707,2,0,2,0,0,0,0,0,0,0,0,0
2020,4708,8,0,8,4,2,6,0,0,0,0,0,0
2020,4709,13,0,13,2,6,8,0,0,0,0,0,0
2020,4710,3,0,3,0,0,0,0,0,0,0,0,0
2020,4800,118,13,131,34,75,109,4,0,4,184,77,261
2020,4801,26,5,31,0,18,18,0,0,0,0,0,0
2020,4802,25,1,26,0,5,5,0,0,0,0,0,0
2020,4803,107,10,117,7,55,62,0,0,0,0,0,0
2020,4804,11,1,12,0,2,2,0,0,0,0,0,0
2020,4805,16,5,21,1,11,12,0,0,0,0,0,0
2020,4806,100,16,116,1,54,55,0,0,0,0,0,0
2020,4807,100,11,111,8,44,52,0,0,0,0,0,0
2020,4900,210,14,224,32,69,101,1,0,1,182,87,269
2020,4901,12,1,13,1,7,8,0,0,0,0,0,0
2020,4902,11,1,12,0,5,5,0,0,0,0,0,0
2020,4903,14,2,16,0,7,7,0,0,0,0,0,0
2020,4904,61,10,71,4,22,26,0,0,0,0,0,0
2020,4905,162,12,174,21,57,78,0,0,0,0,0,0
2020,4906,14,1,15,2,4,6,0,0,0,0,0,0
2020,4908,53,4,57,13,26,39,0,0,0,0,0,0
2020,4909,12,1,13,0,1,1,0,0,0,0,0,0
2020,4914,7,2,9,8,3,11,0,0,0,0,0,0
2020,5000,211,10,221,42,105,147,249,47,296,8,40,48
2020,5001,44,3,47,2,14,16,0,0,0,0,0,0
2020,5002,184,19,203,26,73,99,0,0,0,0,0,0
2020,5003,11,1,12,0,2,2,0,0,0,0,0,0
2020,5004,18,4,22,1,8,9,0,0,0,0,0,0
2020,5007,68,8,76,1,34,35,0,0,0,0,0,0
2020,5010,8,4,12,1,6,7,0,0,0,0,0,0
2020,5100,41,2,43,2,20,22,42,15,57,0,4,4
2020,5102,55,9,64,2,22,24,0,0,0,0,0,0
2020,5200,29,3,32,5,21,26,27,11,38,5,4,9
2020,5201,13,0,13,2,6,8,0,0,0,0,0,0
2020,5202,20,3,23,4,9,13,0,0,0,0,0,0
2020,5300,18,3,21,0,6,6,12,6,18,1,3,4
2020,5400,241,43,284,22,107,129,207,46,253,35,66,101
2020,5401,31,2,33,5,8,13,0,0,0,0,0,0
2020,5402,15,2,17,0,1,1,0,0,0,0,0,0
2020,5403,15,1,16,0,1,1,0,0,0,0,0,0
2020,5404,15,2,17,0,1,1,0,0,0,0,0,0
2020,5405,56,12,68,11,21,32,0,0,0,0,0,0
2020,5406,60,7,67,15,31,46,0,0,0,0,0,0
2020,5407,133,17,150,10,56,66,0,0,0,0,0,0
2020,5408,10,1,11,0,1,1,0,0,0,0,0,0
2020,5411,6,0,6,0,1,1,0,0,0,0,0,0
2020,5500,57,3,60,2,18,20,0,0,0,30,18,48
2020,5501,8,2,10,1,6,7,0,0,0,0,0,0
2020,5600,410,55,465,87,204,291,232,46,278,93,107,200
2020,5604,194,33,227,22,69,91,0,0,0,3,4,7
2020,5605,16,4,20,3,7,10,0,0,0,0,0,0
2020,5606,29,2,31,3,8,11,0,0,0,0,0,0
2020,5608,115,16,131,13,42,55,0,0,0,0,0,0
2020,5609,113,11,124,8,33,41,0,0,0,0,0,0
2020,5622,12,1,13,6,7,13,0,0,0,0,0,0
2020,5680,13,1,14,0,0,0,0,0,0,0,0,0
2020,5700,68,6,74,4,33,37,1,0,1,85,59,144
2020,5701,48,8,56,8,24,32,0,0,0,0,0,0
2020,5702,8,1,9,0,2,2,0,0,0,0,0,0
2020,5703,57,9,66,0,15,15,0,0,0,0,0,0
2020,5704,62,9,71,3,21,24,0,0,0,0,0,0
2020,5797,31,8,39,8,15,23,0,0,0,0,0,0
2020,5800,58,4,62,3,30,33,44,26,70,4,5,9
2020,5801,16,1,17,1,9,10,0,0,0,0,0,0
2020,5802,8,0,8,0,0,0,0,0,0,0,0,0
2020,10M1,214,31,245,8,10,18,0,0,0,0,0,0
2020,190C,10,1,11,2,5,7,0,0,0,0,0,0
2020,190R,9,0,9,1,4,5,0,0,0,0,0,0
2020,191N,7,1,8,3,3,6,0,0,0,0,0,0
2020,19A9,111,20,131,4,8,12,0,0,0,0,0,0
2020,340H,113,22,135,28,79,107,0,0,0,0,0,0
2021,100,484,57,541,97,223,320,420,74,494,97,145,242
2021,101,61,6,67,4,26,30,0,0,0,0,0,0
2021,102,24,1,25,2,7,9,0,0,0,0,0,0
2021,103,124,24,148,19,54,73,1,0,1,9,8,17
2021,104,32,4,36,4,14,18,0,0,0,0,0,0
2021,105,169,20,189,13,75,88,0,0,0,4,8,12
2021,106,153,17,170,15,75,90,0,0,0,14,8,22
2021,107,76,14,90,6,32,38,0,0,0,0,0,0
2021,108,37,13,50,8,18,26,0,0,0,0,0,0
2021,109,579,103,682,85,220,305,0,0,0,0,0,0
2021,110,18,2,20,1,9,10,0,0,0,0,0,0
2021,111,69,9,78,4,30,34,0,0,0,0,0,0
2021,112,69,7,76,2,27,29,0,0,0,6,5,11
2021,113,61,9,70,6,12,18,0,0,0,0,0,0
2021,114,55,4,59,11,21,32,0,0,0,0,0,0
2021,115,10,1,11,3,5,8,0,0,0,0,0,0
2021,116,21,0,21,0,0,0,0,0,0,0,0,0
2021,197,33,10,43,33,19,52,0,0,0,0,0,0
2021,200,13,0,13,0,3,3,0,0,0,0,0,0
2021,300,45,3,48,4,14,18,1,0,1,10,8,18
2021,302,8,0,8,0,0,0,0,0,0,0,0,0
2021,303,7,2,9,0,2,2,0,0,0,0,0,0
2021,305,3,1,4,0,0,0,0,0,0,0,0,0
2021,400,90,5,95,21,36,57,0,0,0,62,49,111
2021,402,87,8,95,4,32,36,0,0,0,5,4,9
2021,403,10,2,12,1,4,5,0,0,0,0,0,0
2021,404,18,3,21,4,9,13,0,0,0,0,0,0
2021,405,15,2,17,4,3,7,0,0,0,0,0,0
2021,497,12,3,15,1,7,8,0,0,0,0,0,0
2021,500,52,10,62,2,19,21,2,0,2,15,19,34
2021,501,6,1,7,0,1,1,0,0,0,0,0,0
2021,600,29,1,30,4,16,20,6,7,13,0,1,1
2021,601,6,3,9,0,0,0,0,0,0,0,0,0
2021,602,10,1,11,0,2,2,0,0,0,0,0,0
2021,700,239,45,284,54,155,209,304,51,355,43,53,96
2021,701,106,6,112,5,34,39,0,0,0,3,1,4
2021,702,57,7,64,6,25,31,0,0,0,0,0,0
2021,703,5,5,10,0,2,2,0,0,0,0,0,0
2021,704,111,20,131,0,36,36,0,0,0,2,0,2
2021,705,29,3,32,2,6,8,0,0,0,0,0,0
2021,706,21,4,25,0,3,3,0,0,0,0,0,0
2021,707,20,4,24,3,15,18,0,0,0,0,0,0
2021,708,69,12,81,2,19,21,0,0,0,0,0,0
2021,709,35,8,43,3,12,15,0,0,0,0,0,0
2021,710,103,26,129,12,32,44,1,0,1,4,2,6
2021,711,52,3,55,4,16,20,0,0,0,0,4,4
2021,712,65,11,76,7,28,35,0,0,0,0,0,0
2021,713,5,1,6,0,0,0,0,0,0,0,0,0
2021,714,30,2,32,0,13,13,0,0,0,0,0,0
2021,716,8,2,10,0,2,2,0,0,0,0,0,0
2021,718,195,26,221,76,58,134,0,0,0,0,0,0
2021,721,18,2,20,5,7,12,0,0,0,0,0,0
2021,724,57,9,66,5,12,17,0,0,0,0,0,0
2021,800,12,5,17,1,6,7,1,0,1,13,10,23
2021,801,10,2,12,0,1,1,0,0,0,0,0,0
2021,900,151,11,162,24,48,72,5,0,5,73,35,108
2021,901,15,3,18,0,8,8,0,0,0,0,0,0
2021,902,35,3,38,2,17,19,0,0,0,0,0,0
2021,1000,360,36,396,55,125,180,10,2,12,398,150,548
2021,1001,85,16,101,17,44,61,0,0,0,2,0,2
2021,1002,15,0,15,9,0,9,0,0,0,0,0,0
2021,1003,12,1,13,0,5,5,0,0,0,0,0,0
2021,1004,12,0,12,0,1,1,0,0,0,0,0,0
2021,1005,680,89,769,105,196,301,0,0,0,0,0,0
2021,1006,6,1,7,0,2,2,0,0,0,0,0,0
2021,1007,17,5,22,0,4,4,0,0,0,0,0,0
2021,1008,19,2,21,0,4,4,0,0,0,0,0,0
2021,1009,15,1,16,2,4,6,0,0,0,0,0,0
2021,1010,11,1,12,0,1,1,0,0,0,0,0,0
2021,1011,14,0,14,0,4,4,0,0,0,0,0,0
2021,1012,29,2,31,2,11,13,0,0,0,0,0,0
2021,1013,32,4,36,3,3,6,0,0,0,0,0,0
2021,1015,33,2,35,2,8,10,0,0,0,0,0,0
2021,1017,20,1,21,1,5,6,0,0,0,0,0,0
2021,1035,14,2,16,0,1,1,0,0,0,0,0,0
2021,1097,20,5,25,1,9,10,0,0,0,0,0,0
2021,10M1,216,28,244,5,12,17,0,0,0,0,0,0
2021,1100,25,3,28,1,14,15,1,0,1,12,6,18
2021,1101,0,0,0,0,2,2,11,0,11,0,0,0
2021,1200,82,7,89,17,45,62,68,26,94,5,11,16
2021,1201,17,3,20,1,12,13,0,0,0,0,0,0
2021,1203,34,4,38,2,18,20,0,0,0,0,0,0
2021,1204,5,0,5,0,0,0,0,0,0,0,0,0
2021,1205,17,1,18,0,8,8,0,0,0,0,0,0
2021,1207,4,1,5,0,1,1,0,0,0,0,0,0
2021,1208,11,1,12,1,6,7,0,0,0,0,0,0
2021,1300,95,4,99,13,34,47,69,23,92,10,24,34
2021,1301,24,2,26,2,11,13,0,0,0,0,0,0
2021,1302,20,2,22,4,12,16,0,0,0,0,0,0
2021,1303,4,0,4,0,0,0,0,0,0,0,0,0
2021,1304,42,1,43,5,19,24,0,0,0,0,0,0
2021,1306,15,4,19,1,2,3,0,0,0,0,0,0
2021,1307,3,0,3,0,0,0,0,0,0,0,0,0
2021,1400,29,0,29,0,0,0,7,0,7,9,8,17
2021,1401,11,1,12,2,6,8,0,0,0,0,0,0
2021,1500,290,23,313,76,171,247,319,91,410,43,88,131
2021,1501,18,2,20,3,4,7,0,0,0,0,0,0
2021,1502,383,39,422,44,170,214,0,0,0,0,0,0
2021,1503,41,5,46,5,14,19,0,0,0,0,0,0
2021,1505,15,2,17,0,6,6,0,0,0,0,0,0
2021,1506,25,3,28,5,13,18,0,0,0,0,0,0
2021,1507,26,4,30,4,9,13,0,0,0,0,0,0
2021,1508,10,1,11,1,8,9,0,0,0,0,0,0
2021,1509,17,2,19,0,9,9,0,0,0,0,0,0
2021,1511,14,0,14,2,8,10,0,0,0,0,0,0
2021,1514,5,0,5,0,0,0,0,0,0,0,0,0
2021,1515,5,0,5,0,1,1,0,0,0,0,0,0
2021,1521,29,2,31,0,5,5,0,0,0,0,0,0
2021,1597,10,4,14,0,8,8,0,0,0,0,0,0
2021,1600,83,5,88,4,43,47,0,0,0,71,70,141
2021,1601,14,3,17,4,10,14,0,0,0,0,0,0
2021,1602,52,7,59,3,23,26,0,0,0,0,0,0
2021,1603,30,3,33,1,7,8,0,0,0,0,0,0
2021,1607,12,6,18,0,2,2,0,0,0,0,0,0
2021,1700,49,3,52,5,13,18,25,12,37,6,5,11
2021,1701,8,4,12,1,1,2,0,0,0,0,0,0
2021,1702,21,1,22,3,10,13,0,0,0,0,0,0
2021,1800,26,11,37,1,10,11,17,8,25,4,6,10
2021,1801,13,2,15,0,3,3,0,0,0,0,0,0
2021,1900,5534,1256,6790,1582,2440,4022,2229,503,2732,820,922,1742
2021,1901,71,10,81,5,35,40,0,0,0,0,0,0
2021,1902,56,6,62,1,24,25,0,0,0,0,1,1
2021,1905,46,4,50,4,22,26,0,0,0,0,0,0
2021,1906,52,4,56,0,23,23,0,0,0,0,0,0
2021,1907,22,5,27,4,8,12,0,0,0,0,0,0
2021,1909,44,3,47,4,16,20,0,0,0,0,0,0
2021,190C,11,1,12,1,4,5,0,0,0,0,0,0
2021,190R,10,0,10,1,4,5,0,0,0,0,0,0
2021,1910,106,19,125,32,54,86,0,0,0,0,0,0
2021,1912,134,18,152,18,51,69,0,0,0,3,6,9
2021,1913,33,8,41,5,15,20,0,0,0,3,2,5
2021,1916,51,3,54,4,20,24,0,0,0,3,1,4
2021,1918,97,9,106,19,13,32,0,0,0,4,2,6
2021,1920,97,15,112,12,35,47,0,0,0,0,0,0
2021,1922,104,12,116,4,24,28,0,0,0,6,2,8
2021,1923,51,5,56,2,12,14,0,0,0,3,2,5
2021,1924,76,11,87,2,13,15,0,0,0,6,3,9
2021,1925,205,23,228,19,62,81,0,0,0,11,8,19
2021,1926,46,4,50,7,19,26,0,0,0,1,4,5
2021,1928,78,9,87,16,26,42,1,0,1,5,5,10
2021,1929,35,3,38,15,3,18,0,0,0,2,7,9
2021,1931,46,5,51,10,13,23,0,0,0,3,2,5
2021,1933,158,22,180,6,37,43,0,0,0,3,7,10
2021,1934,26,1,27,0,6,6,0,0,0,0,0,0
2021,1938,36,5,41,1,17,18,0,0,0,0,0,0
2021,1941,672,93,765,72,141,213,7,0,7,24,14,38
2021,1942,7666,1758,9424,860,1436,2296,45,5,50,268,128,396
2021,1944,56,4,60,8,18,26,0,0,0,2,5,7
2021,1946,39,7,46,3,20,23,0,0,0,1,2,3
2021,1947,64,7,71,1,22,23,0,0,0,0,0,0
2021,1948,59,13,72,6,19,25,0,0,0,2,3,5
2021,1951,16,0,16,3,0,3,0,0,0,1,6,7
2021,1953,188,33,221,20,63,83,0,0,0,12,9,21
2021,1955,128,18,146,34,70,104,0,0,0,10,8,18
2021,1956,76,12,88,10,31,41,0,0,0,4,6,10
2021,1961,24,4,28,2,5,7,0,0,0,4,2,6
2021,1962,47,4,51,3,11,14,0,0,0,0,0,0
2021,1963,20,6,26,1,9,10,0,0,0,0,0,0
2021,1965,184,21,205,65,69,134,1,0,1,12,6,18
2021,1966,14,2,16,0,5,5,0,0,0,0,0,0
2021,1967,25,4,29,1,5,6,0,0,0,0,0,0
2021,1969,67,11,78,7,27,34,0,0,0,4,2,6
2021,1970,31,2,33,3,13,16,0,0,0,0,0,0
2021,1972,196,12,208,28,90,118,0,0,0,10,9,19
2021,1973,37,4,41,2,12,14,0,0,0,0,0,0
2021,1975,81,6,87,7,34,41,0,0,0,3,3,6
2021,1976,101,23,124,10,40,50,0,0,0,0,0,0
2021,1978,18,3,21,12,15,27,0,0,0,0,0,0
2021,1981,18,0,18,4,4,8,0,0,0,0,0,0
2021,1982,17,2,19,6,7,13,0,0,0,0,0,0
2021,1983,14,4,18,7,6,13,0,0,0,0,0,0
2021,1984,15,1,16,5,9,14,0,0,0,0,0,0
2021,1997,35,10,45,40,36,76,0,0,0,0,0,0
2021,19A9,105,20,125,4,5,9,0,0,0,0,0,0
2021,2000,94,10,104,3,31,34,1,0,1,72,34,106
2021,2001,19,1,20,3,8,11,0,0,0,0,0,0
2021,2002,58,7,65,6,20,26,0,0,0,0,0,0
2021,2100,94,22,116,19,49,68,57,23,80,11,14,25
2021,2101,6,0,6,0,0,0,0,0,0,0,0,0
2021,2103,10,1,11,2,3,5,0,0,0,0,0,0
2021,2105,19,2,21,1,4,5,0,0,0,0,0,0
2021,2106,46,9,55,1,19,20,0,0,0,0,0,0
2021,2107,8,0,8,0,0,0,0,0,0,0,0,0
2021,2109,52,11,63,3,17,20,0,0,0,0,0,0
2021,2110,16,3,19,1,5,6,0,0,0,0,0,0
2021,2111,13,0,13,1,3,4,0,0,0,0,0,0
2021,2113,5,0,5,1,1,2,0,0,0,0,0,0
2021,2117,33,9,42,5,9,14,0,0,0,0,0,0
2021,2200,34,5,39,2,14,16,11,8,19,0,0,0
2021,2300,88,4,92,8,14,22,33,14,47,2,10,12
2021,2301,14,1,15,0,4,4,0,0,0,0,0,0
2021,2303,25,1,26,4,11,15,0,0,0,0,0,0
2021,2304,9,1,10,1,2,3,0,0,0,0,0,0
2021,2400,106,12,118,7,40,47,58,27,85,7,15,22
2021,2401,23,2,25,4,6,10,0,0,0,0,0,0
2021,2402,10,0,10,1,4,5,0,0,0,0,0,0
2021,2403,8,1,9,1,2,3,0,0,0,0,0,0
2021,2404,17,0,17,0,9,9,0,0,0,0,0,0
2021,2405,40,4,44,4,20,24,0,0,0,2,0,2
2021,2406,83,13,96,7,29,36,0,0,0,0,0,0
2021,2412,14,3,17,6,9,15,0,0,0,0,0,0
2021,2500,11,1,12,2,6,8,9,4,13,0,0,0
2021,2501,8,0,8,0,1,1,0,0,0,0,0,0
2021,2600,19,3,22,2,3,5,1,0,1,9,6,15
2021,2601,13,1,14,2,3,5,0,0,0,0,0,0
2021,2700,108,12,120,11,51,62,141,27,168,46,45,91
2021,2701,11,2,13,0,7,7,0,0,0,0,0,0
2021,2702,10,0,10,0,0,0,0,0,0,0,0,0
2021,2703,9,1,10,1,2,3,0,0,0,0,0,0
2021,2704,21,1,22,0,6,6,0,0,0,0,0,0
2021,2705,12,2,14,0,2,2,0,0,0,0,0,0
2021,2706,42,6,48,1,5,6,0,0,0,6,5,11
2021,2707,13,6,19,4,8,12,0,0,0,0,0,0
2021,2708,128,14,142,6,33,39,0,0,0,0,0,0
2021,2709,10,0,10,0,1,1,0,0,0,0,0,0
2021,2710,26,2,28,3,8,11,0,0,0,0,0,0
2021,2711,17,2,19,2,3,5,0,0,0,0,0,0
2021,2712,24,5,29,0,7,7,0,0,0,0,0,0
2021,2719,12,4,16,1,7,8,0,0,0,0,0,0
2021,2800,101,9,110,4,32,36,0,0,0,0,0,0
2021,2801,8,3,11,0,6,6,0,0,0,0,0,0
2021,2802,56,5,61,5,37,42,0,0,0,0,0,0
2021,2803,9,2,11,0,6,6,0,0,0,0,0,0
2021,2808,112,8,120,4,5,9,0,0,0,0,0,0
2021,2900,54,4,58,8,27,35,2,0,2,37,27,64
2021,2901,26,2,28,1,4,5,0,0,0,0,0,0
2021,2902,7,0,7,0,1,1,0,0,0,0,0,0
2021,2908,24,1,25,1,9,10,0,0,0,0,0,0
2021,3000,972,145,1117,543,652,1195,653,104,757,308,234,542
2021,3001,339,30,369,39,112,151,16,5,21,0,9,9
2021,3002,53,7,60,4,25,29,0,0,0,0,0,0
2021,3003,73,10,83,7,31,38,0,0,0,0,0,0
2021,3004,119,15,134,17,50,67,0,0,0,5,4,9
2021,3005,47,5,52,1,10,11,0,0,0,3,1,4
2021,3006,18,2,20,0,6,6,0,0,0,0,0,0
2021,3007,48,10,58,2,18,20,0,0,0,0,0,0
2021,3008,100,14,114,12,36,48,0,0,0,1,6,7
2021,3009,163,9,172,9,56,65,0,0,0,0,0,0
2021,3010,161,21,182,17,72,89,1,0,1,12,5,17
2021,3011,41,11,52,9,24,33,0,0,0,1,2,3
2021,3012,55,8,63,10,26,36,0,0,0,0,0,0
2021,3013,17,2,19,0,4,4,0,0,0,0,0,0
2021,3014,130,14,144,25,49,74,0,0,0,6,3,9
2021,3015,136,14,150,26,42,68,0,0,0,0,0,0
2021,3016,40,5,45,3,6,9,0,0,0,2,1,3
2021,3019,326,34,360,41,96,137,0,1,1,48,42,90
2021,3020,35,4,39,10,4,14,0,0,0,0,0,0
2021,3022,83,12,95,12,54,66,0,0,0,0,0,0
2021,3024,72,6,78,5,34,39,0,0,0,2,2,4
2021,3026,177,33,210,29,70,99,0,0,0,0,0,0
2021,3027,18,4,22,2,11,13,0,0,0,0,0,0
2021,3096,10,0,10,2,4,6,0,0,0,0,0,0
2021,3097,37,9,46,31,28,59,0,0,0,0,0,0
2021,3100,165,16,181,19,84,103,61,6,67,87,94,181
2021,3101,17,3,20,1,7,8,0,0,0,0,0,0
2021,3103,21,2,23,2,9,11,0,0,0,0,0,0
2021,3104,55,5,60,2,23,25,0,0,0,0,0,0
2021,3105,125,10,135,17,45,62,0,0,0,0,0,0
2021,3200,27,1,28,1,12,13,1,0,1,10,9,19
2021,3300,1318,155,1473,281,693,974,170,20,190,813,349,1162
2021,3301,27,5,32,2,15,17,0,0,0,0,0,0
2021,3302,40,8,48,2,13,15,0,0,0,0,0,0
2021,3303,17,2,19,4,5,9,0,0,0,0,0,0
2021,3306,22,4,26,4,6,10,0,0,0,0,0,0
2021,3308,67,3,70,10,19,29,0,0,0,0,0,0
2021,3309,60,4,64,14,27,41,0,0,0,0,0,0
2021,3311,81,12,93,23,30,53,0,0,0,0,0,0
2021,3313,318,45,363,30,127,157,0,0,0,0,0,0
2021,3315,131,20,151,11,54,65,0,0,0,3,3,6
2021,3325,40,6,46,4,14,18,0,0,0,0,0,0
2021,3342,94,8,102,2,55,57,0,0,0,0,0,0
2021,3344,15,3,18,2,4,6,0,0,0,0,0,0
2021,3349,58,9,67,5,22,27,0,0,0,0,0,0
2021,3397,23,3,26,4,5,9,0,0,0,0,0,0
2021,3400,674,127,801,171,271,442,390,80,470,68,156,224
2021,3401,69,6,75,0,26,26,0,0,0,0,0,0
2021,3402,23,5,28,1,10,11,0,0,0,0,0,0
2021,3404,596,120,716,80,201,281,0,0,0,0,0,0
2021,3408,17,2,19,11,12,23,0,0,0,0,0,0
2021,340H,113,26,139,16,75,91,0,0,0,0,0,0
2021,3414,13,3,16,0,3,3,0,0,0,0,0,0
2021,3420,0,0,0,0,1,1,0,0,0,0,0,0
2021,3422,442,89,531,12,26,38,0,0,0,0,0,0
2021,3477,63,13,76,14,7,21,0,0,0,0,0,0
2021,3496,61,13,74,10,36,46,0,0,0,0,0,0
2021,3499,6316,420,6736,1325,1809,3134,0,0,0,0,0,0
2021,3500,27,0,27,0,4,4,2,0,2,15,13,28
2021,3501,25,6,31,1,8,9,0,0,0,0,0,0
2021,3600,1143,192,1335,153,576,729,511,94,605,168,475,643
2021,3601,35,2,37,1,16,17,0,0,0,0,0,0
2021,3602,99,15,114,4,49,53,0,0,0,0,0,0
2021,3603,44,6,50,4,23,27,0,0,0,0,0,0
2021,3604,173,18,191,11,86,97,0,0,0,0,0,0
2021,3605,41,5,46,3,17,20,0,0,0,0,0,0
2021,3607,238,23,261,13,65,78,0,0,0,0,0,0
2021,3608,70,6,76,6,28,34,0,0,0,0,0,0
2021,3609,92,19,111,2,33,35,0,0,0,0,0,0
2021,3610,214,31,245,16,84,100,0,0,0,0,0,0
2021,3611,58,7,65,2,27,29,0,0,0,0,0,0
2021,3614,11,5,16,1,10,11,0,0,0,0,0,0
2021,3623,25,3,28,38,22,60,0,0,0,0,0,0
2021,3626,11,1,12,0,2,2,0,0,0,0,0,0
2021,3639,6,3,9,2,5,7,0,0,0,0,0,0
2021,3650,12,2,14,29,24,53,0,0,0,0,0,0
2021,3657,78,22,100,2,10,12,0,0,0,0,0,0
2021,3700,1134,185,1319,342,550,892,867,277,1144,281,493,774
2021,3701,110,13,123,9,28,37,0,0,0,0,0,0
2021,3702,194,47,241,0,0,0,0,0,0,10,2,12
2021,3703,36,9,45,4,16,20,0,0,0,0,0,0
2021,3705,108,10,118,9,43,52,0,0,0,0,0,0
2021,3706,132,12,144,8,47,55,0,0,0,0,0,0
2021,3708,53,9,62,4,22,26,0,0,0,0,0,0
2021,3709,75,9,84,6,32,38,0,0,0,0,0,0
2021,3710,177,23,200,16,72,88,0,0,0,0,0,0
2021,3711,1571,306,1877,192,325,517,0,0,0,0,0,0
2021,3714,21,6,27,11,16,27,0,0,0,0,0,0
2021,3715,108,15,123,12,20,32,0,0,0,0,0,0
2021,3732,17,1,18,1,7,8,0,0,0,0,0,0
2021,3797,34,3,37,20,16,36,0,0,0,0,0,0
2021,3800,346,52,398,74,80,154,350,57,407,12,19,31
2021,3801,1820,309,2129,376,352,728,0,0,0,0,0,0
2021,3803,17,2,19,14,8,22,0,0,0,0,0,0
2021,3897,49,5,54,64,24,88,0,0,0,0,0,0
2021,3900,261,26,287,37,124,161,27,0,27,181,95,276
2021,3901,12,0,12,0,1,1,0,0,0,0,0,0
2021,3902,62,8,70,2,28,30,0,0,0,0,0,0
2021,3903,72,1,73,5,23,28,0,0,0,2,0,2
2021,3904,23,1,24,0,9,9,0,0,0,0,0,0
2021,3905,384,48,432,54,129,183,0,0,0,0,0,0
2021,3906,87,6,93,9,44,53,0,0,0,0,0,0
2021,3915,21,6,27,2,10,12,0,0,0,0,0,0
2021,4000,158,9,167,12,62,74,113,26,139,11,28,39
2021,4001,23,2,25,0,3,3,0,0,0,0,0,0
2021,4002,17,4,21,2,4,6,0,0,0,0,0,0
2021,4003,14,2,16,0,2,2,0,0,0,0,0,0
2021,4004,30,3,33,1,16,17,0,0,0,0,0,0
2021,4005,18,3,21,0,10,10,0,0,0,0,0,0
2021,4006,51,6,57,5,24,29,0,0,0,0,0,0
2021,4007,15,2,17,0,4,4,0,0,0,0,0,0
2021,4008,25,2,27,3,10,13,0,0,0,0,0,0
2021,4016,131,25,156,1,12,13,0,0,0,0,0,0
2021,4019,3,1,4,0,2,2,0,0,0,0,0,0
2021,4100,167,20,187,41,90,131,119,6,125,171,86,257
2021,4101,20,2,22,1,7,8,0,0,0,0,0,0
2021,4102,28,2,30,3,8,11,0,0,0,0,0,0
2021,4103,12,2,14,1,4,5,0,0,0,0,0,0
2021,4104,30,7,37,6,14,20,0,0,0,0,0,0
2021,4105,14,2,16,0,5,5,0,0,0,0,0,0
2021,4106,84,8,92,10,14,24,0,0,0,0,0,0
2021,4108,23,4,27,1,7,8,0,0,0,0,0,0
2021,4109,39,3,42,3,13,16,0,0,0,0,0,0
2021,4111,28,3,31,0,2,2,0,0,0,0,0,0
2021,4113,75,8,83,3,29,32,0,0,0,0,0,0
2021,4114,38,4,42,1,12,13,0,0,0,0,0,0
2021,4116,86,22,108,11,33,44,0,0,0,0,0,0
2021,4117,74,10,84,8,22,30,0,0,0,0,0,0
2021,4119,16,1,17,0,1,1,0,0,0,0,0,0
2021,4120,31,6,37,4,11,15,0,0,0,0,0,0
2021,4127,30,5,35,3,7,10,0,0,0,0,0,0
2021,4200,236,20,256,29,90,119,192,37,229,34,47,81
2021,4201,13,2,15,0,2,2,0,0,0,0,0,0
2021,4202,37,3,40,6,17,23,0,0,0,4,0,4
2021,4203,96,25,121,15,45,60,0,0,0,0,0,0
2021,4204,112,8,120,2,42,44,0,0,0,0,0,0
2021,4211,5,1,6,4,3,7,0,0,0,0,0,0
2021,4297,24,8,32,4,7,11,0,0,0,0,0,0
2021,4300,356,54,410,52,91,143,620,159,779,81,120,201
2021,4302,40,4,44,2,23,25,0,0,0,0,0,0
2021,4304,52,7,59,3,21,24,0,0,0,3,1,4
2021,4305,24,5,29,3,11,14,0,0,0,0,0,0
2021,4307,29,7,36,4,13,17,0,0,0,0,0,0
2021,4308,71,13,84,5,26,31,0,0,0,0,0,0
2021,4310,35,5,40,5,17,22,0,0,0,0,0,0
2021,4311,77,11,88,13,27,40,0,0,0,0,0,0
2021,4312,61,9,70,17,27,44,0,0,0,0,0,0
2021,4313,1009,152,1161,134,329,463,0,0,0,0,0,0
2021,4314,126,14,140,6,47,53,0,0,0,4,1,5
2021,4316,187,18,205,20,57,77,0,0,0,0,0,0
2021,4317,20,5,25,22,19,41,0,0,0,0,0,0
2021,4320,7,0,7,5,6,11,0,0,0,0,0,0
2021,4321,9,0,9,2,3,5,0,0,0,0,0,0
2021,4327,10,0,10,5,2,7,0,0,0,0,0,0
2021,4400,115,24,139,5,41,46,7,1,8,74,47,121
2021,4401,19,2,21,4,2,6,0,0,0,0,0,0
2021,4402,67,8,75,15,20,35,0,0,0,0,0,0
2021,4403,65,6,71,4,15,19,0,0,0,0,0,0
2021,4404,15,2,17,2,7,9,0,0,0,0,0,0
2021,4497,14,5,19,6,10,16,0,0,0,0,0,0
2021,4500,67,4,71,10,32,42,48,15,63,4,10,14
2021,4501,19,0,19,0,6,6,0,0,0,0,0,0
2021,4502,95,6,101,18,28,46,0,0,0,0,0,0
2021,4591,19,2,21,5,1,6,0,0,0,0,0,0
2021,4600,8,2,10,0,1,1,0,0,0,2,2,4
2021,4700,39,2,41,2,14,16,24,7,31,1,3,4
2021,4703,4,0,4,0,0,0,0,0,0,0,0,0
2021,4706,8,0,8,1,5,6,0,0,0,0,0,0
2021,4707,3,0,3,0,0,0,0,0,0,0,0,0
2021,4708,6,0,6,3,3,6,0,0,0,0,0,0
2021,4709,12,0,12,2,6,8,0,0,0,0,0,0
2021,4710,3,0,3,0,0,0,0,0,0,0,0,0
2021,4800,123,14,137,33,77,110,26,8,34,150,77,227
2021,4801,23,6,29,1,18,19,0,0,0,0,0,0
2021,4802,28,2,30,0,6,6,0,0,0,0,0,0
2021,4803,103,10,113,7,59,66,0,0,0,0,0,0
2021,4804,12,0,12,0,2,2,0,0,0,0,0,0
2021,4805,16,6,22,0,11,11,0,0,0,0,0,0
2021,4806,88,16,104,4,59,63,0,0,0,0,0,0
2021,4807,90,8,98,8,37,45,0,0,0,0,0,0
2021,4900,213,12,225,27,64,91,1,0,1,164,82,246
2021,4901,12,1,13,1,7,8,0,0,0,0,0,0
2021,4902,11,1,12,0,6,6,0,0,0,0,0,0
2021,4903,13,2,15,0,8,8,0,0,0,0,0,0
2021,4904,58,12,70,2,22,24,0,0,0,0,0,0
2021,4905,151,13,164,21,55,76,0,0,0,0,0,0
2021,4906,11,2,13,4,2,6,0,0,0,0,0,0
2021,4908,59,6,65,11,25,36,0,0,0,0,0,0
2021,4909,10,1,11,0,2,2,0,0,0,0,0,0
2021,4914,9,2,11,3,10,13,0,0,0,0,0,0
2021,5000,215,9,224,54,104,158,238,52,290,12,48,60
2021,5001,46,3,49,3,13,16,0,0,0,0,0,0
2021,5002,167,17,184,21,70,91,0,0,0,0,0,0
2021,5003,12,1,13,0,2,2,0,0,0,0,0,0
2021,5004,18,4,22,1,11,12,0,0,0,0,0,0
2021,5007,69,8,77,3,33,36,0,0,0,0,0,0
2021,5010,8,4,12,2,6,8,0,0,0,0,0,0
2021,5100,44,3,47,0,21,21,42,17,59,0,4,4
2021,5102,50,10,60,3,22,25,0,0,0,0,0,0
2021,5200,28,6,34,4,14,18,25,11,36,3,3,6
2021,5201,12,0,12,2,6,8,0,0,0,0,0,0
2021,5202,22,3,25,5,9,14,0,0,0,0,0,0
2021,5300,16,2,18,0,9,9,13,4,17,0,0,0
2021,5400,233,43,276,28,108,136,181,54,235,27,61,88
2021,5401,31,2,33,2,8,10,0,0,0,0,0,0
2021,5402,14,3,17,1,1,2,0,0,0,0,0,0
2021,5403,15,3,18,0,1,1,0,0,0,0,0,0
2021,5404,14,1,15,0,2,2,0,0,0,0,0,0
2021,5405,49,15,64,9,21,30,0,0,0,0,0,0
2021,5406,65,8,73,8,25,33,0,0,0,0,0,0
2021,5407,130,17,147,9,58,67,0,0,0,0,0,0
2021,5408,9,3,12,0,1,1,0,0,0,0,0,0
2021,5411,6,0,6,0,1,1,0,0,0,0,0,0
2021,5500,57,2,59,2,17,19,0,0,0,31,21,52
2021,5501,10,3,13,0,6,6,0,0,0,0,0,0
2021,5600,284,31,315,176,193,369,243,56,299,101,108,209
2021,5604,197,30,227,19,64,83,0,0,0,3,4,7
2021,5605,16,4,20,3,8,11,0,0,0,0,0,0
2021,5606,28,2,30,3,8,11,0,0,0,0,0,0
2021,5608,121,17,138,4,36,40,0,0,0,0,0,0
2021,5609,106,13,119,12,42,54,0,0,0,0,0,0
2021,5622,11,3,14,5,8,13,0,0,0,0,0,0
2021,5680,13,1,14,0,1,1,0,0,0,0,0,0
2021,5700,62,9,71,5,32,37,1,0,1,88,55,143
2021,5701,47,8,55,0,0,0,0,0,0,0,0,0
2021,5702,8,0,8,0,2,2,0,0,0,0,0,0
2021,5703,56,11,67,1,14,15,0,0,0,0,0,0
2021,5704,63,8,71,5,23,28,0,0,0,0,0,0
2021,5797,30,10,40,8,17,25,0,0,0,0,0,0
2021,5800,55,5,60,3,21,24,39,25,64,4,5,9
2021,5801,16,2,18,1,8,9,0,0,0,0,0,0
2021,5802,8,0,8,0,1,1,0,0,0,0,0,0
2022,100,493,60,553,106,219,325,441,68,509,92,145,237
2022,101,61,10,71,6,28,34,0,0,0,0,0,0
2022,102,21,1,22,2,9,11,0,0,0,0,0,0
2022,103,126,23,149,24,61,85,1,0,1,12,11,23
2022,104,30,3,33,4,12,16,0,0,0,0,0,0
2022,105,157,20,177,10,66,76,0,0,0,5,7,12
2022,106,144,15,159,18,74,92,0,0,0,12,7,19
2022,107,77,15,92,5,36,41,0,0,0,0,0,0
2022,108,33,14,47,7,18,25,0,0,0,0,0,0
2022,109,595,105,700,71,183,254,0,0,0,0,0,0
2022,110,16,1,17,1,8,9,0,0,0,0,0,0
2022,111,69,11,80,5,30,35,0,0,0,0,0,0
2022,112,58,7,65,0,24,24,0,0,0,6,6,12
2022,113,56,10,66,11,16,27,0,0,0,0,0,0
2022,114,52,7,59,7,22,29,0,0,0,0,0,0
2022,115,13,1,14,2,5,7,0,0,0,0,0,0
2022,116,41,1,42,0,0,0,0,0,0,0,0,0
2022,197,35,11,46,19,28,47,0,0,0,0,0,0
2022,200,12,0,12,0,3,3,0,0,0,0,0,0
2022,300,40,4,44,3,14,17,1,0,1,13,9,22
2022,302,8,0,8,0,0,0,0,0,0,0,0,0
2022,303,7,1,8,0,1,1,0,0,0,0,0,0
2022,305,4,1,5,0,0,0,0,0,0,0,0,0
2022,400,82,8,90,29,33,62,0,0,0,67,45,112
2022,402,82,8,90,3,39,42,0,0,0,5,3,8
2022,403,11,2,13,3,6,9,0,0,0,0,0,0
2022,404,15,4,19,9,8,17,0,0,0,0,0,0
2022,405,17,1,18,2,4,6,0,0,0,0,0,0
2022,497,11,3,14,1,7,8,0,0,0,0,0,0
2022,500,49,8,57,2,23,25,1,0,1,21,12,33
2022,501,6,1,7,0,1,1,0,0,0,0,0,0
2022,600,29,1,30,2,18,20,6,8,14,0,1,1
2022,601,6,2,8,0,1,1,0,0,0,0,0,0
2022,602,10,1,11,0,2,2,0,0,0,0,0,0
2022,700,260,41,301,48,144,192,271,45,316,42,55,97
2022,701,96,5,101,7,24,31,0,0,0,0,0,0
2022,702,57,9,66,6,25,31,0,0,0,0,0,0
2022,703,8,3,11,0,2,2,0,0,0,0,0,0
2022,704,108,20,128,1,39,40,0,0,0,3,0,3
2022,705,20,3,23,5,4,9,0,0,0,0,0,0
2022,706,22,4,26,1,5,6,0,0,0,0,0,0
2022,707,19,5,24,2,17,19,0,0,0,0,0,0
2022,708,68,12,80,4,18,22,0,0,0,0,0,0
2022,709,31,6,37,3,15,18,0,0,0,0,0,0
2022,710,83,22,105,11,31,42,1,0,1,4,1,5
2022,711,53,5,58,7,15,22,0,0,0,1,3,4
2022,712,65,10,75,7,28,35,0,0,0,0,0,0
2022,713,6,1,7,0,0,0,0,0,0,0,0,0
2022,714,26,2,28,1,11,12,0,0,0,0,0,0
2022,716,11,2,13,0,2,2,0,0,0,0,0,0
2022,718,190,22,212,70,66,136,0,0,0,0,0,0
2022,721,18,4,22,4,7,11,0,0,0,0,0,0
2022,724,54,9,63,5,14,19,0,0,0,0,0,0
2022,800,15,4,19,0,9,9,1,0,1,11,9,20
2022,801,10,2,12,0,0,0,0,0,0,0,0,0
2022,900,144,12,156,24,45,69,4,1,5,74,33,107
2022,901,16,2,18,0,7,7,0,0,0,0,0,0
2022,902,35,4,39,2,16,18,0,0,0,0,0,0
2022,1000,360,37,397,56,118,174,9,3,12,384,158,542
2022,1001,86,19,105,15,48,63,0,0,0,3,0,3
2022,1002,18,3,21,2,6,8,0,0,0,0,0,0
2022,1003,11,2,13,0,5,5,0,0,0,0,0,0
2022,1004,11,0,11,0,1,1,0,0,0,0,0,0
2022,1005,715,110,825,118,207,325,0,0,0,0,0,0
2022,1006,7,1,8,0,3,3,0,0,0,0,0,0
2022,1007,19,4,23,1,4,5,0,0,0,0,0,0
2022,1008,20,3,23,0,5,5,0,0,0,0,0,0
2022,1009,16,1,17,2,4,6,0,0,0,0,0,0
2022,1010,13,1,14,0,0,0,0,0,0,0,0,0
2022,1011,16,2,18,0,4,4,0,0,0,0,0,0
2022,1012,31,1,32,1,14,15,0,0,0,0,0,0
2022,1013,35,3,38,3,3,6,0,0,0,0,0,0
2022,1015,27,2,29,2,11,13,0,0,0,0,0,0
2022,1017,20,1,21,0,6,6,0,0,0,0,0,0
2022,1035,13,1,14,1,1,2,0,0,0,0,0,0
2022,1097,20,6,26,2,9,11,0,0,0,0,0,0
2022,10M1,212,29,241,5,12,17,0,0,0,0,0,0
2022,1100,24,2,26,4,14,18,0,0,0,8,11,19
2022,1101,10,1,11,1,2,3,0,0,0,0,0,0
2022,1200,86,8,94,15,42,57,70,26,96,5,9,14
2022,1201,18,4,22,1,12,13,0,0,0,0,0,0
2022,1203,33,4,37,7,18,25,0,0,0,0,0,0
2022,1204,5,0,5,0,0,0,0,0,0,0,0,0
2022,1205,17,2,19,0,7,7,0,0,0,0,0,0
2022,1207,4,1,5,1,0,1,0,0,0,0,0,0
2022,1208,6,2,8,2,7,9,0,0,0,0,0,0
2022,1300,94,6,100,11,41,52,67,20,87,11,21,32
2022,1301,23,2,25,3,10,13,0,0,0,0,0,0
2022,1302,20,3,23,6,11,17,0,0,0,0,0,0
2022,1303,4,0,4,0,0,0,0,0,0,0,0,0
2022,1304,41,2,43,5,25,30,0,0,0,0,0,0
2022,1306,14,4,18,1,3,4,0,0,0,0,0,0
2022,1307,4,0,4,0,0,0,0,0,0,0,0,0
2022,1400,30,0,30,2,17,19,7,0,7,10,8,18
2022,1401,9,2,11,3,6,9,0,0,0,0,0,0
2022,1500,274,27,301,53,173,226,307,86,393,44,82,126
2022,1501,18,2,20,4,5,9,0,0,0,0,0,0
2022,1502,412,57,469,40,169,209,0,0,0,0,0,0
2022,1503,41,4,45,5,15,20,0,0,0,0,0,0
2022,1505,14,1,15,1,6,7,0,0,0,0,0,0
2022,1506,25,3,28,5,12,17,0,0,0,0,0,0
2022,1507,23,6,29,3,6,9,0,0,0,0,0,0
2022,1508,12,1,13,1,7,8,0,0,0,0,0,0
2022,1509,17,2,19,1,7,8,0,0,0,0,0,0
2022,1511,13,1,14,3,10,13,0,0,0,0,0,0
2022,1514,4,0,4,0,0,0,0,0,0,0,0,0
2022,1515,5,1,6,0,1,1,0,0,0,0,0,0
2022,1521,29,3,32,0,4,4,0,0,0,0,0,0
2022,1597,12,3,15,0,9,9,0,0,0,0,0,0
2022,1600,85,7,92,4,41,45,0,0,0,87,70,157
2022,1601,16,3,19,3,11,14,0,0,0,0,0,0
2022,1602,54,7,61,5,22,27,0,0,0,0,0,0
2022,1603,29,4,33,1,7,8,0,0,0,0,0,0
2022,1607,15,1,16,0,2,2,0,0,0,0,0,0
2022,1700,48,3,51,1,19,20,27,5,32,8,5,13
2022,1701,8,1,9,1,3,4,0,0,0,0,0,0
2022,1702,20,1,21,4,10,14,0,0,0,0,0,0
2022,1800,25,2,27,4,14,18,16,5,21,4,7,11
2022,1801,16,1,17,0,2,2,0,0,0,0,0,0
2022,1900,5369,1234,6603,1467,2287,3754,2052,530,2582,850,784,1634
2022,1901,67,10,77,5,36,41,0,0,0,0,0,0
2022,1902,58,4,62,2,23,25,0,0,0,0,0,0
2022,1905,48,3,51,6,22,28,0,0,0,0,0,0
2022,1906,54,5,59,0,22,22,0,0,0,0,0,0
2022,1907,27,6,33,2,7,9,0,0,0,0,0,0
2022,1909,44,3,47,4,16,20,0,0,0,0,1,1
2022,190C,11,1,12,1,4,5,0,0,0,0,0,0
2022,190R,10,0,10,1,4,5,0,0,0,0,0,0
2022,1910,119,19,138,30,56,86,0,0,0,0,0,0
2022,1912,133,17,150,14,50,64,0,0,0,3,6,9
2022,1913,29,7,36,8,15,23,0,0,0,2,2,4
2022,1916,55,4,59,9,18,27,0,0,0,4,0,4
2022,1918,101,8,109,34,13,47,0,0,0,5,0,5
2022,1920,94,20,114,8,36,44,0,0,0,0,0,0
2022,1922,97,14,111,6,27,33,0,0,0,6,2,8
2022,1923,55,5,60,2,11,13,0,0,0,3,0,3
2022,1924,71,13,84,0,13,13,0,0,0,5,5,10
2022,1925,209,24,233,23,63,86,0,0,0,11,8,19
2022,1926,41,6,47,5,22,27,0,0,0,1,3,4
2022,1928,78,10,88,12,24,36,1,0,1,5,6,11
2022,1929,30,2,32,16,1,17,0,0,0,3,8,11
2022,1931,47,4,51,15,13,28,0,0,0,3,2,5
2022,1933,149,21,170,5,39,44,0,0,0,2,6,8
2022,1934,27,1,28,0,7,7,0,0,0,0,0,0
2022,1938,32,7,39,2,15,17,0,0,0,0,0,0
2022,1941,610,82,692,106,145,251,7,0,7,14,22,36
2022,1942,7471,1714,9185,865,1432,2297,35,6,41,255,116,371
2022,1944,53,8,61,8,20,28,0,0,0,2,5,7
2022,1946,40,8,48,7,21,28,0,0,0,2,2,4
2022,1947,58,5,63,0,20,20,0,0,0,0,0,0
2022,1948,57,14,71,9,23,32,0,0,0,1,4,5
2022,1951,20,0,20,1,0,1,0,0,0,0,8,8
2022,1953,184,35,219,27,61,88,0,0,0,11,8,19
2022,1955,128,19,147,20,55,75,0,0,0,9,8,17
2022,1956,78,12,90,10,34,44,0,0,0,4,7,11
2022,1961,25,4,29,1,5,6,0,0,0,5,3,8
2022,1962,42,5,47,2,13,15,0,0,0,0,0,0
2022,1963,21,7,28,0,7,7,0,0,0,0,0,0
2022,1965,177,23,200,88,87,175,0,0,0,11,8,19
2022,1966,16,1,17,0,5,5,0,0,0,0,0,0
2022,1967,24,4,28,0,6,6,0,0,0,0,6,6
2022,1969,64,9,73,8,29,37,0,0,0,4,1,5
2022,1970,28,2,30,12,3,15,0,0,0,0,0,0
2022,1972,171,9,180,20,62,82,0,0,0,8,6,14
2022,1973,36,6,42,3,10,13,0,0,0,0,0,0
2022,1975,88,9,97,6,33,39,0,0,0,5,2,7
2022,1976,97,21,118,9,39,48,0,0,0,0,0,0
2022,1978,16,3,19,11,16,27,0,0,0,0,0,0
2022,1981,16,0,16,0,0,0,0,0,0,0,0,0
2022,1982,17,4,21,5,9,14,0,0,0,0,0,0
2022,1983,14,4,18,12,10,22,0,0,0,0,0,0
2022,1984,15,1,16,12,8,20,0,0,0,0,0,0
2022,1997,45,11,56,32,24,56,0,0,0,0,0,0
2022,19A9,102,19,121,3,12,15,0,0,0,0,0,0
2022,2000,96,14,110,2,31,33,0,0,0,67,35,102
2022,2001,18,2,20,2,9,11,0,0,0,0,0,0
2022,2002,51,6,57,11,20,31,0,0,0,0,0,0
2022,2100,87,24,111,17,50,67,56,17,73,11,13,24
2022,2101,5,1,6,0,0,0,0,0,0,0,0,0
2022,2103,9,1,10,3,3,6,0,0,0,0,0,0
2022,2105,17,2,19,1,4,5,0,0,0,0,0,0
2022,2106,46,11,57,1,18,19,0,0,0,0,0,0
2022,2107,5,0,5,0,0,0,0,0,0,0,0,0
2022,2109,49,15,64,2,17,19,0,0,0,0,0,0
2022,2110,15,3,18,0,6,6,0,0,0,0,0,0
2022,2111,12,2,14,1,3,4,0,0,0,0,0,0
2022,2113,5,0,5,1,1,2,0,0,0,0,0,0
2022,2117,36,6,42,0,6,6,0,0,0,0,0,0
2022,2200,39,6,45,2,14,16,11,9,20,0,1,1
2022,2300,58,1,59,11,31,42,35,10,45,0,6,6
2022,2301,14,1,15,2,5,7,0,0,0,0,0,0
2022,2303,26,1,27,4,13,17,0,0,0,0,0,0
2022,2304,8,1,9,2,2,4,0,0,0,0,0,0
2022,2400,115,10,125,5,36,41,67,33,100,7,13,20
2022,2401,22,1,23,3,7,10,0,0,0,0,0,0
2022,2402,8,2,10,1,4,5,0,0,0,0,0,0
2022,2403,7,0,7,1,1,2,0,0,0,0,0,0
2022,2404,15,2,17,1,5,6,0,0,0,0,0,0
2022,2405,38,4,42,4,17,21,0,0,0,2,3,5
2022,2406,82,13,95,8,33,41,0,0,0,0,0,0
2022,2412,14,3,17,7,9,16,0,0,0,0,0,0
2022,2500,11,0,11,2,5,7,0,0,0,9,3,12
2022,2501,5,0,5,0,1,1,0,0,0,0,0,0
2022,2600,21,3,24,0,2,2,9,5,14,2,1,3
2022,2601,13,1,14,2,2,4,0,0,0,0,0,0
2022,2700,104,12,116,28,49,77,139,28,167,33,39,72
2022,2701,11,1,12,0,8,8,0,0,0,0,0,0
2022,2702,8,1,9,0,0,0,0,0,0,0,0,0
2022,2703,12,0,12,0,3,3,0,0,0,0,0,0
2022,2704,16,1,17,1,6,7,0,0,0,0,0,0
2022,2705,14,3,17,1,2,3,0,0,0,0,0,0
2022,2706,42,5,47,1,4,5,0,0,0,4,5,9
2022,2707,15,6,21,4,8,12,0,0,0,0,0,0
2022,2708,129,16,145,8,33,41,0,0,0,0,0,0
2022,2709,10,0,10,0,1,1,0,0,0,0,0,0
2022,2710,25,1,26,4,10,14,0,0,0,0,0,0
2022,2711,17,1,18,2,4,6,0,0,0,0,0,0
2022,2712,24,5,29,0,8,8,0,0,0,0,0,0
2022,2719,11,5,16,2,8,10,0,0,0,0,0,0
2022,2800,101,9,110,14,25,39,0,1,1,0,0,0
2022,2801,9,3,12,6,0,6,0,0,0,0,0,0
2022,2802,64,4,68,6,40,46,0,0,0,0,0,0
2022,2803,9,2,11,0,6,6,0,0,0,0,0,0
2022,2808,96,7,103,0,0,0,0,0,0,0,0,0
2022,2900,55,5,60,5,25,30,0,0,0,39,26,65
2022,2901,26,2,28,2,5,7,0,0,0,0,0,0
2022,2902,9,1,10,0,3,3,0,0,0,0,0,0
2022,2908,21,1,22,1,9,10,0,0,0,0,0,0
2022,3000,973,156,1129,526,656,1182,663,104,767,289,213,502
2022,3001,342,34,376,42,104,146,15,5,20,0,9,9
2022,3002,48,6,54,7,25,32,0,0,0,0,0,0
2022,3003,68,13,81,6,32,38,0,0,0,0,0,0
2022,3004,117,16,133,17,50,67,0,0,0,0,0,0
2022,3005,48,6,54,0,8,8,0,0,0,3,1,4
2022,3006,20,2,22,0,6,6,0,0,0,0,0,0
2022,3007,47,11,58,1,20,21,0,0,0,0,0,0
2022,3008,100,16,116,9,34,43,0,0,0,1,6,7
2022,3009,162,9,171,8,57,65,0,0,0,0,0,0
2022,3010,183,21,204,14,72,86,1,0,1,12,5,17
2022,3011,42,9,51,10,23,33,0,0,0,0,3,3
2022,3012,61,9,70,7,22,29,0,0,0,0,0,0
2022,3013,19,2,21,1,4,5,0,0,0,0,0,0
2022,3014,120,15,135,28,49,77,0,0,0,5,3,8
2022,3015,136,11,147,33,46,79,0,0,0,1,1,2
2022,3016,39,5,44,6,9,15,0,0,0,2,1,3
2022,3019,321,34,355,38,97,135,0,0,0,46,38,84
2022,3020,35,4,39,8,9,17,0,0,0,4,0,4
2022,3022,83,14,97,12,37,49,0,0,0,0,0,0
2022,3024,79,12,91,1,34,35,0,0,0,1,0,1
2022,3026,191,37,228,35,72,107,0,0,0,0,0,0
2022,3027,18,5,23,0,9,9,0,0,0,0,0,0
2022,3096,11,0,11,2,4,6,0,0,0,0,0,0
2022,3097,34,11,45,40,24,64,0,0,0,0,0,0
2022,3100,161,16,177,19,81,100,69,4,73,85,85,170
2022,3101,20,2,22,0,9,9,0,0,0,0,0,0
2022,3103,26,2,28,1,11,12,0,0,0,0,0,0
2022,3104,50,5,55,2,21,23,0,0,0,0,0,0
2022,3105,119,11,130,20,44,64,0,0,0,0,0,0
2022,3200,28,1,29,1,10,11,1,0,1,7,5,12
2022,3300,1414,166,1580,345,716,1061,74,5,79,860,373,1233
2022,3301,32,4,36,0,13,13,0,0,0,0,0,0
2022,3302,45,9,54,3,18,21,0,0,0,0,0,0
2022,3303,18,3,21,4,5,9,0,0,0,0,0,0
2022,3306,23,4,27,7,14,21,0,0,0,0,0,0
2022,3308,60,5,65,9,23,32,0,0,0,0,0,0
2022,3309,59,3,62,13,29,42,0,0,0,0,0,0
2022,3311,89,14,103,9,34,43,0,0,0,0,0,0
2022,3313,302,43,345,29,122,151,0,0,0,0,0,0
2022,3315,132,22,154,11,58,69,0,0,0,3,2,5
2022,3325,45,5,50,8,15,23,0,0,0,0,0,0
2022,3342,95,8,103,2,51,53,0,0,0,0,0,0
2022,3344,15,2,17,2,5,7,0,0,0,0,0,0
2022,3349,66,12,78,3,22,25,0,0,0,0,0,0
2022,3397,22,3,25,5,7,12,0,0,0,0,0,0
2022,3400,707,126,833,176,260,436,417,83,500,70,176,246
2022,3401,66,7,73,4,29,33,0,0,0,0,0,0
2022,3402,29,5,34,4,12,16,0,0,0,0,0,0
2022,3404,559,121,680,82,211,293,0,0,0,0,0,0
2022,3408,13,6,19,6,10,16,0,0,0,0,0,0
2022,340H,111,24,135,19,76,95,0,0,0,0,0,0
2022,3414,11,3,14,1,6,7,0,0,0,0,0,0
2022,3420,1,0,1,0,1,1,0,0,0,0,0,0
2022,3422,432,92,524,17,26,43,0,0,0,0,0,0
2022,3477,61,12,73,9,9,18,0,0,0,0,0,0
2022,3496,66,12,78,19,35,54,0,0,0,0,0,0
2022,3499,6231,420,6651,1346,1777,3123,0,0,0,0,0,0
2022,3500,25,0,25,0,6,6,0,0,0,18,9,27
2022,3501,27,5,32,4,14,18,0,0,0,0,0,0
2022,3600,1098,202,1300,194,624,818,498,77,575,172,460,632
2022,3601,37,3,40,6,16,22,0,0,0,0,0,0
2022,3602,101,15,116,3,52,55,0,0,0,0,0,0
2022,3603,47,6,53,1,22,23,0,0,0,0,0,0
2022,3604,171,18,189,20,86,106,0,0,0,0,0,0
2022,3605,38,7,45,6,17,23,0,0,0,0,0,0
2022,3607,254,24,278,16,66,82,0,0,0,0,0,0
2022,3608,70,7,77,13,27,40,0,0,0,0,0,0
2022,3609,90,20,110,4,39,43,0,0,0,0,0,0
2022,3610,218,30,248,27,86,113,0,0,0,0,0,0
2022,3611,59,6,65,11,43,54,0,0,0,3,0,3
2022,3614,9,5,14,2,9,11,0,0,0,0,0,0
2022,3623,22,2,24,45,25,70,0,0,0,0,0,0
2022,3626,11,1,12,0,2,2,0,0,0,0,0,0
2022,3639,7,3,10,2,5,7,0,0,0,0,0,0
2022,3650,11,2,13,33,27,60,0,0,0,0,0,0
2022,3657,75,25,100,3,10,13,0,0,0,0,0,0
2022,3700,1088,190,1278,336,532,868,797,268,1065,268,498,766
2022,3701,116,13,129,13,46,59,0,0,0,0,0,0
2022,3702,202,50,252,15,67,82,0,0,0,11,3,14
2022,3703,37,9,46,6,19,25,0,0,0,0,0,0
2022,3705,110,14,124,12,42,54,0,0,0,0,0,0
2022,3706,132,12,144,8,46,54,0,0,0,0,0,0
2022,3708,52,14,66,6,22,28,0,0,0,0,0,0
2022,3709,73,11,84,3,28,31,0,0,0,0,0,0
2022,3710,181,22,203,7,72,79,0,0,0,0,0,0
2022,3711,1481,288,1769,144,320,464,0,0,0,0,0,0
2022,3714,28,6,34,2,16,18,0,0,0,0,0,0
2022,3715,102,17,119,12,17,29,0,0,0,0,0,0
2022,3732,17,0,17,1,7,8,0,0,0,0,0,0
2022,3797,34,2,36,18,20,38,0,0,0,0,0,0
2022,3800,278,30,308,91,103,194,316,53,369,0,0,0
2022,3801,1663,279,1942,410,334,744,0,0,0,0,0,0
2022,3803,13,2,15,14,10,24,0,0,0,0,0,0
2022,3897,54,4,58,4,13,17,0,0,0,0,0,0
2022,3900,247,29,276,37,127,164,27,0,27,186,96,282
2022,3901,12,0,12,0,2,2,0,0,0,0,0,0
2022,3902,64,9,73,4,28,32,0,0,0,0,0,0
2022,3903,74,1,75,5,22,27,0,0,0,2,0,2
2022,3904,24,1,25,3,11,14,0,0,0,0,0,0
2022,3905,339,40,379,52,135,187,0,0,0,0,0,0
2022,3906,98,6,104,13,47,60,0,0,0,0,0,0
2022,3915,19,5,24,1,10,11,0,0,0,0,0,0
2022,4000,157,8,165,13,62,75,116,26,142,13,23,36
2022,4001,22,3,25,0,3,3,0,0,0,0,0,0
2022,4002,17,2,19,2,2,4,0,0,0,0,0,0
2022,4003,13,3,16,0,2,2,0,0,0,0,0,0
2022,4004,38,3,41,4,17,21,0,0,0,0,0,0
2022,4005,20,4,24,0,14,14,0,0,0,0,0,0
2022,4006,48,8,56,22,5,27,0,0,0,0,0,0
2022,4007,16,2,18,2,4,6,0,0,0,0,0,0
2022,4008,28,3,31,4,6,10,0,0,0,0,0,0
2022,4016,127,23,150,0,14,14,0,0,0,0,0,0
2022,4019,3,0,3,2,1,3,0,0,0,0,0,0
2022,4100,166,18,184,48,85,133,109,7,116,158,85,243
2022,4101,18,2,20,1,8,9,0,0,0,0,0,0
2022,4102,27,4,31,4,7,11,0,0,0,0,0,0
2022,4103,12,1,13,1,3,4,0,0,0,0,0,0
2022,4104,31,8,39,7,13,20,0,0,0,0,0,0
2022,4105,16,3,19,0,6,6,0,0,0,0,0,0
2022,4106,76,9,85,12,15,27,0,0,0,0,0,0
2022,4108,24,4,28,1,8,9,0,0,0,0,0,0
2022,4109,39,3,42,3,12,15,0,0,0,0,0,0
2022,4111,27,3,30,1,4,5,0,0,0,0,0,0
2022,4113,78,9,87,4,25,29,0,0,0,0,0,0
2022,4114,41,4,45,1,14,15,0,0,0,0,0,0
2022,4116,81,23,104,8,34,42,0,0,0,0,0,0
2022,4117,66,10,76,8,23,31,0,0,0,0,0,0
2022,4119,8,1,9,0,1,1,0,0,0,0,0,0
2022,4120,28,6,34,4,10,14,0,0,0,0,0,0
2022,4127,25,3,28,8,8,16,0,0,0,0,0,0
2022,4200,218,19,237,32,87,119,182,34,216,39,48,87
2022,4201,11,1,12,0,2,2,0,0,0,0,0,0
2022,4202,42,4,46,1,15,16,0,0,0,4,1,5
2022,4203,87,27,114,12,42,54,0,0,0,0,0,0
2022,4204,98,8,106,15,43,58,0,0,0,0,0,0
2022,4211,3,1,4,5,3,8,0,0,0,0,0,0
2022,4297,24,6,30,3,11,14,0,0,0,0,0,0
2022,4300,335,43,378,51,88,139,592,157,749,76,114,190
2022,4302,39,5,44,2,22,24,0,0,0,0,0,0
2022,4304,51,8,59,4,21,25,0,0,0,4,0,4
2022,4305,23,7,30,2,12,14,0,0,0,0,0,0
2022,4307,30,6,36,1,11,12,0,0,0,0,0,0
2022,4308,72,16,88,4,28,32,0,0,0,0,0,0
2022,4310,33,6,39,4,18,22,0,0,0,0,0,0
2022,4311,74,9,83,11,22,33,0,0,0,0,0,0
2022,4312,69,9,78,16,29,45,0,0,0,0,0,0
2022,4313,971,138,1109,127,331,458,0,0,0,0,0,0
2022,4314,124,13,137,7,52,59,0,0,0,4,1,5
2022,4316,191,17,208,27,52,79,0,0,0,0,0,0
2022,4317,15,4,19,25,17,42,0,0,0,0,0,0
2022,4320,6,0,6,5,7,12,0,0,0,0,0,0
2022,4321,9,0,9,2,3,5,0,0,0,0,0,0
2022,4327,10,0,10,5,2,7,0,0,0,0,0,0
2022,4400,112,25,137,11,45,56,9,0,9,79,48,127
2022,4401,19,2,21,4,4,8,0,0,0,0,0,0
2022,4402,69,10,79,14,18,32,0,0,0,0,0,0
2022,4403,64,7,71,5,15,20,0,0,0,0,0,0
2022,4404,14,2,16,1,8,9,0,0,0,0,0,0
2022,4497,13,5,18,5,9,14,0,0,0,0,0,0
2022,4500,62,5,67,8,33,41,44,13,57,3,11,14
2022,4501,22,1,23,1,8,9,0,0,0,0,0,0
2022,4502,104,6,110,13,30,43,0,0,0,0,0,0
2022,4591,22,1,23,5,1,6,0,0,0,0,0,0
2022,4600,6,2,8,0,0,0,0,0,0,2,2,4
2022,4700,36,1,37,2,12,14,15,5,20,0,1,1
2022,4703,4,0,4,0,0,0,0,0,0,0,0,0
2022,4706,9,0,9,1,7,8,0,0,0,0,0,0
2022,4707,3,0,3,0,0,0,0,0,0,0,0,0
2022,4708,8,0,8,3,3,6,0,0,0,0,0,0
2022,4709,17,0,17,2,10,12,0,0,0,0,0,0
2022,4710,4,0,4,0,0,0,0,0,0,0,0,0
2022,4800,113,14,127,30,79,109,28,8,36,157,77,234
2022,4801,24,5,29,0,17,17,0,0,0,0,0,0
2022,4802,25,2,27,1,4,5,0,0,0,0,0,0
2022,4803,108,18,126,6,66,72,0,0,0,0,0,0
2022,4804,10,2,12,0,2,2,0,0,0,0,0,0
2022,4805,19,7,26,0,11,11,0,0,0,0,0,0
2022,4806,88,17,105,5,58,63,0,0,0,0,0,0
2022,4807,77,9,86,7,30,37,0,0,0,0,0,0
2022,4900,207,10,217,22,70,92,1,0,1,158,88,246
2022,4901,12,1,13,1,7,8,0,0,0,0,0,0
2022,4902,10,1,11,1,4,5,0,0,0,0,0,0
2022,4903,12,3,15,3,8,11,0,0,0,0,0,0
2022,4904,60,12,72,2,24,26,0,0,0,0,0,0
2022,4905,140,17,157,23,56,79,0,0,0,0,0,0
2022,4906,10,1,11,3,4,7,0,0,0,0,0,0
2022,4908,61,6,67,8,25,33,0,0,0,0,0,0
2022,4909,9,1,10,0,2,2,0,0,0,0,0,0
2022,4914,8,2,10,4,9,13,0,0,0,0,0,0
2022,5000,237,17,254,45,119,164,242,47,289,12,47,59
2022,5001,49,4,53,7,14,21,0,0,0,0,0,0
2022,5002,159,13,172,15,69,84,0,0,0,0,0,0
2022,5003,11,1,12,0,3,3,0,0,0,0,0,0
2022,5004,19,4,23,1,12,13,0,0,0,0,0,0
2022,5007,67,8,75,3,34,37,0,0,0,0,0,0
2022,5010,10,4,14,2,5,7,0,0,0,0,0,0
2022,5100,35,7,42,0,20,20,36,18,54,0,5,5
2022,5102,52,8,60,4,22,26,0,0,0,0,0,0
2022,5200,26,1,27,6,21,27,2,0,2,23,13,36
2022,5201,11,0,11,1,5,6,0,0,0,0,0,0
2022,5202,19,4,23,4,13,17,0,0,0,0,0,0
2022,5300,17,2,19,1,9,10,12,3,15,0,0,0
2022,5400,223,34,257,26,102,128,195,50,245,31,51,82
2022,5401,31,4,35,3,7,10,0,0,0,0,0,0
2022,5402,11,2,13,1,2,3,0,0,0,0,0,0
2022,5403,14,2,16,0,2,2,0,0,0,0,0,0
2022,5404,16,3,19,1,2,3,0,0,0,0,0,0
2022,5405,47,18,65,6,21,27,0,0,0,0,0,0
2022,5406,59,10,69,9,23,32,0,0,0,0,0,0
2022,5407,130,17,147,14,57,71,0,0,0,0,0,0
2022,5408,10,2,12,0,1,1,0,0,0,0,0,0
2022,5411,6,0,6,0,1,1,0,0,0,0,0,0
2022,5500,53,4,57,2,16,18,0,0,0,25,19,44
2022,5501,9,1,10,0,6,6,0,0,0,0,0,0
2022,5600,455,64,519,81,184,265,186,39,225,91,103,194
2022,5604,205,27,232,35,87,122,0,0,0,0,0,0
2022,5605,19,3,22,4,8,12,0,0,0,0,0,0
2022,5606,28,3,31,2,8,10,0,0,0,0,0,0
2022,5608,114,17,131,11,38,49,0,0,0,0,0,0
2022,5609,101,10,111,15,42,57,0,0,0,0,0,0
2022,5622,13,3,16,1,4,5,0,0,0,0,0,0
2022,5680,12,1,13,0,1,1,0,0,0,0,0,0
2022,5700,75,11,86,5,27,32,1,0,1,81,51,132
2022,5701,45,7,52,6,22,28,0,0,0,0,0,0
2022,5702,11,0,11,0,2,2,0,0,0,0,0,0
2022,5703,57,12,69,0,15,15,0,0,0,0,0,0
2022,5704,62,6,68,6,22,28,0,0,0,0,0,0
2022,5797,33,9,42,10,16,26,0,0,0,0,0,0
2022,5800,62,5,67,5,25,30,40,23,63,3,5,8
2022,5801,16,2,18,0,10,10,0,0,0,0,0,0
2022,5802,8,0,8,0,0,0,0,0,0,0,0,0
2023,100,477,62,539,110,172,282,422,62,484,107,142,249
2023,101,61,8,69,6,28,34,0,0,0,0,0,0
2023,102,21,2,23,1,10,11,0,0,0,0,0,0
2023,103,124,23,147,21,55,76,1,0,1,10,10,20
2023,104,33,5,38,4,15,19,0,0,0,0,0,0
2023,105,154,18,172,12,71,83,0,0,0,5,5,10
2023,106,146,13,159,18,77,95,0,0,0,15,8,23
2023,107,70,15,85,9,35,44,0,0,0,0,0,0
2023,108,32,11,43,7,14,21,0,0,0,0,0,0
2023,109,606,104,710,62,201,263,0,0,0,0,0,0
2023,110,18,3,21,1,8,9,0,0,0,0,0,0
2023,111,64,9,73,4,27,31,0,0,0,0,0,0
2023,112,55,7,62,3,27,30,0,0,0,4,3,7
2023,113,63,11,74,7,18,25,0,0,0,0,0,0
2023,114,53,6,59,9,25,34,0,0,0,0,0,0
2023,115,11,1,12,3,3,6,0,0,0,0,0,0
2023,116,37,1,38,0,0,0,0,0,0,0,0,0
2023,197,36,9,45,31,21,52,0,0,0,0,0,0
2023,200,10,1,11,0,3,3,0,0,0,0,0,0
2023,300,40,4,44,1,18,19,18,8,26,0,0,0
2023,302,7,0,7,0,0,0,0,0,0,0,0,0
2023,303,6,3,9,0,1,1,0,0,0,0,0,0
2023,305,5,0,5,0,0,0,0,0,0,0,0,0
2023,400,76,9,85,29,38,67,0,0,0,62,42,104
2023,402,84,8,92,5,39,44,0,0,0,4,3,7
2023,403,11,3,14,1,7,8,0,0,0,0,0,0
2023,404,17,3,20,8,14,22,0,0,0,0,0,0
2023,405,17,1,18,2,7,9,0,0,0,0,0,0
2023,497,14,3,17,1,7,8,0,0,0,0,0,0
2023,500,52,7,59,4,22,26,1,0,1,16,14,30
2023,501,7,1,8,0,1,1,0,0,0,0,0,0
2023,600,26,1,27,2,17,19,3,9,12,0,1,1
2023,601,6,2,8,0,1,1,0,0,0,0,0,0
2023,602,9,0,9,0,2,2,0,0,0,0,0,0
2023,700,266,46,312,58,141,199,268,47,315,41,50,91
2023,701,84,4,88,10,27,37,0,0,0,0,0,0
2023,702,52,9,61,4,30,34,0,0,0,0,0,0
2023,703,8,2,10,0,2,2,0,0,0,0,0,0
2023,704,119,19,138,3,42,45,0,0,0,4,0,4
2023,705,33,3,36,2,9,11,0,0,0,0,0,0
2023,706,21,4,25,0,4,4,0,0,0,0,0,0
2023,707,20,6,26,3,18,21,0,0,0,0,0,0
2023,708,64,14,78,4,20,24,0,0,0,0,0,0
2023,709,34,5,39,4,11,15,0,0,0,0,0,0
2023,710,97,23,120,10,34,44,0,0,0,3,1,4
2023,711,56,5,61,6,12,18,0,0,0,1,3,4
2023,712,66,8,74,8,28,36,0,0,0,0,0,0
2023,713,7,1,8,1,0,1,0,0,0,0,0,0
2023,714,24,4,28,3,13,16,0,0,0,0,0,0
2023,716,11,2,13,0,1,1,0,0,0,0,0,0
2023,718,182,22,204,77,72,149,0,0,0,0,0,0
2023,721,17,3,20,3,10,13,0,0,0,0,0,0
2023,724,56,10,66,6,10,16,0,0,0,0,0,0
2023,800,11,2,13,0,11,11,1,0,1,13,11,24
2023,801,11,3,14,0,1,1,0,0,0,0,0,0
2023,900,153,13,166,24,50,74,4,1,5,66,29,95
2023,901,16,3,19,0,5,5,0,0,0,0,0,0
2023,902,33,4,37,6,17,23,0,0,0,0,0,0
2023,1000,369,38,407,70,128,198,8,3,11,370,146,516
2023,1001,95,17,112,16,48,64,0,0,0,2,0,2
2023,1002,17,3,20,1,5,6,0,0,0,0,0,0
2023,1003,12,1,13,0,5,5,0,0,0,0,0,0
2023,1004,9,2,11,0,2,2,0,0,0,0,0,0
2023,1005,732,117,849,145,224,369,0,0,0,0,0,0
2023,1006,8,0,8,0,3,3,0,0,0,0,0,0
2023,1007,16,5,21,2,4,6,0,0,0,0,0,0
2023,1008,20,4,24,0,0,0,0,0,0,0,0,0
2023,1009,20,1,21,2,4,6,0,0,0,0,0,0
2023,1010,11,1,12,0,2,2,0,0,0,0,0,0
2023,1011,15,1,16,1,4,5,0,0,0,0,0,0
2023,1012,30,2,32,1,14,15,0,0,0,0,0,0
2023,1013,31,6,37,2,4,6,0,0,0,0,0,0
2023,1015,31,3,34,2,10,12,0,0,0,0,0,0
2023,1017,20,3,23,0,6,6,0,0,0,0,0,0
2023,1035,14,1,15,0,1,1,0,0,0,0,0,0
2023,1097,19,6,25,2,9,11,0,0,0,0,0,0
2023,1100,23,1,24,5,17,22,0,1,1,9,5,14
2023,1101,10,1,11,1,3,4,0,0,0,0,0,0
2023,1200,83,7,90,10,42,52,67,22,89,6,7,13
2023,1201,20,3,23,1,12,13,0,0,0,0,0,0
2023,1203,33,3,36,3,22,25,0,0,0,0,0,0
2023,1204,5,0,5,0,0,0,0,0,0,0,0,0
2023,1205,17,1,18,0,7,7,0,0,0,0,0,0
2023,1207,3,2,5,0,2,2,0,0,0,0,0,0
2023,1208,6,1,7,1,5,6,0,0,0,0,0,0
2023,1300,95,5,100,14,39,53,69,19,88,9,21,30
2023,1301,28,2,30,4,11,15,28,2,30,4,11,15
2023,1302,19,3,22,4,14,18,0,0,0,0,0,0
2023,1303,4,0,4,0,0,0,0,0,0,0,0,0
2023,1304,40,4,44,5,18,23,0,0,0,0,0,0
2023,1306,14,6,20,2,3,5,0,0,0,0,0,0
2023,1307,3,0,3,0,0,0,0,0,0,0,0,0
2023,1400,23,2,25,3,17,20,8,0,8,11,9,20
2023,1401,8,2,10,1,6,7,0,0,0,0,0,0
2023,1500,294,31,325,87,206,293,300,105,405,39,79,118
2023,1501,18,2,20,3,6,9,0,0,0,0,0,0
2023,1502,413,54,467,28,167,195,0,0,0,0,0,0
2023,1503,45,5,50,6,15,21,0,0,0,0,0,0
2023,1505,14,1,15,0,5,5,0,0,0,0,0,0
2023,1506,28,4,32,4,15,19,0,0,0,0,0,0
2023,1507,20,6,26,3,9,12,0,0,0,0,0,0
2023,1508,12,1,13,0,5,5,0,0,0,0,0,0
2023,1509,17,2,19,2,8,10,0,0,0,0,0,0
2023,1511,11,0,11,3,6,9,0,0,0,0,0,0
2023,1514,0,0,0,4,0,4,0,0,0,0,0,0
2023,1515,6,0,6,0,1,1,0,0,0,0,0,0
2023,1521,29,3,32,0,6,6,0,0,0,0,0,0
2023,1597,12,3,15,1,8,9,0,0,0,0,0,0
2023,1600,84,7,91,4,38,42,0,0,0,89,64,153
2023,1601,16,3,19,3,11,14,0,0,0,0,0,0
2023,1602,56,7,63,5,19,24,0,0,0,0,0,0
2023,1603,30,4,34,0,10,10,0,0,0,0,0,0
2023,1607,14,0,14,0,3,3,0,0,0,0,0,0
2023,1700,47,2,49,2,17,19,30,8,38,5,6,11
2023,1701,10,2,12,1,2,3,0,0,0,0,0,0
2023,1702,20,1,21,4,9,13,0,0,0,0,0,0
2023,1800,28,3,31,2,14,16,18,7,25,5,5,10
2023,1801,15,1,16,1,2,3,0,0,0,0,0,0
2023,1900,5171,1201,6372,1440,2246,3686,2149,550,2699,744,825,1569
2023,1901,68,11,79,6,39,45,0,0,0,0,0,0
2023,1902,57,6,63,2,22,24,0,0,0,0,0,0
2023,1905,50,5,55,3,24,27,0,0,0,0,0,0
2023,1906,55,4,59,0,20,20,0,0,0,0,0,0
2023,1907,26,6,32,4,6,10,0,0,0,0,0,0
2023,1909,40,3,43,9,19,28,0,0,0,0,1,1
2023,1910,114,21,135,34,63,97,0,0,0,0,0,0
2023,1912,134,15,149,8,50,58,0,0,0,3,5,8
2023,1913,34,8,42,1,13,14,0,0,0,2,3,5
2023,1916,52,5,57,4,19,23,0,0,0,4,0,4
2023,1918,94,9,103,23,16,39,0,0,0,4,1,5
2023,1920,94,21,115,7,37,44,0,0,0,0,0,0
2023,1922,99,14,113,5,28,33,0,0,0,6,2,8
2023,1923,53,4,57,2,11,13,0,0,0,4,1,5
2023,1924,72,14,86,1,12,13,0,0,0,6,5,11
2023,1925,199,29,228,23,57,80,0,0,0,10,9,19
2023,1926,39,7,46,7,21,28,0,0,0,2,3,5
2023,1928,74,12,86,14,31,45,1,0,1,6,6,12
2023,1929,29,2,31,16,4,20,0,0,0,2,9,11
2023,1931,43,6,49,18,15,33,0,0,0,2,2,4
2023,1933,154,24,178,9,40,49,0,0,0,2,8,10
2023,1934,25,1,26,2,8,10,0,0,0,0,0,0
2023,1938,33,6,39,1,16,17,0,0,0,0,0,0
2023,1941,605,85,690,80,160,240,7,0,7,20,15,35
2023,1942,7189,1670,8859,851,1396,2247,50,7,57,260,112,372
2023,1944,54,8,62,22,12,34,0,0,0,2,3,5
2023,1946,39,9,48,4,19,23,0,0,0,3,1,4
2023,1947,59,6,65,1,21,22,0,0,0,0,0,0
2023,1948,56,13,69,7,26,33,0,0,0,1,4,5
2023,1951,20,0,20,0,0,0,0,0,0,0,8,8
2023,1953,188,25,213,28,62,90,0,0,0,10,7,17
2023,1955,118,19,137,23,77,100,0,0,0,10,9,19
2023,1956,85,11,96,7,38,45,0,0,0,5,3,8
2023,1961,29,2,31,0,7,7,0,0,0,4,3,7
2023,1962,43,5,48,2,15,17,0,0,0,0,0,0
2023,1963,23,7,30,3,8,11,0,0,0,0,0,0
2023,1965,184,28,212,98,100,198,0,0,0,9,4,13
2023,1966,17,1,18,0,5,5,0,0,0,0,0,0
2023,1967,20,4,24,4,5,9,0,0,0,0,5,5
2023,1969,69,8,77,8,28,36,0,0,0,3,2,5
2023,1970,28,0,28,3,11,14,0,0,0,0,0,0
2023,1972,171,8,179,19,60,79,0,0,0,7,8,15
2023,1973,34,4,38,7,11,18,0,0,0,0,0,0
2023,1975,87,8,95,7,29,36,0,0,0,4,3,7
2023,1976,99,23,122,11,38,49,0,0,0,0,0,0
2023,1978,14,2,16,3,10,13,0,0,0,0,0,0
2023,1981,15,0,15,0,0,0,0,0,0,0,0,0
2023,1982,18,6,24,3,11,14,0,0,0,0,0,0
2023,1983,14,4,18,13,7,20,0,0,0,0,0,0
2023,1984,18,1,19,11,14,25,0,0,0,0,0,0
2023,1997,45,10,55,29,27,56,0,0,0,0,0,0
2023,2000,88,14,102,3,35,38,63,25,88,3,15,18
2023,2001,16,2,18,2,8,10,0,0,0,0,0,0
2023,2002,48,7,55,13,25,38,0,0,0,0,0,0
2023,2100,86,24,110,17,46,63,54,18,72,12,12,24
2023,2101,4,2,6,0,0,0,0,0,0,0,0,0
2023,2103,8,1,9,3,3,6,0,0,0,0,0,0
2023,2105,19,1,20,1,5,6,0,0,0,0,0,0
2023,2106,46,9,55,1,16,17,0,0,0,0,0,0
2023,2107,6,1,7,0,0,0,0,0,0,0,0,0
2023,2109,43,11,54,3,20,23,0,0,0,0,0,0
2023,2110,14,1,15,0,2,2,0,0,0,0,0,0
2023,2111,11,3,14,1,3,4,0,0,0,0,0,0
2023,2113,3,0,3,1,1,2,0,0,0,0,0,0
2023,2117,32,6,38,1,7,8,0,0,0,0,0,0
2023,2200,39,6,45,2,16,18,13,9,22,0,1,1
2023,2300,55,2,57,13,26,39,42,9,51,2,8,10
2023,2301,12,1,13,1,3,4,0,0,0,0,0,0
2023,2303,24,1,25,6,12,18,0,0,0,0,0,0
2023,2304,5,2,7,2,1,3,0,0,0,0,0,0
2023,2400,107,12,119,27,22,49,64,21,85,7,10,17
2023,2401,23,2,25,5,9,14,0,0,0,0,0,0
2023,2402,8,2,10,1,3,4,0,0,0,0,0,0
2023,2403,8,0,8,1,1,2,0,0,0,0,0,0
2023,2404,15,2,17,2,6,8,0,0,0,0,0,0
2023,2405,39,4,43,4,21,25,0,0,0,3,2,5
2023,2406,70,16,86,8,30,38,0,0,0,0,0,0
2023,2412,12,2,14,6,9,15,0,0,0,0,0,0
2023,2500,9,0,9,3,6,9,8,3,11,0,0,0
2023,2501,6,1,7,0,1,1,0,0,0,0,0,0
2023,2600,21,3,24,0,2,2,9,5,14,2,1,3
2023,2601,12,2,14,2,3,5,0,0,0,0,0,0
2023,2700,92,13,105,22,48,70,152,31,183,33,34,67
2023,2701,10,1,11,1,6,7,0,0,0,0,0,0
2023,2702,9,0,9,0,0,0,0,0,0,0,0,0
2023,2703,12,0,12,1,3,4,0,0,0,0,0,0
2023,2704,19,1,20,1,7,8,0,0,0,0,0,0
2023,2705,13,3,16,0,3,3,0,0,0,0,0,0
2023,2706,46,4,50,1,4,5,0,0,0,4,3,7
2023,2707,16,6,22,2,5,7,0,0,0,0,0,0
2023,2708,125,16,141,5,35,40,0,0,0,0,0,0
2023,2709,10,0,10,0,1,1,0,0,0,0,0,0
2023,2710,26,1,27,6,10,16,0,0,0,0,0,0
2023,2711,13,0,13,2,6,8,0,0,0,0,0,0
2023,2712,20,4,24,0,9,9,0,0,0,0,0,0
2023,2719,12,5,17,4,9,13,0,0,0,0,0,0
2023,2800,90,10,100,18,26,44,1,0,1,0,0,0
2023,2801,8,3,11,1,4,5,0,0,0,0,0,0
2023,2802,68,6,74,5,38,43,0,0,0,0,0,0
2023,2803,10,2,12,0,0,0,0,0,0,0,0,0
2023,2808,115,8,123,2,7,9,0,0,0,0,0,0
2023,2900,56,5,61,4,33,37,2,0,2,37,24,61
2023,2901,26,2,28,2,4,6,0,0,0,0,0,0
2023,2902,8,0,8,1,2,3,0,0,0,0,0,0
2023,2908,21,2,23,1,8,9,0,0,0,0,0,0
2023,3000,1007,163,1170,605,667,1272,699,114,813,278,215,493
2023,3001,364,42,406,43,116,159,13,5,18,0,9,9
2023,3002,53,7,60,4,27,31,0,0,0,0,0,0
2023,3003,73,11,84,8,35,43,0,0,0,4,1,5
2023,3004,116,17,133,17,56,73,0,0,0,5,6,11
2023,3005,47,7,54,0,10,10,0,0,0,3,2,5
2023,3006,17,1,18,0,5,5,0,0,0,0,0,0
2023,3007,43,10,53,2,18,20,0,0,0,0,0,0
2023,3008,104,12,116,10,38,48,0,0,0,0,0,0
2023,3009,160,9,169,8,57,65,0,0,0,0,0,0
2023,3010,173,24,197,18,69,87,1,0,1,12,4,16
2023,3011,45,6,51,14,27,41,0,0,0,0,2,2
2023,3012,62,10,72,6,23,29,0,0,0,0,0,0
2023,3013,21,1,22,1,4,5,0,0,0,0,0,0
2023,3014,125,11,136,30,43,73,0,0,0,5,4,9
2023,3015,149,10,159,24,47,71,0,0,0,1,1,2
2023,3016,43,6,49,3,14,17,0,0,0,1,2,3
2023,3019,317,33,350,39,97,136,0,0,0,43,40,83
2023,3020,37,3,40,8,3,11,0,0,0,4,0,4
2023,3022,81,12,93,10,32,42,0,0,0,0,0,0
2023,3024,79,13,92,2,39,41,1,0,1,0,0,0
2023,3026,207,42,249,34,69,103,0,0,0,0,0,0
2023,3027,19,4,23,5,14,19,0,0,0,0,0,0
2023,3096,11,0,11,2,5,7,0,0,0,0,0,0
2023,3097,33,11,44,46,23,69,0,0,0,0,0,0
2023,3100,164,20,184,19,76,95,67,3,70,87,85,172
2023,3101,22,2,24,1,8,9,0,0,0,0,0,0
2023,3103,25,3,28,1,12,13,0,0,0,0,0,0
2023,3104,54,5,59,2,22,24,0,0,0,0,0,0
2023,3105,133,13,146,20,52,72,0,0,0,0,0,0
2023,3200,27,1,28,1,9,10,1,0,1,10,3,13
2023,3300,1497,170,1667,350,755,1105,55,5,60,903,386,1289
2023,3301,27,5,32,0,15,15,0,0,0,0,0,0
2023,3302,45,9,54,3,21,24,0,0,0,0,0,0
2023,3303,20,2,22,4,6,10,0,0,0,0,0,0
2023,3306,25,5,30,6,14,20,0,0,0,0,0,0
2023,3308,72,5,77,8,33,41,0,0,0,0,0,0
2023,3309,56,3,59,24,31,55,0,0,0,0,0,0
2023,3311,89,14,103,10,30,40,0,0,0,0,0,0
2023,3313,314,43,357,36,137,173,0,0,0,0,0,0
2023,3315,130,21,151,8,59,67,0,0,0,4,1,5
2023,3325,45,6,51,6,14,20,0,0,0,0,0,0
2023,3342,100,9,109,4,49,53,0,0,0,0,0,0
2023,3344,17,2,19,2,5,7,0,0,0,0,0,0
2023,3349,74,14,88,3,21,24,0,0,0,0,0,0
2023,3397,24,3,27,6,9,15,0,0,0,0,0,0
2023,3400,728,127,855,177,261,438,394,81,475,76,169,245
2023,3401,65,10,75,1,26,27,0,0,0,0,0,0
2023,3402,30,6,36,9,2,11,0,0,0,0,0,0
2023,3404,555,123,678,79,203,282,0,0,0,0,0,0
2023,3408,12,5,17,8,8,16,0,0,0,0,0,0
2023,3414,17,2,19,1,6,7,0,0,0,0,0,0
2023,3420,1,0,1,0,1,1,0,0,0,0,0,0
2023,3422,443,86,529,17,25,42,0,0,0,0,0,0
2023,3477,52,12,64,6,10,16,0,0,0,0,0,0
2023,3496,65,9,74,19,31,50,0,0,0,0,0,0
2023,3499,6182,420,6602,1485,1818,3303,0,0,0,0,0,0
2023,3500,31,1,32,0,5,5,1,0,1,18,9,27
2023,3501,26,6,32,6,14,20,0,0,0,0,0,0
2023,3600,1161,207,1368,174,579,753,531,87,618,178,447,625
2023,3601,37,3,40,0,20,20,0,0,0,0,0,0
2023,3602,102,15,117,3,50,53,0,0,0,0,0,0
2023,3603,43,7,50,4,31,35,0,0,0,0,0,0
2023,3604,168,18,186,11,82,93,0,0,0,0,0,0
2023,3605,34,8,42,4,17,21,0,0,0,0,0,0
2023,3607,263,24,287,18,69,87,0,0,0,0,0,0
2023,3608,73,7,80,10,27,37,0,0,0,0,0,0
2023,3609,90,14,104,7,42,49,0,0,0,0,0,0
2023,3610,243,35,278,25,117,142,0,0,0,0,0,0
2023,3611,69,8,77,4,29,33,0,0,0,0,0,0
2023,3614,10,4,14,1,11,12,0,0,0,0,0,0
2023,3623,19,2,21,45,32,77,0,0,0,0,0,0
2023,3626,12,2,14,0,2,2,0,0,0,0,0,0
2023,3639,10,1,11,3,4,7,0,0,0,0,0,0
2023,3650,12,2,14,36,27,63,0,0,0,0,0,0
2023,3657,59,23,82,2,10,12,0,0,0,0,0,0
2023,3700,1121,192,1313,340,552,892,807,259,1066,280,548,828
2023,3701,112,15,127,7,44,51,0,0,0,0,0,0
2023,3702,217,48,265,32,85,117,8,1,9,0,0,0
2023,3703,35,12,47,6,18,24,0,0,0,0,0,0
2023,3705,109,15,124,8,40,48,0,0,0,0,0,0
2023,3706,136,11,147,7,43,50,0,0,0,0,0,0
2023,3708,51,14,65,7,23,30,0,0,0,0,0,0
2023,3709,74,12,86,4,31,35,0,0,0,0,0,0
2023,3710,172,18,190,15,66,81,0,0,0,0,0,0
2023,3711,1485,292,1777,214,352,566,0,0,0,0,0,0
2023,3714,30,7,37,2,19,21,0,0,0,0,0,0
2023,3715,109,19,128,14,18,32,0,0,0,0,0,0
2023,3732,17,0,17,1,8,9,0,0,0,0,0,0
2023,3797,41,4,45,21,23,44,0,0,0,0,0,0
2023,3800,283,38,321,72,80,152,308,49,357,24,15,39
2023,3801,1589,280,1869,479,374,853,0,0,0,0,0,0
2023,3803,17,3,20,16,10,26,0,0,0,0,0,0
2023,3897,47,4,51,8,14,22,0,0,0,0,0,0
2023,3900,250,30,280,34,130,164,32,2,34,189,94,283
2023,3901,10,0,10,0,1,1,0,0,0,0,0,0
2023,3902,67,9,76,2,30,32,0,0,0,0,0,0
2023,3903,74,1,75,5,22,27,0,0,0,2,0,2
2023,3904,21,1,22,3,13,16,0,0,0,0,0,0
2023,3905,315,34,349,43,141,184,0,0,0,0,0,0
2023,3906,97,7,104,6,48,54,0,0,0,0,0,0
2023,3915,21,4,25,2,4,6,0,0,0,0,0,0
2023,4000,153,8,161,18,64,82,123,30,153,14,22,36
2023,4001,25,2,27,0,3,3,0,0,0,0,0,0
2023,4002,19,2,21,3,3,6,0,0,0,0,0,0
2023,4003,13,3,16,1,2,3,0,0,0,0,0,0
2023,4004,39,4,43,2,18,20,0,0,0,0,0,0
2023,4005,18,3,21,0,13,13,0,0,0,0,0,0
2023,4006,49,5,54,4,25,29,0,0,0,0,0,0
2023,4007,13,1,14,3,5,8,0,0,0,0,0,0
2023,4008,27,2,29,3,9,12,0,0,0,0,0,0
2023,4016,126,23,149,0,13,13,0,0,0,0,0,0
2023,4019,4,0,4,1,1,2,0,0,0,0,0,0
2023,4100,207,20,227,62,98,160,71,2,73,156,71,227
2023,4101,18,3,21,1,7,8,0,0,0,0,0,0
2023,4102,27,4,31,4,8,12,0,0,0,0,0,0
2023,4103,15,1,16,1,3,4,0,0,0,0,0,0
2023,4104,33,6,39,7,13,20,0,0,0,0,0,0
2023,4105,16,3,19,0,7,7,0,0,0,0,0,0
2023,4106,75,10,85,10,13,23,0,0,0,0,0,0
2023,4108,22,3,25,2,8,10,0,0,0,0,0,0
2023,4109,43,2,45,3,13,16,0,0,0,0,0,0
2023,4111,28,4,32,0,5,5,0,0,0,0,0,0
2023,4113,78,9,87,4,23,27,0,0,0,0,0,0
2023,4114,46,5,51,3,14,17,0,0,0,0,0,0
2023,4116,88,20,108,13,34,47,0,0,0,0,0,0
2023,4117,69,11,80,10,23,33,0,0,0,0,0,0
2023,4119,6,1,7,0,1,1,0,0,0,0,0,0
2023,4120,28,8,36,5,9,14,0,0,0,0,0,0
2023,4127,26,3,29,6,6,12,0,0,0,0,0,0
2023,4200,229,21,250,32,85,117,184,32,216,46,51,97
2023,4201,10,1,11,0,2,2,0,0,0,0,0,0
2023,4202,35,4,39,4,17,21,0,0,0,4,1,5
2023,4203,93,27,120,15,46,61,0,0,0,0,0,0
2023,4204,109,6,115,8,47,55,0,0,0,0,0,0
2023,4211,5,1,6,4,4,8,0,0,0,0,0,0
2023,4297,24,7,31,4,11,15,0,0,0,0,0,0
2023,4300,329,45,374,49,91,140,572,158,730,76,105,181
2023,4302,34,5,39,6,23,29,0,0,0,0,0,0
2023,4304,54,9,63,3,20,23,0,0,0,3,0,3
2023,4305,24,5,29,1,11,12,0,0,0,0,0,0
2023,4307,31,5,36,5,13,18,0,0,0,0,0,0
2023,4308,71,17,88,5,27,32,0,0,0,0,0,0
2023,4310,38,5,43,7,16,23,0,0,0,0,0,0
2023,4311,75,10,85,14,34,48,0,0,0,0,0,0
2023,4312,64,8,72,18,34,52,0,0,0,0,0,0
2023,4313,936,139,1075,138,335,473,0,0,0,0,0,0
2023,4314,131,12,143,8,50,58,0,0,0,3,1,4
2023,4316,199,19,218,18,58,76,0,0,0,0,0,0
2023,4317,19,4,23,25,20,45,0,0,0,0,0,0
2023,4320,8,0,8,4,7,11,0,0,0,0,0,0
2023,4321,9,0,9,1,3,4,0,0,0,0,0,0
2023,4327,8,0,8,3,4,7,0,0,0,0,0,0
2023,4400,109,25,134,6,51,57,10,0,10,81,42,123
2023,4401,20,2,22,4,5,9,0,0,0,0,0,0
2023,4402,63,9,72,14,18,32,0,0,0,0,0,0
2023,4403,63,7,70,3,17,20,0,0,0,0,0,0
2023,4404,14,3,17,2,7,9,0,0,0,0,0,0
2023,4497,14,4,18,5,7,12,0,0,0,0,0,0
2023,4500,68,6,74,13,38,51,37,12,49,4,10,14
2023,4501,22,1,23,1,9,10,0,0,0,0,0,0
2023,4502,112,8,120,10,34,44,0,0,0,0,0,0
2023,4591,24,1,25,6,2,8,0,0,0,0,0,0
2023,4600,7,1,8,2,2,4,0,0,0,0,0,0
2023,4700,36,2,38,17,2,19,18,5,23,3,1,4
2023,4703,4,1,5,0,0,0,0,0,0,0,0,0
2023,4706,9,0,9,3,5,8,0,0,0,0,0,0
2023,4707,3,0,3,0,0,0,0,0,0,0,0,0
2023,4708,7,0,7,3,3,6,0,0,0,0,0,0
2023,4709,16,0,16,1,7,8,0,0,0,0,0,0
2023,4710,4,0,4,0,0,0,0,0,0,0,0,0
2023,4800,120,14,134,29,90,119,27,9,36,165,71,236
2023,4801,26,5,31,1,16,17,0,0,0,0,0,0
2023,4802,24,2,26,0,6,6,0,0,0,0,0,0
2023,4803,107,14,121,3,62,65,0,0,0,0,0,0
2023,4804,11,1,12,1,1,2,0,0,0,0,0,0
2023,4805,16,6,22,0,11,11,0,0,0,0,0,0
2023,4806,94,17,111,3,63,66,0,0,0,0,0,0
2023,4807,68,8,76,8,31,39,0,0,0,0,0,0
2023,4900,207,12,219,26,74,100,0,0,0,146,86,232
2023,4901,13,1,14,0,8,8,0,0,0,0,0,0
2023,4902,10,1,11,1,5,6,0,0,0,0,0,0
2023,4903,13,4,17,1,9,10,0,0,0,0,0,0
2023,4904,59,11,70,2,28,30,0,0,0,0,0,0
2023,4905,153,22,175,30,57,87,0,0,0,0,0,0
2023,4906,12,2,14,1,7,8,0,0,0,0,0,0
2023,4908,60,6,66,6,25,31,0,0,0,0,0,0
2023,4909,9,1,10,0,2,2,0,0,0,0,0,0
2023,4914,7,2,9,4,10,14,0,0,0,0,0,0
2023,5000,232,11,243,51,116,167,262,50,312,17,44,61
2023,5001,44,4,48,7,15,22,0,0,0,0,0,0
2023,5002,159,16,175,31,79,110,0,0,0,0,0,0
2023,5003,12,1,13,0,3,3,0,0,0,0,0,0
2023,5004,18,4,22,1,11,12,0,0,0,0,0,0
2023,5007,68,8,76,9,41,50,0,0,0,0,0,0
2023,5010,9,2,11,1,6,7,0,0,0,0,0,0
2023,5100,42,6,48,1,25,26,36,17,53,0,4,4
2023,5102,55,8,63,3,21,24,0,0,0,0,0,0
2023,5200,29,1,30,5,22,27,20,9,29,2,3,5
2023,5201,9,1,10,0,7,7,0,0,0,0,0,0
2023,5202,24,5,29,6,14,20,0,0,0,0,0,0
2023,5300,18,3,21,0,6,6,14,4,18,0,0,0
2023,5400,221,30,251,30,105,135,190,46,236,37,62,99
2023,5401,34,3,37,4,8,12,0,0,0,0,0,0
2023,5402,12,3,15,1,3,4,0,0,0,0,0,0
2023,5403,14,3,17,0,1,1,0,0,0,0,0,0
2023,5404,16,3,19,1,2,3,0,0,0,0,0,0
2023,5405,51,16,67,6,22,28,0,0,0,0,0,0
2023,5406,60,11,71,11,24,35,0,0,0,0,0,0
2023,5407,135,18,153,9,60,69,0,0,0,0,0,0
2023,5408,14,0,14,0,2,2,0,0,0,0,0,0
2023,5411,0,1,1,6,0,6,0,0,0,0,1,1
2023,5500,55,7,62,2,19,21,0,0,0,27,20,47
2023,5501,9,1,10,0,5,5,0,0,0,0,0,0
2023,5600,460,67,527,87,215,302,200,32,232,92,92,184
2023,5604,197,29,226,38,73,111,0,0,0,5,4,9
2023,5605,19,2,21,4,7,11,0,0,0,0,0,0
2023,5606,25,3,28,2,8,10,0,0,0,0,0,0
2023,5608,115,15,130,7,40,47,0,0,0,0,0,0
2023,5609,108,10,118,14,43,57,0,0,0,0,0,0
2023,5622,12,3,15,5,7,12,0,0,0,0,0,0
2023,5680,11,2,13,1,1,2,0,0,0,0,0,0
2023,5700,77,9,86,7,34,41,1,0,1,81,57,138
2023,5701,49,7,56,5,21,26,0,0,0,0,0,0
2023,5702,11,0,11,0,3,3,0,0,0,0,0,0
2023,5703,57,11,68,1,19,20,0,0,0,0,0,0
2023,5704,56,5,61,5,26,31,0,0,0,0,0,0
2023,5797,35,9,44,17,20,37,0,0,0,0,0,0
2023,5800,65,5,70,3,31,34,50,19,69,5,4,9
2023,5801,13,2,15,1,12,13,0,0,0,0,0,0
2023,5802,8,0,8,1,2,3,0,0,0,0,0,0
2023,10M1,206,27,233,6,12,18,0,0,0,0,0,0
2023,190C,8,1,9,2,5,7,0,0,0,0,0,0
2023,190R,8,0,8,2,4,6,0,0,0,0,0,0
2023,19A9,112,20,132,4,11,15,0,0,0,0,0,0
2023,340H,118,24,142,23,87,110,0,0,0,0,0,0
